,District,Block,Panchayat,SCs HH issued jobcards,STs HH issued jobcards,Others HH issued jobcards,Total HH issued jobcards,SCs Provided Employment,STs Provided Employment,Others Provided Employment,Total Provided Employment,Women EMP Provided,SCs Persondays generated,STs Persondays generated,Others Persondays generated,Total Persondays generated,Women Persondays generated,SCs Families Completed 100 Days,STs Families Completed 100 Days,Others Families Completed 100 Days,Total Families Completed 100 Days
0,ANANTAPUR,Agali,AGALI,362,1,747,1110,102,0,60,162,116,4310,0,1465,5775,2126,10,0,0,10
1,ANANTAPUR,Agali,Hallikera,161,1,554,716,0,0,0,0,0,0,0,0,0,0,0,0,0,0
2,ANANTAPUR,Agali,HULIKERADEVARAHALLI,73,67,367,507,55,54,245,354,300,4755,4509,16848,26112,10999,24,22,82,128
3,ANANTAPUR,Agali,INAGALORE,346,4,1279,1629,37,0,94,131,94,1344,0,3243,4587,1791,3,0,7,10
4,ANANTAPUR,Agali,Irigenahalli,180,1,494,675,0,0,0,0,0,0,0,0,0,0,0,0,0,0
5,ANANTAPUR,Agali,KODIHALLI,208,0,696,904,118,0,327,445,366,8956,0,17157,26113,11361,40,0,54,94
6,ANANTAPUR,Agali,MADHUDI,217,0,555,772,55,0,109,164,123,1678,0,6011,7689,3432,0,0,23,23
7,ANANTAPUR,Agali,NARASAMBUDI,207,0,958,1165,64,0,256,320,269,3071,0,14316,17387,7310,4,0,39,43
8,ANANTAPUR,Agali,P.BYADIGERA,218,0,494,712,60,0,111,171,144,2354,0,5546,7900,3888,8,0,5,13
9,ANANTAPUR,Agali,RAGELINGANAHALLI,160,0,779,939,78,0,256,334,155,4583,0,14380,18963,5354,11,0,35,46
10,ANANTAPUR,Agali,RAVUDI,207,1,890,1098,47,1,97,145,100,2250,30,4493,6773,2930,7,0,13,20
11,ANANTAPUR,Amadagur,AMADAGUR,308,6,1651,1965,112,0,678,790,748,5161,0,37334,42495,24199,8,0,88,96
12,ANANTAPUR,Amadagur,CHEEKIREVULAPALLE,13,16,266,295,5,3,78,86,88,298,173,3774,4245,2435,0,0,2,2
13,ANANTAPUR,Amadagur,CHINAGANIPALLI,159,4,1097,1260,51,0,315,366,331,2395,0,16162,18557,10294,8,0,42,50
14,ANANTAPUR,Amadagur,GUNDUVARIPALLI,99,4,148,251,51,1,33,85,82,2426,38,1525,3989,2280,1,0,2,3
15,ANANTAPUR,Amadagur,JOWKULAKOTHAPALLI,122,13,1008,1143,70,5,444,519,493,5002,245,21344,26591,15310,16,0,26,42
16,ANANTAPUR,Amadagur,KASSAMUDRAM,90,3,506,599,55,1,259,315,312,2965,43,15654,18662,10498,9,0,49,58
17,ANANTAPUR,Amadagur,MOHAMMADABAD,293,13,1010,1316,127,2,401,530,529,7309,144,23275,30728,18792,23,0,48,71
18,ANANTAPUR,Amadagur,PULIKUNTAPALLI,225,164,756,1145,117,80,190,387,366,7268,3651,9534,20453,11310,27,10,37,74
19,ANANTAPUR,Amadagur,THUMMALA,233,192,1489,1914,104,85,433,622,594,6325,5510,21704,33539,18478,20,20,48,88
20,ANANTAPUR,Amarapuram,Agraharam,258,1,454,713,0,0,0,0,0,0,0,0,0,0,0,0,0,0
21,ANANTAPUR,Amarapuram,ALDAHALLI,152,0,420,572,68,0,179,247,219,4423,0,11003,15426,7391,21,0,37,58
22,ANANTAPUR,Amarapuram,AMARAPURAM,399,23,1828,2250,78,0,395,473,407,4471,0,21744,26215,14669,16,0,50,66
23,ANANTAPUR,Amarapuram,BASAVANAHALLI,264,51,578,893,106,4,178,288,258,6339,188,7741,14268,6792,23,0,23,46
24,ANANTAPUR,Amarapuram,HALUKURU,537,0,626,1163,204,0,99,303,313,14126,0,5896,20022,9694,59,0,20,79
25,ANANTAPUR,Amarapuram,HEMAVATHI,468,7,1372,1847,117,1,195,313,310,4940,18,10760,15718,7629,10,0,32,42
26,ANANTAPUR,Amarapuram,Maddenakunta,188,3,792,983,0,0,0,0,0,0,0,0,0,0,0,0,0,0
27,ANANTAPUR,Amarapuram,NIDRAGATTA,151,1,545,697,53,1,114,168,176,1864,60,4252,6176,3166,2,0,8,10
28,ANANTAPUR,Amarapuram,SIVARAM,460,15,1091,1566,245,0,473,718,689,18459,0,30267,48726,24541,85,0,105,190
29,ANANTAPUR,Amarapuram,THAMMEDAHALLI,267,14,1247,1528,78,0,179,257,250,5100,0,13646,18746,9305,20,0,63,83
30,ANANTAPUR,Amarapuram,VALASA,494,13,1047,1554,193,2,144,339,272,11506,203,9458,21167,10665,29,1,39,69
31,ANANTAPUR,Anantapur,A.NARAYANAPURAM,220,45,1416,1681,12,1,64,77,63,196,20,921,1137,816,0,0,0,0
32,ANANTAPUR,Anantapur,AKKAMPALLI,21,18,269,308,0,0,104,104,101,0,0,5247,5247,4193,0,0,0,0
33,ANANTAPUR,Anantapur,AKUTHOTAPALLI,114,12,459,585,16,0,15,31,25,208,0,402,610,320,0,0,1,1
34,ANANTAPUR,Anantapur,ALAMURU,109,2,407,518,72,0,218,290,286,4659,0,14153,18812,14714,11,0,45,56
35,ANANTAPUR,Anantapur,ANANTAPUR(R),260,29,343,632,3,0,0,3,3,31,0,0,31,31,0,0,0,0
36,ANANTAPUR,Anantapur,CHINNAMPALLI,33,14,264,311,23,11,138,172,166,1405,282,6750,8437,5354,3,0,10,13
37,ANANTAPUR,Anantapur,CHIYYEDU,135,4,469,608,30,1,205,236,202,1442,48,12964,14454,6410,1,0,48,49
38,ANANTAPUR,Anantapur,ITIKALAPALLE,51,33,521,605,0,1,91,92,84,0,52,4953,5005,3095,0,0,11,11
39,ANANTAPUR,Anantapur,KAKKALAPALLI,108,13,220,341,20,0,11,31,32,1251,0,624,1875,1304,5,0,0,5
40,ANANTAPUR,Anantapur,KAKKALAPALLI COLONY,176,48,430,654,0,0,0,0,0,0,0,0,0,0,0,0,0,0
41,ANANTAPUR,Anantapur,KAMARUPALLI,55,9,376,440,43,5,229,277,243,3516,401,15275,19192,11443,19,1,52,72
42,ANANTAPUR,Anantapur,KANDUKUR,200,17,1193,1410,14,4,306,324,289,314,56,8957,9327,6593,0,0,17,17
43,ANANTAPUR,Anantapur,KATIGANIKALVA,59,2,274,335,40,1,179,220,216,2649,108,11872,14629,10203,11,1,29,41
44,ANANTAPUR,Anantapur,KATTAKINGAPALLI,126,1,254,381,73,1,140,214,198,3149,19,7164,10332,6905,6,0,16,22
45,ANANTAPUR,Anantapur,KODIMI,34,1,268,303,0,0,62,62,51,0,0,2849,2849,1571,0,0,7,7
46,ANANTAPUR,Anantapur,KURUGUNTA,112,16,193,321,47,3,63,113,118,2481,13,4304,6798,4967,4,0,6,10
47,ANANTAPUR,Anantapur,MANNILA,78,0,390,468,6,0,173,179,173,157,0,11825,11982,6564,1,0,55,56
48,ANANTAPUR,Anantapur,N.N.KUNTA,76,121,161,358,3,16,12,31,23,35,236,542,813,369,0,0,3,3
49,ANANTAPUR,Anantapur,PULAKUNTA,164,4,502,670,42,3,304,349,343,1623,108,21897,23628,12208,2,0,106,108
50,ANANTAPUR,Anantapur,RACHANAPALLE,12,2,215,229,0,0,31,31,31,0,0,1222,1222,868,0,0,0,0
51,ANANTAPUR,Anantapur,RAJIV COLONY,88,27,624,739,13,6,81,100,95,476,145,2850,3471,2742,1,0,3,4
52,ANANTAPUR,Anantapur,RUDRAMPETA,112,26,149,287,4,0,0,4,2,21,0,0,21,10,0,0,0,0
53,ANANTAPUR,Anantapur,SOMALADODDI,217,15,592,824,47,3,20,70,68,931,46,324,1301,1022,0,0,0,0
54,ANANTAPUR,Anantapur,THATICHERLA,47,2,419,468,0,0,94,94,82,0,0,7136,7136,3431,0,0,47,47
55,ANANTAPUR,Anantapur,UPPARAPALLI,76,4,501,581,22,1,219,242,233,1469,41,14482,15992,12326,9,0,54,63
56,ANANTAPUR,Atmakur,ATMAKUR,333,7,2120,2460,104,1,528,633,581,6916,33,35545,42494,27535,27,0,97,124
57,ANANTAPUR,Atmakur,B.YALERU,243,3,530,776,139,2,325,466,462,9802,84,24990,34876,24773,30,0,96,126
58,ANANTAPUR,Atmakur,GORIDINDLA,54,210,285,549,48,167,240,455,460,4379,13749,18346,36474,19494,24,59,68,151
59,ANANTAPUR,Atmakur,MADIGUBBA,133,92,605,830,64,42,240,346,296,2624,3262,12306,18192,9411,2,15,14,31
60,ANANTAPUR,Atmakur,MUTTALA,98,12,629,739,36,1,266,303,305,2149,6,14407,16562,8636,9,0,47,56
61,ANANTAPUR,Atmakur,ODDUPALLI,169,0,293,462,103,0,130,233,204,7865,0,9602,17467,8711,27,0,34,61
62,ANANTAPUR,Atmakur,P.SIDDARAMPURAM,66,4,372,442,36,4,195,235,205,2330,245,13064,15639,8139,7,1,44,52
63,ANANTAPUR,Atmakur,P.YALERU,185,19,576,780,120,5,289,414,364,5957,389,19092,25438,14542,8,1,56,65
64,ANANTAPUR,Atmakur,PAMPANUR,75,200,139,414,48,15,65,128,114,1732,273,2555,4560,2568,1,0,2,3
65,ANANTAPUR,Atmakur,RANGAMPETA,51,0,273,324,36,0,124,160,144,2510,0,8778,11288,7339,11,0,28,39
66,ANANTAPUR,Atmakur,SANAPA,101,5,782,888,20,0,210,230,200,773,0,10315,11088,7037,1,0,23,24
67,ANANTAPUR,Atmakur,SINGAMPALLI,53,158,176,387,35,91,97,223,220,2069,4507,5092,11668,6686,4,12,17,33
68,ANANTAPUR,Atmakur,TALUPURU,175,0,607,782,62,0,221,283,249,2048,0,15025,17073,8839,3,0,35,38
69,ANANTAPUR,Atmakur,THOPUDURTHI,132,11,847,990,85,8,466,559,522,4607,386,35504,40497,21348,4,1,137,142
70,ANANTAPUR,Atmakur,VEPACHERLA,49,350,120,519,21,182,67,270,261,1549,14112,4853,20514,12329,7,78,18,103
71,ANANTAPUR,Bathalapalle,APPARACHERUVU,124,25,747,896,43,13,281,337,288,1404,616,20221,22241,12439,1,1,103,105
72,ANANTAPUR,Bathalapalle,BATHALAPALLE,527,111,1808,2446,98,29,466,593,583,5376,1409,27030,33815,21209,16,4,70,90
73,ANANTAPUR,Bathalapalle,D.CHERLOPALLE,54,230,488,772,29,84,112,225,211,1813,3116,5375,10304,5622,7,5,11,23
74,ANANTAPUR,Bathalapalle,DAMPETLA,77,57,582,716,51,32,227,310,283,3298,2234,10782,16314,10164,14,12,28,54
75,ANANTAPUR,Bathalapalle,GARISALAPALLI,74,57,402,533,52,25,244,321,297,2851,519,9376,12746,7626,8,1,13,22
76,ANANTAPUR,Bathalapalle,MALYAVANTHAM,244,65,941,1250,33,20,436,489,468,1448,422,23303,25173,13771,4,0,50,54
77,ANANTAPUR,Bathalapalle,MUSTUR,150,0,513,663,86,0,216,302,288,5256,0,14713,19969,11308,12,0,53,65
78,ANANTAPUR,Bathalapalle,NALLABOYANAPALLI,50,0,493,543,36,0,240,276,246,2322,0,13463,15785,8259,9,0,40,49
79,ANANTAPUR,Bathalapalle,OBULAPURAM,93,5,759,857,49,1,396,446,420,2075,10,17713,19798,11610,1,0,27,28
80,ANANTAPUR,Bathalapalle,SANGALA,26,69,387,482,16,52,260,328,325,707,2281,12851,15839,8823,0,5,26,31
81,ANANTAPUR,Bathalapalle,SANJEEVAPURAM,167,12,777,956,50,2,186,238,202,3841,202,14124,18167,9873,18,1,58,77
82,ANANTAPUR,Bathalapalle,THAMBAPURAM,95,20,337,452,31,9,156,196,179,1098,514,7686,9298,4964,1,3,15,19
83,ANANTAPUR,Beluguppa,ANKAMPALLE,110,1,461,572,41,0,80,121,98,2243,0,2207,4450,1943,6,0,2,8
84,ANANTAPUR,Beluguppa,AVULENNA,115,0,361,476,53,0,84,137,130,1194,0,4918,6112,2889,0,0,16,16
85,ANANTAPUR,Beluguppa,BELUGUPPA,357,375,1222,1954,87,118,292,497,446,3195,5445,15417,24057,12459,3,11,13,27
86,ANANTAPUR,Beluguppa,DUDDEKUNTA,223,0,701,924,132,0,108,240,240,6980,0,5433,12413,6055,9,0,8,17
87,ANANTAPUR,Beluguppa,GANGAVARAM,219,51,810,1080,99,2,241,342,325,6565,192,16127,22884,11758,17,1,50,68
88,ANANTAPUR,Beluguppa,JEEDIPALLI,42,1,306,349,0,0,9,9,12,0,0,102,102,72,0,0,0,0
89,ANANTAPUR,Beluguppa,KALVAPALLE,178,113,514,805,65,49,194,308,293,2754,3637,15177,21568,10357,6,8,53,67
90,ANANTAPUR,Beluguppa,KONAMPALLE,111,48,448,607,37,13,96,146,158,2157,732,6375,9264,4720,4,1,15,20
91,ANANTAPUR,Beluguppa,N.G. PALLI,132,8,390,530,78,1,147,226,210,4474,12,7922,12408,5969,7,0,19,26
92,ANANTAPUR,Beluguppa,NAKKALAPALLI,15,0,451,466,4,0,63,67,60,245,0,4933,5178,2896,0,0,22,22
93,ANANTAPUR,Beluguppa,NARASAPURAM,192,223,719,1134,104,114,183,401,412,4788,3607,5470,13865,6752,13,6,10,29
94,ANANTAPUR,Beluguppa,RAMASAGARAM,63,1,598,662,49,0,212,261,256,3014,0,11402,14416,6989,4,0,8,12
95,ANANTAPUR,Beluguppa,RAVANEPALLI,90,104,263,457,28,43,143,214,207,1069,1010,8606,10685,5277,2,0,23,25
96,ANANTAPUR,Beluguppa,SEERPI,239,1,773,1013,115,0,230,345,317,7752,0,13884,21636,10422,23,0,44,67
97,ANANTAPUR,Beluguppa,SREERANGAPURAM,205,0,428,633,134,0,64,198,180,5844,0,1351,7195,3650,1,0,0,1
98,ANANTAPUR,Beluguppa,THAGGUPARTHY,170,0,282,452,102,0,90,192,167,3073,0,5478,8551,4018,1,0,21,22
99,ANANTAPUR,Beluguppa,VIRUPAPALLI,126,3,346,475,70,0,111,181,174,2396,0,3071,5467,2566,1,0,3,4
100,ANANTAPUR,Beluguppa,YERRAGUDI,146,0,358,504,95,0,123,218,202,5617,0,6557,12174,6247,8,0,7,15
101,ANANTAPUR,Bommanahal,BANDUR,107,0,316,423,33,0,128,161,152,1734,0,6890,8624,5396,4,0,14,18
102,ANANTAPUR,Bommanahal,BOLLANAGUDAM,111,1,615,727,66,0,385,451,385,2601,0,14683,17284,7953,6,0,24,30
103,ANANTAPUR,Bommanahal,BOMMANAHAL,83,0,569,652,3,0,216,219,202,72,0,7906,7978,4176,0,0,17,17
104,ANANTAPUR,Bommanahal,D.HONNUR,122,0,671,793,35,0,171,206,173,1023,0,6136,7159,3246,1,0,18,19
105,ANANTAPUR,Bommanahal,ELANJI,48,0,358,406,38,0,241,279,260,2330,0,9977,12307,6676,5,0,8,13
106,ANANTAPUR,Bommanahal,GONEHAL,104,0,193,297,76,0,121,197,218,3489,0,2783,6272,3937,5,0,1,6
107,ANANTAPUR,Bommanahal,GOVINDAWADA,194,6,1360,1560,98,2,473,573,561,3025,45,9101,12171,6188,1,0,0,1
108,ANANTAPUR,Bommanahal,HARESAMUDRAM,29,0,216,245,7,0,153,160,150,106,0,8643,8749,5024,0,0,22,22
109,ANANTAPUR,Bommanahal,KALLUHOLLE,88,1,583,672,28,0,234,262,268,563,0,8704,9267,4291,0,0,10,10
110,ANANTAPUR,Bommanahal,KOLAGANAHALLI,73,1,270,344,65,0,178,243,241,3681,0,8101,11782,6024,8,0,13,21
111,ANANTAPUR,Bommanahal,KURUVALLI,11,4,286,301,6,1,176,183,185,191,42,9462,9695,4500,0,0,16,16
112,ANANTAPUR,Bommanahal,LINGADAHAL,76,2,638,716,46,1,376,423,394,1055,15,10725,11795,6251,0,0,5,5
113,ANANTAPUR,Bommanahal,NEMAKALLU,54,0,528,582,0,0,77,77,79,0,0,398,398,265,0,0,0,0
114,ANANTAPUR,Bommanahal,SIDDARAMPURAM,59,0,306,365,47,0,151,198,197,2986,0,8121,11107,5220,11,0,20,31
115,ANANTAPUR,Bommanahal,SINGANAHALLI,102,0,265,367,63,0,137,200,181,2684,0,3848,6532,3274,1,0,1,2
116,ANANTAPUR,Bommanahal,SREEDHARAGHATTA,88,0,321,409,41,0,184,225,228,903,0,9637,10540,6772,0,0,16,16
117,ANANTAPUR,Bommanahal,UDDEHAL,122,45,851,1018,16,3,193,212,206,444,33,3593,4070,2405,1,0,0,1
118,ANANTAPUR,Bommanahal,UNTHAKAL,147,11,530,688,63,3,161,227,214,2108,73,7998,10179,4965,1,0,21,22
119,ANANTAPUR,Bommanahal,UPPARAHAL,28,0,392,420,4,0,134,138,131,78,0,2908,2986,1570,0,0,1,1
120,ANANTAPUR,Brahmasamudram,BHAIRASAMUDRAM,105,0,501,606,65,0,283,348,304,2691,0,11163,13854,6667,5,0,20,25
121,ANANTAPUR,Brahmasamudram,BHYRAVANITHIPPA,163,0,760,923,24,0,79,103,78,275,0,954,1229,531,0,0,0,0
122,ANANTAPUR,Brahmasamudram,BOMMAGANIPALLI,36,203,114,353,19,96,63,178,152,1573,6123,4448,12144,6629,10,31,19,60
123,ANANTAPUR,Brahmasamudram,BRAHMASAMUDRAM,181,0,678,859,93,0,274,367,321,5401,0,18732,24133,12326,11,0,50,61
124,ANANTAPUR,Brahmasamudram,ERADIKERA,222,3,509,734,90,0,160,250,242,3625,0,5364,8989,4362,6,0,6,12
125,ANANTAPUR,Brahmasamudram,GUNDIGANIHALLI,72,0,296,368,35,0,72,107,92,1130,0,2048,3178,1769,0,0,0,0
126,ANANTAPUR,Brahmasamudram,KANNEPALLE,251,81,1351,1683,61,22,298,381,363,2314,275,17011,19600,9233,9,0,55,64
127,ANANTAPUR,Brahmasamudram,MUPPULAKUNTA,44,1,338,383,7,0,143,150,157,310,0,7457,7767,3899,0,0,23,23
128,ANANTAPUR,Brahmasamudram,NAGIREDDIPALLI,4,0,431,435,0,0,92,92,88,0,0,5694,5694,3613,0,0,16,16
129,ANANTAPUR,Brahmasamudram,PALAVENKATAPURAM,169,1,800,970,64,0,118,182,153,3089,0,4763,7852,3453,6,0,6,12
130,ANANTAPUR,Brahmasamudram,PILLALAPALLE,171,0,627,798,55,0,137,192,176,1628,0,7742,9370,5580,1,0,18,19
131,ANANTAPUR,Brahmasamudram,RAYALAPPADODDI,67,26,347,440,35,10,150,195,161,2019,628,11223,13870,6004,8,3,42,53
132,ANANTAPUR,Brahmasamudram,S. KONDAPURAM,223,0,897,1120,87,0,250,337,295,5432,0,13258,18690,9605,19,0,39,58
133,ANANTAPUR,Brahmasamudram,THEETAKAL,120,0,236,356,70,0,134,204,211,4834,0,12437,17271,8496,15,0,51,66
134,ANANTAPUR,Brahmasamudram,VEPALAPARTHI,245,8,981,1234,36,0,182,218,183,2195,0,8756,10951,5055,8,0,31,39
135,ANANTAPUR,Brahmasamudram,WEST KODIPALLE,119,1,687,807,39,0,89,128,92,1388,0,4028,5416,2655,4,0,6,10
136,ANANTAPUR,Bukkapatnam,AGRAHARAM,63,110,1034,1207,24,41,321,386,371,1786,3172,18156,23114,12599,7,9,54,70
137,ANANTAPUR,Bukkapatnam,BUKKAPATNAM,318,38,1864,2220,77,7,481,565,547,5066,430,32930,38426,32775,7,0,57,64
138,ANANTAPUR,Bukkapatnam,GARIKAVARIPALLI,100,95,1031,1226,2,18,166,186,193,166,394,8011,8571,4950,1,0,27,28
139,ANANTAPUR,Bukkapatnam,GUNIPALLE,65,2,374,441,30,1,221,252,229,1568,29,16307,17904,10829,5,0,67,72
140,ANANTAPUR,Bukkapatnam,KOTHAKOTA,141,251,784,1176,42,36,254,332,355,777,473,5958,7208,4265,0,0,3,3
141,ANANTAPUR,Bukkapatnam,KRISHNAPURAM,74,86,729,889,15,35,206,256,264,818,2157,15699,18674,10882,2,7,75,84
142,ANANTAPUR,Bukkapatnam,MARALA,62,155,665,882,23,50,225,298,305,1100,3527,17503,22130,13822,4,15,94,113
143,ANANTAPUR,Bukkapatnam,NARAYAMPALLE THANDA,6,199,221,426,6,63,128,197,205,113,1519,4826,6458,3610,0,0,3,3
144,ANANTAPUR,Bukkapatnam,PAMUDURTHI,141,0,757,898,53,0,223,276,268,2956,0,13313,16269,9439,12,0,52,64
145,ANANTAPUR,Bukkapatnam,SIDDARAMPURAM,159,25,1457,1641,71,4,822,897,926,3559,112,55760,59431,33112,9,0,181,190
146,ANANTAPUR,Bukkapatnam,YADALANKAPALLI,47,31,563,641,23,17,240,280,306,1772,1077,15522,18371,11181,12,3,52,67
147,ANANTAPUR,Bukkarayasamudram,B.K.SAMUDRAM,655,70,4627,5352,84,5,560,649,613,2965,167,33094,36226,25252,5,0,99,104
148,ANANTAPUR,Bukkarayasamudram,B.KOTHAPALLI,60,1,262,323,0,0,0,0,0,0,0,0,0,0,0,0,0,0
149,ANANTAPUR,Bukkarayasamudram,BOMMALATAPALLI,49,29,275,353,32,11,124,167,146,1523,589,7005,9117,5075,3,1,13,17
150,ANANTAPUR,Bukkarayasamudram,CHEDULLA,72,44,343,459,38,26,150,214,215,2449,1671,9940,14060,9991,6,6,39,51
151,ANANTAPUR,Bukkarayasamudram,CHENNAMPALLE,161,16,850,1027,53,6,394,453,426,748,162,15367,16277,9090,0,0,23,23
152,ANANTAPUR,Bukkarayasamudram,DANDUVARIPALLE,206,55,423,684,92,28,193,313,293,5871,1640,12268,19779,11506,19,4,44,67
153,ANANTAPUR,Bukkarayasamudram,DAYYALAKUNTAPALLI,26,8,452,486,16,4,255,275,265,752,275,21427,22454,14734,2,0,118,120
154,ANANTAPUR,Bukkarayasamudram,GOVINDAPALLE,105,8,517,630,11,0,85,96,98,557,0,5136,5693,3599,1,0,5,6
155,ANANTAPUR,Bukkarayasamudram,JANTHULUR,111,7,245,363,64,0,109,173,164,4270,0,7081,11351,6213,20,0,36,56
156,ANANTAPUR,Bukkarayasamudram,K.K.AGRAHARAM,190,0,858,1048,33,0,49,82,79,876,0,3077,3953,2058,2,0,10,12
157,ANANTAPUR,Bukkarayasamudram,KORRAPADU,374,42,1254,1670,46,6,254,306,309,1186,176,11201,12563,9129,0,0,21,21
158,ANANTAPUR,Bukkarayasamudram,NEELAMPALLI,2,25,331,358,0,19,177,196,188,0,1301,14396,15697,9521,0,5,58,63
159,ANANTAPUR,Bukkarayasamudram,PASALUR,151,96,149,396,75,70,78,223,222,3969,5648,6217,15834,11055,5,29,35,69
160,ANANTAPUR,Bukkarayasamudram,PODARALLA,123,24,588,735,4,0,13,17,11,32,0,96,128,58,0,0,0,0
161,ANANTAPUR,Bukkarayasamudram,REDDIPALLE,399,183,593,1175,77,49,14,140,130,5006,3190,548,8744,5668,18,3,0,21
162,ANANTAPUR,Bukkarayasamudram,REGIDIKOTTUR,9,0,382,391,0,0,0,0,0,0,0,0,0,0,0,0,0,0
163,ANANTAPUR,Bukkarayasamudram,SIDDARAMPURAM,172,37,348,557,39,7,66,112,92,3423,451,3060,6934,4831,19,0,8,27
164,ANANTAPUR,Bukkarayasamudram,Vadiampeta,37,0,343,380,0,0,0,0,0,0,0,0,0,0,0,0,0,0
165,ANANTAPUR,Bukkarayasamudram,VENKATAPURAM,244,0,311,555,86,0,96,182,158,5739,0,5032,10771,6024,21,0,12,33
166,ANANTAPUR,Chenne Kothapalle,BASAMPALLE,175,7,609,791,87,0,378,465,470,5081,0,29330,34411,16078,14,0,108,122
167,ANANTAPUR,Chenne Kothapalle,BASINEPALLE,2,4,468,474,0,0,59,59,59,0,0,2819,2819,1779,0,0,0,0
168,ANANTAPUR,Chenne Kothapalle,CHENNAKOTHAPALLE,273,48,1507,1828,126,27,529,682,649,9049,1948,25669,36666,20615,34,8,47,89
169,ANANTAPUR,Chenne Kothapalle,GANGINEPALLE,32,254,695,981,14,45,354,413,444,418,2219,16683,19320,9978,0,1,21,22
170,ANANTAPUR,Chenne Kothapalle,KANUMUKKALA,33,12,548,593,23,5,346,374,350,1109,292,19752,21153,10640,0,0,45,45
171,ANANTAPUR,Chenne Kothapalle,MEDAPURAM,316,31,1605,1952,103,6,691,800,755,5011,397,29389,34797,16422,19,1,82,102
172,ANANTAPUR,Chenne Kothapalle,MUSTIKOVILA,78,25,845,948,29,8,522,559,560,1270,351,25410,27031,13595,1,0,30,31
173,ANANTAPUR,Chenne Kothapalle,NAGASAMUDRAM,177,21,894,1092,10,1,235,246,231,483,10,9878,10371,5325,2,0,19,21
174,ANANTAPUR,Chenne Kothapalle,NYAMADDALA,154,93,1442,1689,83,49,688,820,766,4087,1544,40541,46172,21589,6,0,94,100
175,ANANTAPUR,Chenne Kothapalle,OBULAMPALLE,130,3,684,817,51,1,326,378,343,3214,56,23065,26335,13753,12,0,91,103
176,ANANTAPUR,Chenne Kothapalle,POLETIPALLE,183,1,568,752,100,1,281,382,386,6771,108,14986,21865,11600,19,1,33,53
177,ANANTAPUR,Chenne Kothapalle,PYADINDI,168,0,799,967,88,0,451,539,563,4496,0,25778,30274,16072,5,0,43,48
178,ANANTAPUR,Chenne Kothapalle,VELDURTHI,57,17,336,410,46,10,232,288,314,2702,578,14308,17588,8989,6,2,31,39
179,ANANTAPUR,Chenne Kothapalle,VENKATAMPALLE,285,0,690,975,145,0,395,540,494,9123,0,27621,36744,19078,42,0,121,163
180,ANANTAPUR,Chilamathur,CHAGALERU,193,2,717,912,72,0,211,283,240,4589,0,13709,18298,7894,12,0,63,75
181,ANANTAPUR,Chilamathur,CHILAMATHUR,512,98,2500,3110,104,5,294,403,308,4782,316,19747,24845,12448,16,2,92,110
182,ANANTAPUR,Chilamathur,DEMAKETHEPALLE,258,0,1243,1501,73,0,295,368,285,5016,0,19539,24555,12607,17,0,67,84
183,ANANTAPUR,Chilamathur,KODI KONDA,91,11,602,704,21,1,79,101,82,1002,6,3093,4101,1877,3,0,3,6
184,ANANTAPUR,Chilamathur,KODUR,365,188,2509,3062,32,29,154,215,147,799,360,7679,8838,4160,3,0,11,14
185,ANANTAPUR,Chilamathur,MORASALAPALLI,80,23,1208,1311,23,4,300,327,280,1344,149,18499,19992,9987,5,0,66,71
186,ANANTAPUR,Chilamathur,PALAGALA PALLI,36,1,599,636,10,1,161,172,146,169,12,5034,5215,2429,1,0,7,8
187,ANANTAPUR,Chilamathur,SETTIPALLE,151,14,767,932,6,3,138,147,122,136,48,4851,5035,2626,0,0,15,15
188,ANANTAPUR,Chilamathur,SOMAGHATTA,86,24,699,809,0,2,167,169,111,0,107,8641,8748,2999,0,1,24,25
189,ANANTAPUR,Chilamathur,TEKULODU,46,0,364,410,32,0,258,290,274,1743,0,19299,21042,9186,5,0,96,101
190,ANANTAPUR,Chilamathur,VEERA PURAM,157,36,834,1027,28,0,131,159,111,796,0,5097,5893,2499,0,0,7,7
191,ANANTAPUR,D.Hirchal,CHERLOPALLI,123,0,426,549,0,0,150,150,136,0,0,4700,4700,2557,0,0,1,1
192,ANANTAPUR,D.Hirchal,D.HIREHAL,103,6,649,758,16,0,187,203,209,757,0,10335,11092,6079,3,0,48,51
193,ANANTAPUR,D.Hirchal,DODAGHATTA,79,0,221,300,42,0,86,128,138,1203,0,4806,6009,3112,0,0,10,10
194,ANANTAPUR,D.Hirchal,HULIKAL,77,4,469,550,29,0,47,76,71,1458,0,1929,3387,1964,1,0,2,3
195,ANANTAPUR,D.Hirchal,JAJARAKAL,104,0,316,420,3,0,78,81,72,155,0,4672,4827,3323,0,0,21,21
196,ANANTAPUR,D.Hirchal,KADALUR,138,2,514,654,46,0,140,186,183,1070,0,5491,6561,3774,1,0,7,8
197,ANANTAPUR,D.Hirchal,KUDLUR,162,2,648,812,30,0,173,203,183,1595,0,11069,12664,7146,4,0,43,47
198,ANANTAPUR,D.Hirchal,M.HANUMAPURAM,152,3,350,505,19,1,47,67,44,552,32,2944,3528,1205,0,0,11,11
199,ANANTAPUR,D.Hirchal,MADENAHALLI,25,3,514,542,0,0,42,42,44,0,0,2047,2047,1574,0,0,3,3
200,ANANTAPUR,D.Hirchal,MALAPANAGUDI,48,104,345,497,8,30,102,140,128,175,1299,4934,6408,4081,0,3,24,27
201,ANANTAPUR,D.Hirchal,MALLIKETHI,46,0,298,344,0,0,65,65,54,0,0,2265,2265,1228,0,0,0,0
202,ANANTAPUR,D.Hirchal,MURADI,284,17,939,1240,43,5,234,282,224,2253,336,15672,18261,8081,9,1,63,73
203,ANANTAPUR,D.Hirchal,NAGALAPURAM,35,1,551,587,4,0,187,191,148,115,0,7272,7387,3820,0,0,15,15
204,ANANTAPUR,D.Hirchal,OBULAPURAM,88,6,282,376,43,4,114,161,163,1857,197,5359,7413,5789,3,0,13,16
205,ANANTAPUR,D.Hirchal,PULAKURTHI,76,0,804,880,5,0,232,237,237,82,0,14097,14179,8468,0,0,32,32
206,ANANTAPUR,D.Hirchal,SOMALAPURAM,97,0,273,370,30,0,94,124,129,1143,0,6417,7560,3913,3,0,29,32
207,ANANTAPUR,Dharmavaram,C.C.KOTHAKOTA,42,17,337,396,35,13,259,307,321,2674,829,20013,23516,12079,10,1,80,91
208,ANANTAPUR,Dharmavaram,CHINGICHERLA,165,2,260,427,127,1,141,269,273,8148,29,10099,18276,11161,23,0,33,56
209,ANANTAPUR,Dharmavaram,CHINTLAPALLE,89,15,387,491,47,10,232,289,265,2778,655,13515,16948,10160,4,1,15,20
210,ANANTAPUR,Dharmavaram,DARSIMALA,93,154,404,651,41,65,176,282,269,2397,2989,11604,16990,9792,2,8,30,40
211,ANANTAPUR,Dharmavaram,DHARMAPURI,40,82,371,493,17,20,152,189,165,897,1120,7358,9375,5373,2,2,20,24
212,ANANTAPUR,Dharmavaram,ELUKUNTLA,81,32,608,721,56,18,380,454,472,4539,1737,34239,40515,20446,24,11,158,193
213,ANANTAPUR,Dharmavaram,GOTLURU,389,62,2130,2581,145,18,296,459,405,7464,750,17653,25867,16658,12,0,64,76
214,ANANTAPUR,Dharmavaram,KUNUTHURU,78,5,565,648,36,1,311,348,332,1889,88,21769,23746,13170,2,0,76,78
215,ANANTAPUR,Dharmavaram,MALLAKALVA,135,110,595,840,23,15,238,276,268,1134,833,19744,21711,12830,1,4,85,90
216,ANANTAPUR,Dharmavaram,NELAKOTA,57,174,275,506,42,77,168,287,280,3155,4549,12482,20186,9774,13,10,51,74
217,ANANTAPUR,Dharmavaram,POTHUKUNTA,61,7,841,909,35,1,218,254,250,1129,34,6134,7297,5108,0,0,4,4
218,ANANTAPUR,Dharmavaram,POTHULANAGEPALLE,49,0,432,481,35,0,299,334,339,3186,0,20251,23437,14119,21,0,56,77
219,ANANTAPUR,Dharmavaram,RAVULACHERUVU,124,140,688,952,51,59,422,532,506,2953,2941,24648,30542,17852,3,6,53,62
220,ANANTAPUR,Dharmavaram,REGATIPALLE,147,1,565,713,76,0,248,324,321,2302,0,14511,16813,10074,2,0,36,38
221,ANANTAPUR,Dharmavaram,SUBBARAOPETA,55,0,169,224,41,0,117,158,158,2816,0,8526,11342,7846,10,0,35,45
222,ANANTAPUR,Dharmavaram,THUMMALA,43,11,410,464,23,8,234,265,263,774,328,9447,10549,7138,0,0,5,5
223,ANANTAPUR,Dharmavaram,UPPANESANAPALLE,56,30,218,304,42,24,114,180,166,3022,1795,9060,13877,8328,6,5,30,41
224,ANANTAPUR,Dharmavaram,VENKATA THIMMAPURAM,103,133,224,460,72,74,114,260,295,4093,3656,6787,14536,7741,4,8,20,32
225,ANANTAPUR,Gandlapenta,CHAMALAGONDI,107,330,424,861,77,253,316,646,620,6440,22906,28276,57622,29823,11,76,93,180
226,ANANTAPUR,Gandlapenta,GANDLAPENTA,50,12,664,726,14,3,240,257,239,671,117,15926,16714,8423,3,0,61,64
227,ANANTAPUR,Gandlapenta,GODDUVELAGALA,33,1,464,498,25,1,377,403,400,1684,58,23850,25592,13419,2,0,80,82
228,ANANTAPUR,Gandlapenta,JEENULAKUNTA,29,2,269,300,3,1,63,67,58,53,90,3163,3306,1981,0,0,10,10
229,ANANTAPUR,Gandlapenta,KATARUPALLI,225,58,891,1174,61,36,162,259,251,3625,3024,10412,17061,9345,16,18,36,70
230,ANANTAPUR,Gandlapenta,KURUMAMIDI,34,86,347,467,27,57,145,229,221,1499,3943,6976,12418,6372,1,13,11,25
231,ANANTAPUR,Gandlapenta,MADDIVARIGONDI,69,19,315,403,54,6,113,173,157,2830,298,5962,9090,4675,7,0,14,21
232,ANANTAPUR,Gandlapenta,MALAMEEDA PALLI,93,64,1129,1286,55,38,658,751,743,3569,970,37480,42019,20555,11,1,100,112
233,ANANTAPUR,Gandlapenta,SOMAYAJULA PALLI,115,1,588,704,60,0,352,412,381,4424,0,26177,30601,17097,21,0,126,147
234,ANANTAPUR,Gandlapenta,THOOPALLI,71,1,605,677,36,0,317,353,334,2797,0,25316,28113,14372,13,0,116,129
235,ANANTAPUR,Gandlapenta,THUMMALABYLU,1,166,130,297,0,134,90,224,219,0,11713,6123,17836,8172,0,72,34,106
236,ANANTAPUR,Gandlapenta,VEPARALA,27,129,360,516,14,90,187,291,277,920,4221,9009,14150,7192,3,7,19,29
237,ANANTAPUR,Garladinne,BUDEDU,296,17,463,776,34,1,43,78,71,952,4,1143,2099,1091,1,0,1,2
238,ANANTAPUR,Garladinne,GARLADINNE,244,43,1398,1685,22,5,89,116,106,579,214,3649,4442,2916,0,0,11,11
239,ANANTAPUR,Garladinne,ILLURU,341,7,497,845,196,1,44,241,245,13010,27,839,13876,7661,38,0,0,38
240,ANANTAPUR,Garladinne,KALLURU R.S.,483,38,1359,1880,63,3,331,397,387,2745,154,18447,21346,15826,4,0,50,54
241,ANANTAPUR,Garladinne,KAMALAPURAM,10,175,383,568,7,53,109,169,147,373,2559,6515,9447,4500,1,2,22,25
242,ANANTAPUR,Garladinne,KANAMPALLI,157,0,360,517,53,0,205,258,247,2311,0,10826,13137,6633,6,0,8,14
243,ANANTAPUR,Garladinne,KESAVAPURAM,118,2,191,311,32,0,61,93,91,1440,0,3320,4760,2633,2,0,13,15
244,ANANTAPUR,Garladinne,KOPPALAKONDA,121,3,480,604,64,2,221,287,291,1922,30,12300,14252,7916,0,0,24,24
245,ANANTAPUR,Garladinne,KOTANKA,129,24,494,647,68,9,254,331,307,4428,382,19009,23819,12683,21,1,73,95
246,ANANTAPUR,Garladinne,KRISHNAPURAM,5,0,272,277,2,0,79,81,58,28,0,2702,2730,1132,0,0,5,5
247,ANANTAPUR,Garladinne,M.P.R. DAM,60,10,296,366,21,0,63,84,82,1089,0,2937,4026,2504,4,0,2,6
248,ANANTAPUR,Garladinne,MARTHADU,193,25,1429,1647,28,0,188,216,185,1095,0,8561,9656,5243,2,0,17,19
249,ANANTAPUR,Garladinne,MUKUNDAPURAM,173,21,394,588,72,4,161,237,214,3411,131,8275,11817,6495,5,1,27,33
250,ANANTAPUR,Garladinne,MUNTHIMADUGU,127,20,451,598,36,12,186,234,252,3224,1054,14400,18678,10544,19,5,81,105
251,ANANTAPUR,Garladinne,PENAKACHERLA,245,32,734,1011,126,7,251,384,350,7537,226,12772,20535,10305,14,0,36,50
252,ANANTAPUR,Garladinne,SIRIVARAM,63,0,222,285,14,0,96,110,93,413,0,7010,7423,3717,0,0,32,32
253,ANANTAPUR,Garladinne,THIMMAMPETA,47,7,332,386,16,3,161,180,147,506,105,7992,8603,4270,0,0,17,17
254,ANANTAPUR,Garladinne,YERRAGUNTLA,106,15,493,614,56,10,89,155,163,4031,873,4747,9651,5023,15,5,12,32
255,ANANTAPUR,Gooty,ABBEDODDI,102,0,273,375,78,0,130,208,233,8228,0,10026,18254,9512,46,0,33,79
256,ANANTAPUR,Gooty,BASINEPALLI,46,162,421,629,21,47,154,222,211,835,793,7011,8639,6292,1,0,4,5
257,ANANTAPUR,Gooty,BETHAPALLI,290,3,1123,1416,16,0,91,107,108,226,0,1607,1833,1150,0,0,0,0
258,ANANTAPUR,Gooty,BRAMHANAPALLI,65,0,307,372,58,0,212,270,309,5592,0,14892,20484,11378,32,0,66,98
259,ANANTAPUR,Gooty,CHERLOPALLI,5,0,313,318,2,0,161,163,151,41,0,3954,3995,2079,0,0,3,3
260,ANANTAPUR,Gooty,CHETNEPALLI,660,21,996,1677,96,3,119,218,211,1702,66,2013,3781,2957,0,0,0,0
261,ANANTAPUR,Gooty,DHARMAPURAM,49,12,143,204,32,10,87,129,155,3169,760,6354,10283,6524,19,2,23,44
262,ANANTAPUR,Gooty,ERRAGUDDI,32,149,357,538,15,81,255,351,359,1116,4601,22686,28403,14125,2,7,89,98
263,ANANTAPUR,Gooty,GOOTY,509,36,2109,2654,58,0,125,183,176,1700,0,6826,8526,7892,0,0,22,22
264,ANANTAPUR,Gooty,ISSURARALLAPALLI,61,98,499,658,23,17,121,161,155,157,230,1361,1748,1029,0,0,0,0
265,ANANTAPUR,Gooty,JAKKALACHERUVU,77,36,599,712,5,0,260,265,278,150,0,17025,17175,9340,0,0,71,71
266,ANANTAPUR,Gooty,KARIDIKONDA,220,21,350,591,54,4,100,158,163,3540,144,7123,10807,5603,17,0,42,59
267,ANANTAPUR,Gooty,KOJJELAPALLI,107,0,389,496,49,0,176,225,239,1646,0,8393,10039,6353,2,0,17,19
268,ANANTAPUR,Gooty,KOTHAPETA,165,7,535,707,44,0,132,176,179,2058,0,5600,7658,4641,0,0,1,1
269,ANANTAPUR,Gooty,LACHENAPALLI,73,0,396,469,36,0,190,226,234,669,0,6023,6692,5094,0,0,3,3
270,ANANTAPUR,Gooty,MAMADUR,158,3,286,447,106,0,162,268,296,7863,0,11072,18935,9810,21,0,25,46
271,ANANTAPUR,Gooty,PEDDODDI,111,2,469,582,53,1,167,221,221,4100,20,11877,15997,8169,15,0,41,56
272,ANANTAPUR,Gooty,RAJAPURAM,49,2,327,378,36,3,153,192,228,1754,84,8281,10119,5170,1,0,17,18
273,ANANTAPUR,Gooty,T.KOTHAPALLI,6,99,355,460,2,7,75,84,94,132,120,2907,3159,1702,0,0,5,5
274,ANANTAPUR,Gooty,THONDAPADU,77,1,279,357,62,0,46,108,142,3075,0,1929,5004,3095,5,0,5,10
275,ANANTAPUR,Gooty,TURAKAPALLI,150,9,276,435,45,1,143,189,157,2080,18,7106,9204,5188,2,0,16,18
276,ANANTAPUR,Gooty,UBICHERLA,180,0,575,755,142,0,421,563,712,12237,0,36596,48833,25434,56,0,114,170
277,ANANTAPUR,Gooty,UTAKALLU,42,1,453,496,26,1,251,278,293,945,44,10918,11907,6140,0,0,11,11
278,ANANTAPUR,Gooty,VANNEDODDI,11,1,392,404,2,0,223,225,250,478,0,15138,15616,8418,2,0,36,38
279,ANANTAPUR,Gooty,YARRAGANIPALLI,1,10,257,268,0,5,69,74,71,0,312,3484,3796,2621,0,0,6,6
280,ANANTAPUR,Gorantla,BUDILI,169,84,1037,1290,16,5,138,159,129,399,62,4207,4668,2340,0,0,4,4
281,ANANTAPUR,Gorantla,GANGAMPALLE,119,196,738,1053,36,56,187,279,239,3034,2148,10079,15261,7862,22,4,37,63
282,ANANTAPUR,Gorantla,GORANTLA,356,125,2856,3337,20,8,144,172,155,699,270,6619,7588,4099,1,0,18,19
283,ANANTAPUR,Gorantla,GOWNIVARIPALLE,109,1,972,1082,42,1,397,440,467,1917,100,17025,19042,9451,4,1,20,25
284,ANANTAPUR,Gorantla,KAMMAVARIPALLE,171,49,633,853,21,11,114,146,127,808,645,4989,6442,3364,0,2,15,17
285,ANANTAPUR,Gorantla,KONDAPURAM,87,63,878,1028,9,5,226,240,237,461,277,12592,13330,7655,1,1,28,30
286,ANANTAPUR,Gorantla,MALASAMUDRAM,68,40,683,791,8,21,182,211,197,416,1202,10111,11729,5518,1,1,20,22
287,ANANTAPUR,Gorantla,MALLAPALLE,117,47,693,857,7,0,138,145,112,114,0,5474,5588,2817,0,0,7,7
288,ANANTAPUR,Gorantla,MANDALAPALLE,226,549,1140,1915,37,115,195,347,350,2128,5878,7991,15997,8386,5,8,10,23
289,ANANTAPUR,Gorantla,NARSIMPALLE,232,4,512,748,50,0,139,189,157,2702,0,8113,10815,5935,13,0,30,43
290,ANANTAPUR,Gorantla,PALASUMDRAM,225,166,613,1004,43,26,111,180,152,2119,891,5721,8731,4931,8,2,15,25
291,ANANTAPUR,Gorantla,PULERU,102,0,454,556,19,0,71,90,78,1285,0,3713,4998,2691,5,0,16,21
292,ANANTAPUR,Gorantla,REDDICHERUVUPALLE,36,0,617,653,1,0,160,161,135,109,0,6531,6640,3634,1,0,3,4
293,ANANTAPUR,Gorantla,VADIGEPALLE,163,102,517,782,57,31,190,278,239,2351,1188,7911,11450,5883,0,0,4,4
294,ANANTAPUR,Gorantla,VANAVOLU,88,371,1436,1895,1,94,402,497,429,20,3140,24495,27655,14969,0,1,97,98
295,ANANTAPUR,Gorantla,VENKATARAMANAPALLE,2,0,615,617,0,0,74,74,63,0,0,4778,4778,2205,0,0,19,19
296,ANANTAPUR,Gudibanda,CHIGATHURPI,71,0,199,270,58,0,82,140,115,3769,0,4570,8339,3790,17,0,15,32
297,ANANTAPUR,Gudibanda,GUDIBANDA,349,78,1362,1789,121,47,352,520,476,4918,2284,12924,20126,10489,14,4,13,31
298,ANANTAPUR,Gudibanda,GUNEMORUBAGAL,77,0,357,434,8,0,85,93,86,58,0,1108,1166,621,0,0,0,0
299,ANANTAPUR,Gudibanda,JAMBULABANDA,332,31,605,968,194,9,249,452,366,13654,668,15483,29805,14323,59,2,61,122
300,ANANTAPUR,Gudibanda,KARIKERA,317,5,500,822,41,0,69,110,97,1238,0,1979,3217,1442,0,0,1,1
301,ANANTAPUR,Gudibanda,KONAKALLU,149,0,707,856,9,0,146,155,146,222,0,5941,6163,3056,0,0,8,8
302,ANANTAPUR,Gudibanda,KUMBARANAGEHALLI,50,0,188,238,17,0,37,54,47,578,0,2046,2624,1264,0,0,3,3
303,ANANTAPUR,Gudibanda,MANDALAHALLI,282,17,912,1211,41,0,138,179,164,1459,0,4427,5886,3289,2,0,9,11
304,ANANTAPUR,Gudibanda,MORUBAGAL,620,2,1569,2191,145,0,61,206,189,6147,0,2009,8156,3869,3,0,2,5
305,ANANTAPUR,Gudibanda,MUTHUKUR,286,95,1002,1383,51,0,143,194,172,2014,0,5622,7636,3871,3,0,6,9
306,ANANTAPUR,Gudibanda,RALLAHALLI,574,0,1116,1690,194,0,270,464,423,10487,0,13540,24027,13933,37,0,43,80
307,ANANTAPUR,Gudibanda,S.RAYAPURAM,100,0,201,301,34,0,34,68,49,1424,0,739,2163,1031,0,0,0,0
308,ANANTAPUR,Gudibanda,Sankaragallu,240,0,429,669,0,0,0,0,0,0,0,0,0,0,0,0,0,0
309,ANANTAPUR,Gummagatta,75  VEERAPURAM,121,58,277,456,33,28,76,137,112,1181,809,2631,4621,2188,2,0,3,5
310,ANANTAPUR,Gummagatta,BELODU,88,0,547,635,30,0,153,183,167,1245,0,7658,8903,4086,2,0,11,13
311,ANANTAPUR,Gummagatta,BHUPASAMUDRAM,144,2,659,805,65,0,139,204,189,2707,0,6663,9370,4637,3,0,16,19
312,ANANTAPUR,Gummagatta,GALAGALA,162,1,1072,1235,48,0,431,479,448,2064,0,15655,17719,8648,1,0,8,9
313,ANANTAPUR,Gummagatta,GOLLAPALLE,161,4,621,786,55,0,214,269,215,2884,0,10687,13571,7245,7,0,17,24
314,ANANTAPUR,Gummagatta,GONABHAVI,178,2,645,825,66,0,151,217,183,1326,0,7584,8910,5990,1,0,4,5
315,ANANTAPUR,Gummagatta,GUMMAGATTA,124,0,454,578,23,0,149,172,156,1073,0,7789,8862,5179,0,0,14,14
316,ANANTAPUR,Gummagatta,K.P. DODDI,116,4,570,690,24,0,186,210,202,807,0,10182,10989,5548,0,0,35,35
317,ANANTAPUR,Gummagatta,KALUGODU,376,6,1695,2077,162,1,502,665,610,5625,20,22532,28177,13374,9,0,30,39
318,ANANTAPUR,Gummagatta,MAREM PALLI,91,48,525,664,44,13,172,229,198,1696,866,10755,13317,6144,2,3,41,46
319,ANANTAPUR,Gummagatta,NETRAPALLI,83,1,549,633,32,0,190,222,212,1023,0,9254,10277,5467,0,0,10,10
320,ANANTAPUR,Gummagatta,PULAKUNTA,100,0,721,821,25,0,213,238,183,911,0,9139,10050,4785,0,0,9,9
321,ANANTAPUR,Gummagatta,RANGASAMUDRAM,155,0,405,560,60,0,71,131,125,3501,0,4180,7681,3786,7,0,17,24
322,ANANTAPUR,Gummagatta,SIRIGE DODDI,71,0,792,863,8,0,276,284,271,310,0,14978,15288,7222,0,0,16,16
323,ANANTAPUR,Gummagatta,TALLAKERA,491,7,1178,1676,103,0,166,269,225,2223,0,6137,8360,4083,2,0,13,15
324,ANANTAPUR,Guntakal,AYYAVARIPALLI,65,7,179,251,45,5,55,105,91,2411,84,2852,5347,2753,4,0,5,9
325,ANANTAPUR,Guntakal,CHINTALAMPALLI,60,1,237,298,6,1,49,56,57,54,4,2002,2060,950,0,0,8,8
326,ANANTAPUR,Guntakal,DANCHERLA,65,2,599,666,25,0,342,367,320,972,0,16226,17198,8342,2,0,41,43
327,ANANTAPUR,Guntakal,DONIMUKKALA,35,0,377,412,21,0,110,131,146,1889,0,4961,6850,4092,10,0,19,29
328,ANANTAPUR,Guntakal,DOSALUDIKI,77,2,363,442,30,1,66,97,74,1075,38,2972,4085,1687,0,0,4,4
329,ANANTAPUR,Guntakal,G.KOTTALU,130,9,488,627,67,2,71,140,155,3886,119,4352,8357,4588,5,0,11,16
330,ANANTAPUR,Guntakal,GUNDALA,153,0,255,408,63,0,113,176,226,3687,0,7312,10999,5624,11,0,37,48
331,ANANTAPUR,Guntakal,GUNDALA TANDA,1,308,6,315,0,77,4,81,90,0,2528,118,2646,1590,0,0,0,0
332,ANANTAPUR,Guntakal,GURABADU,42,0,268,310,20,0,171,191,189,507,0,6669,7176,3396,0,0,4,4
333,ANANTAPUR,Guntakal,IMAMPURAM,0,20,208,228,0,1,83,84,78,0,1,3459,3460,1771,0,0,3,3
334,ANANTAPUR,Guntakal,KADIRIPALLI,6,89,110,205,1,64,83,148,160,12,3785,4429,8226,4110,0,14,13,27
335,ANANTAPUR,Guntakal,KASAPURAM,177,6,835,1018,26,1,43,70,63,1834,40,810,2684,1773,9,0,0,9
336,ANANTAPUR,Guntakal,KOGANAPALLE,103,1,721,825,3,0,109,112,120,115,0,6103,6218,3228,0,0,17,17
337,ANANTAPUR,Guntakal,MOLAKALPENTA,33,61,426,520,9,0,63,72,83,139,0,2158,2297,1167,0,0,6,6
338,ANANTAPUR,Guntakal,N.TIMMAPURAM,46,2,346,394,1,0,82,83,71,6,0,3221,3227,1536,0,0,8,8
339,ANANTAPUR,Guntakal,N.VENKATAMPALLI,27,89,247,363,17,59,126,202,232,895,4261,5727,10883,5495,5,19,16,40
340,ANANTAPUR,Guntakal,NAGASAMUDRAM,80,6,716,802,57,4,355,416,443,3062,222,19001,22285,11327,3,0,28,31
341,ANANTAPUR,Guntakal,NAKKANADODDI,24,111,632,767,9,65,150,224,252,436,3509,4128,8073,4260,1,3,7,11
342,ANANTAPUR,Guntakal,NALLADASARAPALLI,38,0,239,277,8,0,93,101,96,83,0,1631,1714,902,0,0,1,1
343,ANANTAPUR,Guntakal,NELAGONDA,78,11,560,649,20,1,150,171,178,399,32,7356,7787,3693,0,0,16,16
344,ANANTAPUR,Guntakal,OBULAPURAM,39,56,426,521,8,31,77,116,113,99,2393,2092,4584,2495,0,13,1,14
345,ANANTAPUR,Guntakal,PATHAKOTHA CHERUVU,76,1,708,785,27,0,188,215,203,939,0,7863,8802,4856,0,0,9,9
346,ANANTAPUR,Guntakal,PULIGUTTAPALLI,34,308,268,610,5,45,19,69,63,265,2399,1022,3686,1792,0,12,5,17
347,ANANTAPUR,Guntakal,Y.T.CHERUVU,182,1,853,1036,93,1,400,494,503,1923,8,6931,8862,4809,0,0,0,0
348,ANANTAPUR,Hindupur,BALAMPALLI,253,0,510,763,91,0,84,175,144,6524,0,5171,11695,6305,23,0,14,37
349,ANANTAPUR,Hindupur,BEEREPALLI,38,0,451,489,10,0,199,209,148,472,0,8521,8993,4069,2,0,29,31
350,ANANTAPUR,Hindupur,BEVINA HALLI,304,0,483,787,75,0,78,153,125,3717,0,4926,8643,4666,5,0,13,18
351,ANANTAPUR,Hindupur,CHALIVENDALA,192,4,637,833,45,0,100,145,95,1944,0,4564,6508,3137,6,0,16,22
352,ANANTAPUR,Hindupur,CHOWLUR,132,0,354,486,5,0,55,60,58,107,0,2670,2777,1899,0,0,10,10
353,ANANTAPUR,Hindupur,GOLLAPURAM,159,21,454,634,0,0,1,1,1,0,0,96,96,30,0,0,0,0
354,ANANTAPUR,Hindupur,KAGGALLU,46,0,404,450,12,0,89,101,90,422,0,5720,6142,4601,0,0,29,29
355,ANANTAPUR,Hindupur,KIRIKERA,226,0,872,1098,70,0,66,136,108,4147,0,2618,6765,3199,12,0,3,15
356,ANANTAPUR,Hindupur,KOTIPI,162,2,629,793,11,0,92,103,86,291,0,4254,4545,2783,0,0,6,6
357,ANANTAPUR,Hindupur,MALUGURU,275,3,459,737,6,1,97,104,91,133,22,5746,5901,3968,0,0,20,20
358,ANANTAPUR,Hindupur,MANESAMUDRAM,71,0,68,139,1,0,13,14,12,31,0,553,584,231,0,0,0,0
359,ANANTAPUR,Hindupur,PULAKUNTA,77,0,548,625,3,0,70,73,72,156,0,5322,5478,3212,1,0,24,25
360,ANANTAPUR,Hindupur,SANTHEBIDANUR,156,1,642,799,23,0,28,51,43,964,0,1398,2362,1394,2,0,3,5
361,ANANTAPUR,Hindupur,THUMUKUNTA,145,8,496,649,0,0,32,32,27,0,0,783,783,370,0,0,0,0
362,ANANTAPUR,Kadiri,BURUGA PALLI,27,0,190,217,23,0,148,171,166,1556,0,12035,13591,6572,7,0,78,85
363,ANANTAPUR,Kadiri,CHALAMAKUNTLA PALLE,63,2,256,321,43,0,150,193,172,3973,0,12832,16805,8027,33,0,82,115
364,ANANTAPUR,Kadiri,KADIRI BRAMHANA PALLI,47,95,588,730,31,34,262,327,282,1445,1688,17623,20756,12389,4,4,77,85
365,ANANTAPUR,Kadiri,KADIRIKUNTLA PALLE,71,6,186,263,50,3,124,177,165,4603,247,9182,14032,6567,24,1,43,68
366,ANANTAPUR,Kadiri,KALASAMUDRAM,83,6,600,689,59,6,331,396,386,4713,618,27197,32528,18287,22,5,151,178
367,ANANTAPUR,Kadiri,KONDAMANAYANI PALEM,30,9,119,158,20,6,87,113,95,1172,526,7110,8808,5497,5,4,53,62
368,ANANTAPUR,Kadiri,KUMMARAVANDLA PALLE,31,207,813,1051,15,32,455,502,464,1321,1601,28127,31049,18665,6,5,77,88
369,ANANTAPUR,Kadiri,MOTUKAPALLI,96,60,365,521,32,25,204,261,232,1705,1270,14136,17111,10455,6,4,75,85
370,ANANTAPUR,Kadiri,MUTHYLACHERUVU,29,572,732,1333,10,123,221,354,327,425,7025,11890,19340,10541,1,21,16,38
371,ANANTAPUR,Kadiri,PATNAM,77,334,946,1357,46,215,295,556,557,2993,12095,16008,31096,16359,3,13,16,32
372,ANANTAPUR,Kadiri,YAGUVAPALLI,96,124,525,745,59,45,270,374,368,5235,3603,22854,31692,16587,30,18,129,177
373,ANANTAPUR,Kadiri,YERRADODDI,30,129,373,532,2,43,57,102,89,28,3690,3921,7639,4516,0,26,14,40
374,ANANTAPUR,Kalyandurg,BEDRAHALLI,206,1,449,656,153,0,184,337,405,9486,0,7849,17335,8632,28,0,21,49
375,ANANTAPUR,Kalyandurg,BHATTUVANIPALLI,138,50,307,495,74,8,126,208,177,5042,60,5847,10949,5038,17,0,13,30
376,ANANTAPUR,Kalyandurg,BORAMPALLI,125,2,467,594,67,0,120,187,184,4047,0,5349,9396,4722,15,0,14,29
377,ANANTAPUR,Kalyandurg,CHAPIRI,97,15,500,612,57,10,249,316,320,2719,834,15740,19293,10033,9,7,55,71
378,ANANTAPUR,Kalyandurg,DODAGATTA,260,0,489,749,28,0,198,226,228,1188,0,6194,7382,3923,4,0,2,6
379,ANANTAPUR,Kalyandurg,DURADAKUNTA,160,0,583,743,123,0,399,522,538,8579,0,31478,40057,19845,15,0,101,116
380,ANANTAPUR,Kalyandurg,E.KODIPALLE,204,32,589,825,176,10,349,535,612,10997,782,24999,36778,18900,35,4,83,122
381,ANANTAPUR,Kalyandurg,GARUDAPURAM,192,60,724,976,112,2,260,374,364,7266,114,15455,22835,10171,20,0,39,59
382,ANANTAPUR,Kalyandurg,GOLLA,155,11,671,837,94,2,367,463,458,6496,99,25946,32541,15685,19,0,80,99
383,ANANTAPUR,Kalyandurg,HULIKAL,179,0,683,862,131,0,402,533,529,10009,0,26083,36092,16443,36,0,72,108
384,ANANTAPUR,Kalyandurg,KALYANDURG,62,7,1485,1554,1,0,222,223,218,27,0,3795,3822,2848,0,0,3,3
385,ANANTAPUR,Kalyandurg,KONDAPURAM,34,64,235,333,28,54,173,255,283,1500,1606,11281,14387,7434,0,1,43,44
386,ANANTAPUR,Kalyandurg,KOTTURU,219,0,775,994,169,0,296,465,523,14508,0,22575,37083,17489,56,0,98,154
387,ANANTAPUR,Kalyandurg,M.N.PALLI,258,427,1022,1707,189,354,691,1234,1617,15409,27567,52916,95892,49012,66,101,200,367
388,ANANTAPUR,Kalyandurg,MANIREVU,151,108,543,802,69,0,159,228,225,5233,0,5932,11165,5202,12,0,12,24
389,ANANTAPUR,Kalyandurg,MUDIGAL,93,1,553,647,37,0,95,132,135,1677,0,3731,5408,2604,3,0,1,4
390,ANANTAPUR,Kalyandurg,NARAYANAPURAM,139,4,429,572,89,2,250,341,348,5762,64,20290,26116,12622,14,0,61,75
391,ANANTAPUR,Kalyandurg,ONTIMIDDI,110,7,596,713,31,0,77,108,102,1675,0,4047,5722,3115,4,0,9,13
392,ANANTAPUR,Kalyandurg,PALAVOY,143,35,595,773,106,31,411,548,525,5233,2014,24191,31438,16005,6,1,42,49
393,ANANTAPUR,Kalyandurg,T.SAMUDRAM,147,56,961,1164,137,40,539,716,825,6266,1650,29210,37126,18117,11,4,88,103
394,ANANTAPUR,Kambadur,CHENNAMPALLE,240,16,867,1123,119,6,417,542,512,8348,376,26389,35113,17899,28,1,50,79
395,ANANTAPUR,Kambadur,GOLLAPALLE,178,66,538,782,111,45,321,477,516,8401,3388,24069,35858,18213,29,13,78,120
396,ANANTAPUR,Kambadur,KAMBADUR,1340,309,2646,4295,471,38,236,745,683,26598,1844,11180,39622,19925,104,5,33,142
397,ANANTAPUR,Kambadur,KARTHANAPARTHI,229,39,663,931,178,22,414,614,703,18938,1923,40126,60987,29425,96,10,195,301
398,ANANTAPUR,Kambadur,KURAKULAPALLE,133,2,760,895,63,1,277,341,299,4571,54,14526,19151,9028,15,0,31,46
399,ANANTAPUR,Kambadur,MARRIMAKULA PALLE,290,15,721,1026,161,12,267,440,403,8292,896,17295,26483,12234,19,3,80,102
400,ANANTAPUR,Kambadur,MULAKANUR,224,35,528,787,104,10,195,309,290,6593,429,13417,20439,9174,21,1,63,85
401,ANANTAPUR,Kambadur,NUTHIMADUGU,189,194,729,1112,57,75,198,330,323,4215,5555,17728,27498,14257,25,23,107,155
402,ANANTAPUR,Kambadur,PALLUR,388,225,848,1461,253,131,456,840,927,24618,8081,41782,74481,36016,141,22,182,345
403,ANANTAPUR,Kambadur,RALLA ANANTAPURAM,221,77,797,1095,99,4,329,432,431,5840,156,28577,34573,16947,16,0,128,144
404,ANANTAPUR,Kambadur,RAMPURAM,220,8,693,921,102,0,231,333,321,6802,0,16138,22940,10712,16,0,50,66
405,ANANTAPUR,Kambadur,TIMMAPURAM,574,117,1246,1937,300,17,555,872,832,25018,1051,40045,66114,33108,110,5,158,273
406,ANANTAPUR,Kanaganapalle,BHADRAPURAM,55,0,589,644,33,0,364,397,372,2733,0,26978,29711,15251,12,0,89,101
407,ANANTAPUR,Kanaganapalle,BHANUKOTA,111,3,311,425,66,1,181,248,243,2508,35,8729,11272,5750,0,0,22,22
408,ANANTAPUR,Kanaganapalle,DADULUR,126,122,773,1021,60,27,264,351,321,3628,1375,19268,24271,11702,11,0,83,94
409,ANANTAPUR,Kanaganapalle,ELUKUNTLA,89,0,427,516,71,0,271,342,350,2614,0,7520,10134,4969,0,0,4,4
410,ANANTAPUR,Kanaganapalle,KANGANAPALLE,176,8,1666,1850,118,5,1189,1312,1381,9926,240,100559,110725,54462,39,1,400,440
411,ANANTAPUR,Kanaganapalle,KONAPURAM,217,14,868,1099,139,6,670,815,766,12306,357,53251,65914,34180,52,0,186,238
412,ANANTAPUR,Kanaganapalle,KONDAPALLI,71,1,289,361,41,1,201,243,275,1182,82,16567,17831,8492,1,0,80,81
413,ANANTAPUR,Kanaganapalle,KONETINAYANIPALYAM,156,8,771,935,61,3,289,353,365,2194,108,14401,16703,8658,6,0,35,41
414,ANANTAPUR,Kanaganapalle,MADDELACHERUVU,196,68,808,1072,128,2,485,615,541,7765,57,29472,37294,18781,14,0,93,107
415,ANANTAPUR,Kanaganapalle,MAMILLAPALLI,80,0,361,441,50,0,219,269,252,2626,0,13650,16276,8528,3,0,35,38
416,ANANTAPUR,Kanaganapalle,MUKTHAPURAM,193,23,377,593,128,10,260,398,410,7197,207,17478,24882,13288,20,0,57,77
417,ANANTAPUR,Kanaganapalle,MUTHAVAKUNTLA,202,27,586,815,113,15,259,387,395,3400,530,11447,15377,7579,0,1,12,13
418,ANANTAPUR,Kanaganapalle,NARASAMPALLE,114,0,361,475,77,0,130,207,227,4011,0,6024,10035,5067,19,0,25,44
419,ANANTAPUR,Kanaganapalle,PATHAPALYAM,31,0,242,273,23,0,132,155,137,704,0,3731,4435,2272,0,0,1,1
420,ANANTAPUR,Kanaganapalle,THOGARAKUNTA,95,115,705,915,25,54,266,345,317,1233,1372,10040,12645,6683,1,2,11,14
421,ANANTAPUR,Kanaganapalle,THUMUCHERLA,209,6,981,1196,86,4,326,416,373,3153,144,13775,17072,7877,2,0,11,13
422,ANANTAPUR,Kanaganapalle,VEPAKUNTA,151,122,401,674,77,39,163,279,246,4425,2142,8912,15479,7599,4,9,17,30
423,ANANTAPUR,Kanekal,BENNIKAL,79,3,480,562,41,0,212,253,260,1535,0,6029,7564,4118,0,0,0,0
424,ANANTAPUR,Kanekal,BIDURUKUNTHAM,60,0,174,234,7,0,108,115,113,92,0,5111,5203,2934,0,0,8,8
425,ANANTAPUR,Kanekal,BRAHAMASAMUDRAM,78,0,509,587,54,0,299,353,332,1771,0,10369,12140,6655,1,0,0,1
426,ANANTAPUR,Kanekal,GANIGERA,233,1,300,534,102,0,17,119,120,3742,0,406,4148,2143,3,0,0,3
427,ANANTAPUR,Kanekal,GARUDACHEDU,210,0,330,540,103,0,48,151,142,2541,0,2349,4890,2538,0,0,6,6
428,ANANTAPUR,Kanekal,GOPULA PURAM,111,0,248,359,35,0,103,138,117,2177,0,7432,9609,4763,8,0,32,40
429,ANANTAPUR,Kanekal,HANAKANAHAL,145,3,588,736,60,3,289,352,310,1893,223,17333,19449,10664,0,2,23,25
430,ANANTAPUR,Kanekal,HULIKERA,157,26,750,933,47,0,291,338,294,2079,0,11632,13711,6422,7,0,33,40
431,ANANTAPUR,Kanekal,JAKKALAVADIKI,92,2,485,579,58,1,87,146,130,2292,41,3590,5923,3801,0,0,1,1
432,ANANTAPUR,Kanekal,KALEKURTHY,89,0,212,301,36,0,27,63,76,1299,0,1253,2552,1325,1,0,1,2
433,ANANTAPUR,Kanekal,KANEKAL,371,6,966,1343,200,0,343,543,556,7796,0,14346,22142,12548,8,0,10,18
434,ANANTAPUR,Kanekal,MALYAM,175,1,365,541,71,1,102,174,156,1402,42,4447,5891,3508,0,0,2,2
435,ANANTAPUR,Kanekal,N. HANUMAPURAM,96,0,436,532,39,0,222,261,236,452,0,8634,9086,4496,0,0,5,5
436,ANANTAPUR,Kanekal,RATCHUMARRI,98,0,557,655,35,0,320,355,351,705,0,7491,8196,4253,0,0,0,0
437,ANANTAPUR,Kanekal,SOLLAPURAM,123,0,286,409,41,0,69,110,122,1162,0,4930,6092,3146,0,0,20,20
438,ANANTAPUR,Kanekal,THUMBIGANUR,151,0,657,808,14,0,236,250,255,54,0,7480,7534,4332,0,0,8,8
439,ANANTAPUR,Kanekal,UDEGOLAM,59,0,299,358,51,0,217,268,264,2427,0,8878,11305,5906,2,0,8,10
440,ANANTAPUR,Kanekal,YERRAGUNTA,115,1,448,564,17,0,92,109,107,421,0,3374,3795,2371,0,0,2,2
441,ANANTAPUR,Kothacheruvu,BANDLAPALLE,103,91,1144,1338,21,1,225,247,217,1250,10,8401,9661,5324,1,0,6,7
442,ANANTAPUR,Kothacheruvu,BYRAPURAM,61,67,532,660,20,21,172,213,195,742,823,8291,9856,5012,0,1,18,19
443,ANANTAPUR,Kothacheruvu,IRAGAMPALLE,59,7,388,454,28,2,104,134,141,1470,18,3743,5231,2911,4,0,4,8
444,ANANTAPUR,Kothacheruvu,K.LOCHERLA,106,43,660,809,2,5,153,160,158,108,416,10410,10934,6707,1,1,35,37
445,ANANTAPUR,Kothacheruvu,K.NAGIREDDY PALLE,33,1,155,189,21,1,95,117,113,1265,94,6582,7941,4665,2,0,25,27
446,ANANTAPUR,Kothacheruvu,KESAPURAM,96,17,468,581,27,0,182,209,202,1320,0,8819,10139,5248,2,0,19,21
447,ANANTAPUR,Kothacheruvu,KODAPAGANIPALLE,46,40,437,523,26,1,220,247,241,1632,120,6872,8624,5110,6,1,5,12
448,ANANTAPUR,Kothacheruvu,KOTHACHERUVU,168,7,1948,2123,20,3,301,324,329,878,116,11451,12445,8737,1,0,26,27
449,ANANTAPUR,Kothacheruvu,LINGAREDDYPALLE,78,0,193,271,30,0,77,107,103,1612,0,4568,6180,3971,1,0,8,9
450,ANANTAPUR,Kothacheruvu,MIRZAPURAM,107,24,483,614,53,2,188,243,239,3494,68,11606,15168,7702,7,0,34,41
451,ANANTAPUR,Kothacheruvu,MYLASAMUDAM,42,0,333,375,11,0,151,162,148,411,0,8889,9300,4674,1,0,12,13
452,ANANTAPUR,Kothacheruvu,NAREPALLI,44,11,315,370,11,2,153,166,152,625,132,10419,11176,6039,1,0,28,29
453,ANANTAPUR,Kothacheruvu,POTHULAKUNTA,70,3,742,815,30,2,361,393,393,876,62,13501,14439,7355,1,0,15,16
454,ANANTAPUR,Kothacheruvu,TALAMARLA,110,4,766,880,8,0,85,93,76,127,0,4815,4942,2340,0,0,16,16
455,ANANTAPUR,Kothacheruvu,THIRUMALADEVARAPALLE,15,94,292,401,4,22,154,180,186,75,482,6497,7054,3746,0,0,5,5
456,ANANTAPUR,Kudair,ARAVAKUR,33,11,366,410,16,3,150,169,160,370,33,6452,6855,3520,0,0,13,13
457,ANANTAPUR,Kudair,CHOLASAMUDRAM,173,97,567,837,100,54,248,402,380,6500,4202,19160,29862,14899,22,16,78,116
458,ANANTAPUR,Kudair,GOTUKURU,132,2,523,657,8,0,49,57,54,230,0,2375,2605,1337,0,0,7,7
459,ANANTAPUR,Kudair,IPPERU,295,20,725,1040,139,4,276,419,429,7958,210,17469,25637,12717,16,0,53,69
460,ANANTAPUR,Kudair,JALLIPALLI,75,18,479,572,33,1,185,219,199,1977,9,11805,13791,7665,2,0,28,30
461,ANANTAPUR,Kudair,KALAGALLA,165,129,187,481,85,34,63,182,155,6757,2886,3612,13255,5929,30,14,12,56
462,ANANTAPUR,Kudair,KAMMURU,135,4,472,611,29,1,175,205,184,1685,40,10386,12111,6969,3,0,33,36
463,ANANTAPUR,Kudair,KORRAKODU,150,3,708,861,33,2,312,347,327,2575,170,20795,23540,11423,11,0,67,78
464,ANANTAPUR,Kudair,KUDAIR,352,69,1215,1636,173,17,267,457,433,12275,1226,15445,28946,14531,51,5,52,108
465,ANANTAPUR,Kudair,MARUTLA,70,16,823,909,13,5,248,266,249,422,195,14202,14819,6999,0,0,37,37
466,ANANTAPUR,Kudair,MUDDALAPURAM,187,0,369,556,117,0,180,297,321,6580,0,8908,15488,7576,16,0,20,36
467,ANANTAPUR,Kudair,P. NARAYANAPURAM,131,52,560,743,79,28,292,399,369,4130,2171,16969,23270,11097,4,4,28,36
468,ANANTAPUR,Kudair,THIMMAPURAM,231,27,419,677,66,7,96,169,165,3310,114,5411,8835,5073,6,0,10,16
469,ANANTAPUR,Kudair,UDIRIPIKONDA,56,146,624,826,13,7,191,211,197,609,253,14292,15154,7125,0,0,71,71
470,ANANTAPUR,Kundurpi,APPILEPALLE,225,7,744,976,143,2,229,374,342,9430,45,14382,23857,11147,30,0,38,68
471,ANANTAPUR,Kundurpi,BASAPURAM,170,0,522,692,98,0,229,327,313,5292,0,13735,19027,8609,13,0,43,56
472,ANANTAPUR,Kundurpi,BESTHARAPALLI,112,1,880,993,23,1,174,198,185,785,29,8331,9145,4476,1,0,17,18
473,ANANTAPUR,Kundurpi,JAMBUGUMPALA,323,0,1266,1589,136,0,176,312,304,5573,0,5429,11002,4697,11,0,15,26
474,ANANTAPUR,Kundurpi,KARIGANIPALLE,116,0,427,543,79,0,266,345,334,6909,0,26116,33025,15349,24,0,103,127
475,ANANTAPUR,Kundurpi,KUNDURPI,332,7,1634,1973,110,0,482,592,483,7370,0,35941,43311,19416,23,0,125,148
476,ANANTAPUR,Kundurpi,MAHANTHAPURAM,88,0,559,647,46,0,257,303,315,2830,0,17382,20212,10161,10,0,45,55
477,ANANTAPUR,Kundurpi,MALAYANUR,242,1,1450,1693,36,0,320,356,318,760,0,14143,14903,7233,0,0,29,29
478,ANANTAPUR,Kundurpi,NIJAVALLI,198,0,537,735,113,0,160,273,281,6373,0,8750,15123,7741,20,0,26,46
479,ANANTAPUR,Kundurpi,TENAGAL,137,7,500,644,78,2,249,329,293,6211,59,20886,27156,12228,23,0,99,122
480,ANANTAPUR,Kundurpi,TUMUKUNTA,120,2,701,823,78,0,437,515,491,6880,0,40921,47801,22734,33,0,178,211
481,ANANTAPUR,Kundurpi,YARRAKANTA,202,0,658,860,127,0,321,448,449,11440,0,25307,36747,17351,43,0,94,137
482,ANANTAPUR,Kundurpi,YENUMALADODDI,302,66,1351,1719,121,4,349,474,422,7784,322,21889,29995,14774,30,1,70,101
483,ANANTAPUR,Lepakshi,BISALAMANE PALLE,58,1,392,451,26,1,104,131,113,1037,109,5595,6741,4021,1,1,20,22
484,ANANTAPUR,Lepakshi,CHOLASAMUDRAM,111,0,365,476,26,0,98,124,65,1852,0,7715,9567,3356,11,0,52,63
485,ANANTAPUR,Lepakshi,KALLUR,174,1,432,607,71,0,67,138,102,2422,0,2170,4592,2438,5,0,3,8
486,ANANTAPUR,Lepakshi,KANCHISAMUDRAM,301,16,1231,1548,37,2,237,276,215,1791,72,14786,16649,7821,5,0,59,64
487,ANANTAPUR,Lepakshi,KODI PALLE,129,1,698,828,26,0,174,200,160,1533,0,12089,13622,7499,4,0,29,33
488,ANANTAPUR,Lepakshi,KONDUR,230,3,862,1095,45,0,147,192,125,2280,0,9624,11904,5180,6,0,34,40
489,ANANTAPUR,Lepakshi,LEPAKSHI,325,6,1843,2174,39,0,227,266,222,2812,0,13157,15969,10582,15,0,30,45
490,ANANTAPUR,Lepakshi,MANEPALLE,139,75,560,774,54,11,201,266,228,2437,516,10866,13819,7948,2,1,13,16
491,ANANTAPUR,Lepakshi,MYDUGOLAM,117,0,237,354,52,0,45,97,61,2799,0,1609,4408,1791,9,0,2,11
492,ANANTAPUR,Lepakshi,NAYANIPALLE,200,1,305,506,120,1,132,253,227,8760,36,11681,20477,10911,23,0,47,70
493,ANANTAPUR,Lepakshi,PULAMATHI,244,4,942,1190,101,1,297,399,350,7962,96,22874,30932,19994,24,0,58,82
494,ANANTAPUR,Lepakshi,SIRIVARAM,169,1,764,934,36,0,214,250,211,1991,0,13015,15006,8501,7,0,59,66
495,ANANTAPUR,Madakasira,AMIDALAGONDI,409,36,1037,1482,221,4,461,686,672,11043,161,22678,33882,18349,20,1,26,47
496,ANANTAPUR,Madakasira,BULLASAMUDRAM,204,1,440,645,19,0,133,152,132,581,0,5161,5742,3341,1,0,9,10
497,ANANTAPUR,Madakasira,C.KODIGEPALLE,267,0,379,646,56,0,149,205,179,1580,0,9018,10598,5858,0,0,25,25
498,ANANTAPUR,Madakasira,CHANDAKACHERLA,241,241,763,1245,55,63,268,386,333,3072,3100,16976,23148,10754,8,5,73,86
499,ANANTAPUR,Madakasira,CHATRAM,90,3,284,377,35,0,138,173,160,1689,0,8387,10076,5433,4,0,27,31
500,ANANTAPUR,Madakasira,GANGALAVAI PALYAM,228,1,512,741,84,0,29,113,108,3894,0,775,4669,2314,9,0,0,9
501,ANANTAPUR,Madakasira,GOVINDAPURAM,88,1,623,712,35,0,160,195,200,1827,0,7647,9474,5422,7,0,17,24
502,ANANTAPUR,Madakasira,GOWDANAHALLI,256,0,625,881,50,0,54,104,85,1936,0,1860,3796,1757,6,0,5,11
503,ANANTAPUR,Madakasira,Gundumala,169,110,371,650,0,0,0,0,0,0,0,0,0,0,0,0,0,0
504,ANANTAPUR,Madakasira,HARESAMUDRAM,255,7,1110,1372,23,0,232,255,241,629,0,7213,7842,3661,0,0,7,7
505,ANANTAPUR,Madakasira,Kadirepalli,52,47,613,712,0,0,0,0,0,0,0,0,0,0,0,0,0,0
506,ANANTAPUR,Madakasira,KALLUMARRI,308,23,1053,1384,41,2,159,202,161,2049,44,6486,8579,4056,8,0,10,18
507,ANANTAPUR,Madakasira,MADAKASIRA,825,34,1817,2676,80,0,197,277,248,3481,0,7938,11419,6580,8,0,17,25
508,ANANTAPUR,Madakasira,MANUR,191,109,563,863,2,1,100,103,86,220,12,4758,4990,2399,1,0,12,13
509,ANANTAPUR,Madakasira,MELAVOI,643,166,1567,2376,243,34,417,694,630,8877,1653,19573,30103,15270,20,9,61,90
510,ANANTAPUR,Madakasira,R.ANANTAPURAM,341,2,640,983,61,0,69,130,104,1680,0,2431,4111,1973,2,0,2,4
511,ANANTAPUR,Madakasira,YERRABOMMANAHALLI,444,21,733,1198,110,5,94,209,156,5029,208,3080,8317,3915,11,0,2,13
512,ANANTAPUR,Mudigubba,BUDANAMPALLE,73,1,449,523,39,0,102,141,170,1163,0,2709,3872,1929,0,0,1,1
513,ANANTAPUR,Mudigubba,CHINNAKOTLA,45,3,576,624,0,0,48,48,45,0,0,278,278,138,0,0,0,0
514,ANANTAPUR,Mudigubba,DORIGALLU,127,504,1304,1935,24,145,359,528,472,1021,10315,20782,32118,19887,4,38,63,105
515,ANANTAPUR,Mudigubba,EDULAPALLE,118,1,430,549,63,0,196,259,301,4672,0,10826,15498,8195,22,0,15,37
516,ANANTAPUR,Mudigubba,GANDLAVANDLAPALLE,140,9,646,795,79,3,353,435,471,3474,42,19614,23130,12057,4,0,37,41
517,ANANTAPUR,Mudigubba,GUNJEPALLE,66,253,317,636,21,143,143,307,304,1508,9578,10714,21800,11618,6,31,45,82
518,ANANTAPUR,Mudigubba,JONNALAKOTHAPALLE,222,137,473,832,109,67,116,292,255,6985,3807,6377,17169,8983,23,8,10,41
519,ANANTAPUR,Mudigubba,KODAVANDLA PALLE,39,3,549,591,6,2,285,293,303,160,169,15128,15457,8139,0,0,34,34
520,ANANTAPUR,Mudigubba,KONDAGATTUPALLI,99,440,1148,1687,49,272,505,826,818,2516,16785,28151,47452,25176,1,50,89,140
521,ANANTAPUR,Mudigubba,MALAKAVEMULA,223,33,767,1023,71,10,157,238,228,2112,292,5423,7827,4218,0,0,12,12
522,ANANTAPUR,Mudigubba,MALLEPALLI,127,89,1259,1475,49,36,450,535,542,2561,1864,28785,33210,18067,1,5,103,109
523,ANANTAPUR,Mudigubba,MANGALAMADAKA,74,213,246,533,45,125,126,296,292,2748,8848,11165,22761,12008,5,38,56,99
524,ANANTAPUR,Mudigubba,MARTHADU,83,11,779,873,27,1,171,199,221,938,2,5318,6258,3586,1,0,4,5
525,ANANTAPUR,Mudigubba,MUDIGUBBA,215,179,2358,2752,11,22,321,354,318,619,2013,25851,28483,21581,2,9,95,106
526,ANANTAPUR,Mudigubba,MUKTHAPURAM,126,143,553,822,52,40,167,259,224,2841,1391,11135,15367,8811,8,0,27,35
527,ANANTAPUR,Mudigubba,P.C.REVU,91,0,727,818,12,0,165,177,194,315,0,9537,9852,4902,0,0,25,25
528,ANANTAPUR,Mudigubba,PODARALLAPALLI,31,364,330,725,11,238,219,468,462,545,9865,7545,17955,9115,0,9,6,15
529,ANANTAPUR,Mudigubba,SANEVARIPALLE,39,77,549,665,0,1,102,103,84,0,40,4379,4419,2225,0,0,6,6
530,ANANTAPUR,Mudigubba,SANKEPALLE,180,0,1435,1615,101,0,753,854,921,4158,0,50672,54830,29213,9,0,209,218
531,ANANTAPUR,Mudigubba,THAPPETAVARIPALLI,39,7,233,279,28,2,157,187,202,2183,190,13522,15895,8376,2,0,47,49
532,ANANTAPUR,Mudigubba,UPPALAPADU,109,0,472,581,41,0,194,235,238,1294,0,9506,10800,5618,1,0,15,16
533,ANANTAPUR,Nallacheruvu,ALLUGUNDU,95,10,470,575,35,4,165,204,179,1679,189,9676,11544,6954,5,0,39,44
534,ANANTAPUR,Nallacheruvu,JOGANNAPETA,89,7,270,366,20,3,129,152,129,1177,179,8635,9991,5979,4,1,35,40
535,ANANTAPUR,Nallacheruvu,KADIRIPULAKUNTA,62,1,458,521,28,0,151,179,166,1866,0,10471,12337,8964,12,0,55,67
536,ANANTAPUR,Nallacheruvu,M.AGRAHARAM(S.M.PALLI),65,0,213,278,45,0,119,164,145,3144,0,7007,10151,5375,9,0,26,35
537,ANANTAPUR,Nallacheruvu,MADDIMADUGU,26,0,193,219,11,0,109,120,116,891,0,6520,7411,4559,5,0,22,27
538,ANANTAPUR,Nallacheruvu,NALLACHERUVU,148,31,1151,1330,64,3,165,232,194,2820,133,9382,12335,7688,6,0,38,44
539,ANANTAPUR,Nallacheruvu,ORAVOY,238,7,687,932,105,1,110,216,186,4886,11,7140,12037,6860,9,0,30,39
540,ANANTAPUR,Nallacheruvu,P.KOTHAPALLI,17,247,371,635,6,58,201,265,254,573,2955,11631,15159,8738,4,6,30,40
541,ANANTAPUR,Nallacheruvu,PANTHULACHERUVU,41,19,252,312,34,9,139,182,163,2601,546,10289,13436,8690,9,1,48,58
542,ANANTAPUR,Nallacheruvu,TALAMARLAVANDLAPALLI,118,20,463,601,42,5,166,213,199,2497,556,12543,15596,11390,8,2,61,71
543,ANANTAPUR,Nallacheruvu,TAVALAMARRI,56,0,369,425,26,0,197,223,196,1092,0,15051,16143,8770,3,0,75,78
544,ANANTAPUR,Nallacheruvu,UBICHERLA,122,17,605,744,34,4,176,214,236,2096,310,9658,12064,8998,4,1,38,43
545,ANANTAPUR,Nallamada,CHARUPALLI,75,16,559,650,36,3,168,207,189,1267,113,11008,12388,6876,0,0,49,49
546,ANANTAPUR,Nallamada,DONNIKOTA,193,44,1100,1337,74,21,432,527,486,3845,1536,28168,33549,17349,10,7,84,101
547,ANANTAPUR,Nallamada,GOPEPALLI,74,82,404,560,28,43,143,214,192,805,2355,6639,9799,5161,0,5,18,23
548,ANANTAPUR,Nallamada,KURUMALA,166,22,569,757,69,5,76,150,138,4082,176,3222,7480,4049,18,1,10,29
549,ANANTAPUR,Nallamada,MASAKAVANKAPALLI,67,53,356,476,36,25,115,176,156,1638,1128,5236,8002,4504,1,0,5,6
550,ANANTAPUR,Nallamada,NALLAMADA,288,416,1801,2505,142,129,348,619,562,9748,5380,20362,35490,20761,48,11,87,146
551,ANANTAPUR,Nallamada,PATHABATHALAPALLI,142,46,1122,1310,49,12,438,499,505,2794,122,34811,37727,20255,6,0,154,160
552,ANANTAPUR,Nallamada,PULAGAMPALLI,68,43,378,489,19,0,111,130,117,858,0,4678,5536,3305,2,0,7,9
553,ANANTAPUR,Nallamada,REDDIPALLI,104,218,805,1127,70,75,368,513,507,5126,5565,21779,32470,18282,25,28,44,97
554,ANANTAPUR,Nallamada,VANKARAKUNTA,102,17,555,674,14,4,162,180,158,569,72,8188,8829,4490,1,0,33,34
555,ANANTAPUR,Nallamada,VELLAMADDI,33,247,167,447,26,187,115,328,357,2299,12201,5941,20441,10593,11,28,5,44
556,ANANTAPUR,Nallamada,YERRAVANKAPALLI,51,121,508,680,18,69,219,306,313,672,3870,11029,15571,8508,0,5,24,29
557,ANANTAPUR,Nambulipulikunta,BALIJA PALLI,50,45,229,324,28,12,79,119,108,1501,368,6263,8132,4515,3,0,31,34
558,ANANTAPUR,Nambulipulikunta,DHANIYANICHERUVU,49,13,576,638,32,5,279,316,268,968,234,15622,16824,9449,1,0,40,41
559,ANANTAPUR,Nambulipulikunta,EASTNADIMPALLI,98,4,446,548,40,0,208,248,236,2817,0,16067,18884,10235,11,0,86,97
560,ANANTAPUR,Nambulipulikunta,EDURUDONA,76,3,603,682,32,1,323,356,318,1730,28,22964,24722,15287,7,0,98,105
561,ANANTAPUR,Nambulipulikunta,GOWKANAPALLE,55,6,452,513,39,2,235,276,242,2163,107,16726,18996,11874,5,0,77,82
562,ANANTAPUR,Nambulipulikunta,MARRIKOMMADINNE,49,2,601,652,30,0,360,390,346,1226,0,24973,26199,13922,2,0,109,111
563,ANANTAPUR,Nambulipulikunta,MEKALACHERUVU,89,83,572,744,37,55,270,362,343,1517,3816,16196,21529,11411,4,15,28,47
564,ANANTAPUR,Nambulipulikunta,NAMBULAPULIKUNTA,156,6,426,588,53,0,121,174,148,2557,0,6951,9508,5331,4,0,18,22
565,ANANTAPUR,Nambulipulikunta,P.KOTHAPALLI,64,28,587,679,30,15,268,313,281,1866,1078,19529,22473,12644,3,5,63,71
566,ANANTAPUR,Nambulipulikunta,PEDABALLI,26,61,362,449,13,21,167,201,189,737,427,10531,11695,7248,4,0,35,39
567,ANANTAPUR,Nambulipulikunta,VANKAMADDI,4,10,308,322,4,4,162,170,156,179,246,11498,11923,6647,0,0,54,54
568,ANANTAPUR,Nambulipulikunta,VELICHELIMALA,60,151,307,518,40,94,150,284,263,2274,9070,11630,22974,12413,5,43,47,95
569,ANANTAPUR,Nambulipulikunta,WEST NADIM PALLI,3,39,453,495,0,25,273,298,297,0,3651,24913,28564,15525,0,20,113,133
570,ANANTAPUR,Narpala,B.PAPPUR,175,98,788,1061,48,43,220,311,316,2948,3756,14988,21692,13105,9,18,62,89
571,ANANTAPUR,Narpala,BANDLAPALLE,137,0,840,977,80,0,499,579,556,4073,0,25692,29765,15334,4,0,56,60
572,ANANTAPUR,Narpala,BONDALAWADA,200,18,623,841,115,6,228,349,311,5384,337,9975,15696,8058,9,1,12,22
573,ANANTAPUR,Narpala,CHAMALURU,77,0,510,587,38,0,276,314,312,1454,0,13850,15304,9049,0,0,17,17
574,ANANTAPUR,Narpala,DUGGUMARRI,235,64,775,1074,136,38,458,632,626,9654,1928,33541,45123,23773,25,3,108,136
575,ANANTAPUR,Narpala,GADAMNAGEPALLE,141,0,448,589,14,0,144,158,158,475,0,11234,11709,5959,0,0,64,64
576,ANANTAPUR,Narpala,GANGANAPALLE,178,17,648,843,111,8,285,404,389,9031,385,17882,27298,12733,42,0,57,99
577,ANANTAPUR,Narpala,GUGUDU,306,6,807,1119,138,0,386,524,506,8533,0,34369,42902,21130,29,0,138,167
578,ANANTAPUR,Narpala,GUNJEPALLE,109,3,333,445,62,1,205,268,280,6231,35,20186,26452,13037,37,0,113,150
579,ANANTAPUR,Narpala,H.SODANAPALLE,160,0,319,479,123,0,217,340,353,11666,0,21736,33402,15357,51,0,100,151
580,ANANTAPUR,Narpala,KESEPALLE,313,4,938,1255,190,0,223,413,438,14368,0,14188,28556,14051,59,0,46,105
581,ANANTAPUR,Narpala,NADIMIDODDI,151,0,399,550,85,0,270,355,362,3532,0,21501,25033,12280,6,0,105,111
582,ANANTAPUR,Narpala,NARPALA,736,116,4940,5792,66,3,740,809,741,3619,147,37970,41736,24642,9,0,73,82
583,ANANTAPUR,Narpala,NAYANAPALLE,78,1,500,579,46,1,348,395,541,2733,107,26703,29543,15299,9,1,117,127
584,ANANTAPUR,Narpala,RANGAPURAM,14,0,550,564,5,0,386,391,388,670,0,46508,47178,22473,4,0,227,231
585,ANANTAPUR,Narpala,SIDDARACHERLA,377,19,508,904,157,3,133,293,275,7704,127,7281,15112,8367,17,0,21,38
586,ANANTAPUR,Narpala,VENKATAMPALLE,137,0,369,506,91,0,176,267,274,7864,0,15589,23453,12547,49,0,92,141
587,ANANTAPUR,Obuladevaracheruvu,ALLAPALLI,209,3,1345,1557,80,2,315,397,350,6030,35,16359,22424,11972,23,0,33,56
588,ANANTAPUR,Obuladevaracheruvu,CHINTHAMANIPALLI,26,13,459,498,16,8,217,241,228,1069,542,14471,16082,8292,2,1,56,59
589,ANANTAPUR,Obuladevaracheruvu,DABURUVARIPALLI,93,1,824,918,38,0,233,271,270,1611,0,13269,14880,9483,1,0,34,35
590,ANANTAPUR,Obuladevaracheruvu,ENAGALORE,70,26,736,832,24,15,168,207,194,566,865,7485,8916,4523,1,5,24,30
591,ANANTAPUR,Obuladevaracheruvu,KONDAKAMARLA,386,468,1202,2056,178,237,411,826,796,9938,17374,22333,49645,25277,22,73,57,152
592,ANANTAPUR,Obuladevaracheruvu,MAMILLAKUNTLAPALLI,39,0,469,508,14,0,104,118,117,705,0,4941,5646,3463,2,0,6,8
593,ANANTAPUR,Obuladevaracheruvu,MITTAPALLI,39,26,676,741,6,2,150,158,146,66,18,5272,5356,2710,0,0,3,3
594,ANANTAPUR,Obuladevaracheruvu,OBULADEVARA CHERUVU,221,14,865,1100,105,2,311,418,404,6193,57,17801,24051,16380,21,0,49,70
595,ANANTAPUR,Obuladevaracheruvu,SUNNAMPALLI,175,1,1256,1432,93,0,410,503,505,4522,0,18808,23330,12697,16,0,21,37
596,ANANTAPUR,Obuladevaracheruvu,TANGEDAKUNTA,233,4,1058,1295,135,1,344,480,465,8037,28,19701,27766,14273,28,0,57,85
597,ANANTAPUR,Obuladevaracheruvu,THIPPEPALLI,64,54,352,470,34,41,164,239,226,1721,3657,10719,16097,8621,3,12,33,48
598,ANANTAPUR,Obuladevaracheruvu,THUMMALAKUNTLAPALLI,154,17,826,997,66,3,107,176,166,3564,85,5405,9054,5142,8,0,15,23
599,ANANTAPUR,Obuladevaracheruvu,VENKATAPURAM,77,23,738,838,43,14,325,382,352,2119,924,15706,18749,8963,7,3,39,49
600,ANANTAPUR,Pamidi,ANUMPALLE,20,1,338,359,11,1,264,276,282,949,60,19406,20415,11887,5,0,62,67
601,ANANTAPUR,Pamidi,DEVARAPALLE,103,1,519,623,30,1,198,229,201,919,101,9411,10431,5859,0,1,22,23
602,ANANTAPUR,Pamidi,DIBBASANI PALLE,0,1,195,196,0,0,132,132,121,0,0,7856,7856,3958,0,0,21,21
603,ANANTAPUR,Pamidi,EDDULAPALLE,141,35,685,861,70,6,120,196,189,3958,127,5226,9311,5091,7,0,11,18
604,ANANTAPUR,Pamidi,EDURURU,192,0,240,432,126,0,129,255,246,8691,0,6797,15488,8655,14,0,7,21
605,ANANTAPUR,Pamidi,GAJARAMPALLE,134,1,356,491,104,1,92,197,210,6579,138,4553,11270,5695,14,1,5,20
606,ANANTAPUR,Pamidi,GULIMIKONDLA KOTTALA,67,6,460,533,50,4,197,251,247,2044,21,4931,6996,3945,1,0,1,2
607,ANANTAPUR,Pamidi,KANDLAPALLE,93,2,364,459,70,1,238,309,299,3430,24,13704,17158,8678,4,0,12,16
608,ANANTAPUR,Pamidi,KATRIMALA,131,1,372,504,82,1,205,288,278,5109,62,9721,14892,7503,12,0,12,24
609,ANANTAPUR,Pamidi,KATTAKINDA PALLE,14,0,293,307,9,0,182,191,199,431,0,7023,7454,4236,0,0,4,4
610,ANANTAPUR,Pamidi,KHADARPETA,81,1,216,298,58,1,137,196,172,2925,96,7258,10279,5539,4,0,10,14
611,ANANTAPUR,Pamidi,NEELUR,88,7,262,357,65,7,134,206,204,3563,371,6718,10652,5174,5,0,6,11
612,ANANTAPUR,Pamidi,PALYAM,125,1,544,670,69,0,233,302,277,1922,0,8175,10097,4967,1,0,5,6
613,ANANTAPUR,Pamidi,PALYAM THANDA,5,644,234,883,0,308,134,442,446,0,12532,8373,20905,11007,0,14,13,27
614,ANANTAPUR,Pamidi,PAMIDI,504,14,1673,2191,148,1,100,249,240,5634,56,4061,9751,6642,12,0,4,16
615,ANANTAPUR,Pamidi,RAMAGIRI,19,275,399,693,16,20,215,251,291,644,549,12545,13738,7400,0,0,22,22
616,ANANTAPUR,Pamidi,RAMARAJUPALLE,1,1,405,407,0,0,174,174,157,0,0,11241,11241,5795,0,0,41,41
617,ANANTAPUR,Pamidi,SORAKAYALAPETA,13,0,269,282,12,0,156,168,156,825,0,11412,12237,5868,5,0,46,51
618,ANANTAPUR,Pamidi,VANKARAJUKALVA,85,0,522,607,53,0,210,263,225,3142,0,7709,10851,5566,4,0,6,10
619,ANANTAPUR,Parigi,BEECHIGANIPALLE,305,1,644,950,105,0,186,291,270,8348,0,11506,19854,9178,38,0,49,87
620,ANANTAPUR,Parigi,HONNAMPALLI,31,3,385,419,15,2,79,96,86,1072,344,4875,6291,3025,5,2,22,29
621,ANANTAPUR,Parigi,KODIGENAHALLI,124,6,864,994,26,0,184,210,183,1111,0,6185,7296,3848,2,0,7,9
622,ANANTAPUR,Parigi,MODA,521,5,655,1181,132,0,115,247,214,6873,0,6885,13758,8551,22,0,20,42
623,ANANTAPUR,Parigi,P.NARASAPURAM,184,0,539,723,73,0,230,303,278,5636,0,13899,19535,10134,26,0,24,50
624,ANANTAPUR,Parigi,PARIGI,387,17,1408,1812,50,2,329,381,349,3629,128,25885,29642,17921,17,1,128,146
625,ANANTAPUR,Parigi,PYDETI,75,0,423,498,31,0,156,187,158,1264,0,5124,6388,3226,2,0,9,11
626,ANANTAPUR,Parigi,S.RANGARAJULAPALLY,282,2,667,951,91,0,191,282,231,3562,0,12325,15887,9802,5,0,48,53
627,ANANTAPUR,Parigi,SASANAKOTA,149,0,180,329,39,0,49,88,71,2841,0,3805,6646,3178,19,0,13,32
628,ANANTAPUR,Parigi,SEEGIPALLE,106,1,527,634,70,1,285,356,353,6615,21,25445,32081,15277,31,0,107,138
629,ANANTAPUR,Parigi,SIREKOLAM,151,4,401,556,24,2,161,187,156,679,102,11239,12020,6395,2,1,45,48
630,ANANTAPUR,Parigi,UTAKUR,307,0,731,1038,117,0,183,300,268,5965,0,9021,14986,8240,14,0,24,38
631,ANANTAPUR,Parigi,VITTAPALLE,73,0,236,309,44,0,32,76,70,3150,0,1469,4619,2372,19,0,0,19
632,ANANTAPUR,Parigi,YERRAGUNTA,131,0,517,648,38,0,163,201,192,1469,0,8805,10274,5816,4,0,24,28
633,ANANTAPUR,Peddapappur,AMMALADINNE,157,0,191,348,58,0,31,89,92,1727,0,1049,2776,2732,0,0,1,1
634,ANANTAPUR,Peddapappur,CHAGALLU,64,0,218,282,50,0,145,195,196,3256,0,8919,12175,9510,6,0,29,35
635,ANANTAPUR,Peddapappur,CHEEMULAVAGU PALLI,59,0,287,346,35,0,109,144,139,1596,0,5118,6714,5905,1,0,2,3
636,ANANTAPUR,Peddapappur,CHIKKEPALLI,10,0,330,340,7,0,182,189,168,280,0,10673,10953,6027,0,0,11,11
637,ANANTAPUR,Peddapappur,CHINNAYEKKULURU,100,1,478,579,76,0,359,435,440,5137,0,24609,29746,15482,8,0,38,46
638,ANANTAPUR,Peddapappur,DEVANUPPALAPADU,67,1,294,362,52,0,220,272,302,1405,0,11426,12831,7231,1,0,26,27
639,ANANTAPUR,Peddapappur,DHARMAPURAM,12,0,323,335,0,0,36,36,30,0,0,578,578,342,0,0,0,0
640,ANANTAPUR,Peddapappur,GARLADINNE,57,0,215,272,46,0,164,210,205,2648,0,6298,8946,5059,8,0,9,17
641,ANANTAPUR,Peddapappur,JUTUR,143,6,517,666,35,0,169,204,210,1240,0,6524,7764,5679,2,0,5,7
642,ANANTAPUR,Peddapappur,KUMMETHA,108,0,294,402,19,0,82,101,97,340,0,2829,3169,2418,0,0,2,2
643,ANANTAPUR,Peddapappur,MUCHUKOTA,216,0,383,599,65,0,104,169,168,1588,0,1708,3296,2909,0,0,0,0
644,ANANTAPUR,Peddapappur,NAMANANKA PALLI,3,0,242,245,0,0,123,123,115,0,0,8175,8175,5611,0,0,29,29
645,ANANTAPUR,Peddapappur,NARASAPURAM,101,26,494,621,42,0,114,156,154,839,0,4916,5755,5022,1,0,5,6
646,ANANTAPUR,Peddapappur,P.CHERLOPALLI,20,1,277,298,10,0,167,177,184,203,0,2377,2580,1397,0,0,2,2
647,ANANTAPUR,Peddapappur,PASALUR,114,1,269,384,62,0,85,147,141,2011,0,4491,6502,4189,2,0,7,9
648,ANANTAPUR,Peddapappur,PEDDAPAPPUR,151,12,738,901,9,0,99,108,104,131,0,2817,2948,1883,0,0,3,3
649,ANANTAPUR,Peddapappur,PEDDAYEKKULURU,122,4,298,424,77,2,166,245,242,2105,35,4820,6960,4425,0,0,3,3
650,ANANTAPUR,Peddapappur,SOMMANA PALLI,216,0,238,454,12,0,32,44,43,675,0,1934,2609,1746,1,0,1,2
651,ANANTAPUR,Peddapappur,TABJULA,108,0,495,603,79,0,283,362,379,6292,0,21079,27371,15716,31,0,110,141
652,ANANTAPUR,Peddapappur,VARADAYA PALLI,2,0,447,449,0,0,186,186,187,0,0,6899,6899,5668,0,0,6,6
653,ANANTAPUR,Peddavadugur,A.TIMMAPURAM,4,12,421,437,1,1,258,260,234,43,1,17896,17940,10431,0,0,56,56
654,ANANTAPUR,Peddavadugur,APPECHERLA,97,0,387,484,28,0,86,114,111,871,0,5319,6190,3303,1,0,15,16
655,ANANTAPUR,Peddavadugur,BHEEMUNIPALLI,119,0,298,417,35,0,121,156,143,1644,0,7152,8796,5483,5,0,22,27
656,ANANTAPUR,Peddavadugur,BURNAKUNTA,0,0,354,354,0,0,225,225,220,0,0,7517,7517,4071,0,0,19,19
657,ANANTAPUR,Peddavadugur,CHINNAVADUGUR,85,0,320,405,54,0,163,217,193,2560,0,8085,10645,5612,2,0,19,21
658,ANANTAPUR,Peddavadugur,CHINTHALA CHERUVU,46,1,317,364,18,0,176,194,190,1333,0,13574,14907,8357,3,0,64,67
659,ANANTAPUR,Peddavadugur,CHITRACHEDU,122,3,561,686,54,0,287,341,313,1489,0,12268,13757,8297,1,0,9,10
660,ANANTAPUR,Peddavadugur,CHITTOOR,99,0,419,518,66,0,240,306,308,3642,0,13736,17378,10056,5,0,21,26
661,ANANTAPUR,Peddavadugur,DIMMAGUDI,175,3,415,593,138,0,236,374,392,6223,0,7848,14071,7208,7,0,20,27
662,ANANTAPUR,Peddavadugur,G.VENKATAMPALLI,98,2,224,324,51,0,129,180,164,2990,0,8901,11891,6205,9,0,41,50
663,ANANTAPUR,Peddavadugur,GOOTY ANANTHAPURAM,120,0,246,366,56,0,105,161,142,3143,0,5130,8273,4678,11,0,13,24
664,ANANTAPUR,Peddavadugur,KANDLAGUDURU,126,0,263,389,82,0,123,205,200,5724,0,6639,12363,7830,30,0,22,52
665,ANANTAPUR,Peddavadugur,KASEPALLI,0,0,338,338,0,0,112,112,98,0,0,4259,4259,2507,0,0,16,16
666,ANANTAPUR,Peddavadugur,KRISTIPADU,244,4,752,1000,54,4,111,169,154,3053,48,6510,9611,5567,10,0,25,35
667,ANANTAPUR,Peddavadugur,LAXIMPALLI,156,0,323,479,102,0,52,154,146,8094,0,2762,10856,5477,41,0,12,53
668,ANANTAPUR,Peddavadugur,MALLENIPALLI,65,0,224,289,42,0,113,155,141,2108,0,6313,8421,4227,9,0,21,30
669,ANANTAPUR,Peddavadugur,MEDIMAKULAPALLE,28,0,438,466,5,0,130,135,128,178,0,8738,8916,5122,0,0,25,25
670,ANANTAPUR,Peddavadugur,MIDTURU,182,2,213,397,102,0,101,203,214,5844,0,2616,8460,5444,13,0,3,16
671,ANANTAPUR,Peddavadugur,MUPPALAGUTTI,56,5,290,351,37,1,119,157,150,1918,21,5892,7831,4328,3,0,2,5
672,ANANTAPUR,Peddavadugur,P.KOTTALAPALLI,21,0,295,316,17,0,88,105,97,944,0,4025,4969,2881,2,0,3,5
673,ANANTAPUR,Peddavadugur,P.VERANNAPALLI,215,2,240,457,167,0,8,175,191,11933,0,179,12112,6647,39,0,0,39
674,ANANTAPUR,Peddavadugur,PEDDAVADUGUR,280,4,647,931,144,0,194,338,305,8342,0,12187,20529,10635,11,0,21,32
675,ANANTAPUR,Peddavadugur,RAMPURAM,0,0,158,158,0,0,88,88,73,0,0,5212,5212,3127,0,0,14,14
676,ANANTAPUR,Peddavadugur,RAVULUDIKI,155,0,439,594,82,0,226,308,308,4988,0,8168,13156,7957,17,0,10,27
677,ANANTAPUR,Peddavadugur,VIRUPAPURAM,204,4,288,496,130,3,139,272,252,5691,176,7195,13062,7566,4,0,21,25
678,ANANTAPUR,Penu Konda,ADADAKULAPALLE,104,172,223,499,50,51,51,152,142,4077,3191,3194,10462,6162,19,8,15,42
679,ANANTAPUR,Penu Konda,DUDDEBANDA,143,3,766,912,28,1,204,233,194,1799,7,16838,18644,9182,5,0,95,100
680,ANANTAPUR,Penu Konda,GONIPETA,47,122,193,362,21,7,108,136,119,1530,330,7897,9757,5016,9,1,34,44
681,ANANTAPUR,Penu Konda,GUTTURU,131,4,867,1002,62,0,272,334,284,4512,0,19397,23909,13174,19,0,83,102
682,ANANTAPUR,Penu Konda,KONAPURAM,203,100,434,737,107,49,159,315,264,8518,4677,14111,27306,15149,47,25,85,157
683,ANANTAPUR,Penu Konda,KURUBAVANDLA PALLI,78,0,473,551,32,0,200,232,211,2353,0,12801,15154,8249,8,0,46,54
684,ANANTAPUR,Penu Konda,MAVATURU,102,2,477,581,75,0,310,385,326,7608,0,26742,34350,18131,41,0,152,193
685,ANANTAPUR,Penu Konda,MUNIMADUGU,184,12,883,1079,57,7,421,485,442,3247,563,31356,35166,17164,11,3,148,162
686,ANANTAPUR,Penu Konda,NAGALURU,191,1,558,750,51,0,90,141,124,3159,0,7228,10387,6090,12,0,39,51
687,ANANTAPUR,Penu Konda,PENUKONDA,259,114,1130,1503,35,8,90,133,122,2060,413,5430,7903,4494,7,0,22,29
688,ANANTAPUR,Penu Konda,RAMPURAM,117,148,1023,1288,37,75,288,400,314,2698,6829,22600,32127,14427,12,43,106,161
689,ANANTAPUR,Penu Konda,SETTIPALLE,83,161,319,563,33,60,183,276,217,2466,3805,13945,20216,9544,11,13,68,92
690,ANANTAPUR,Penu Konda,VENKATAGIRI PALEM,67,47,334,448,14,28,119,161,131,1037,1709,8553,11299,5845,6,6,49,61
691,ANANTAPUR,Penu Konda,VENKATAREDDYPALLI,195,9,677,881,51,0,231,282,243,3691,0,16779,20470,13821,20,0,59,79
692,ANANTAPUR,Putlur,ARKATIVEMULA,214,1,120,335,111,0,27,138,147,8233,0,1209,9442,7025,26,0,0,26
693,ANANTAPUR,Putlur,BALAPURAM,125,0,564,689,87,0,461,548,529,9526,0,59664,69190,33747,46,0,299,345
694,ANANTAPUR,Putlur,C.VENGANNAPALLI,51,0,380,431,14,0,94,108,109,1110,0,10952,12062,6268,5,0,62,67
695,ANANTAPUR,Putlur,CHALAVEMULA,81,0,361,442,48,0,204,252,232,2735,0,14697,17432,10509,2,0,28,30
696,ANANTAPUR,Putlur,CHERLOPALLI,58,0,296,354,33,0,135,168,166,2161,0,5954,8115,5633,4,0,5,9
697,ANANTAPUR,Putlur,CHINTALAPALLI,197,0,432,629,101,0,227,328,325,6462,0,15302,21764,12259,9,0,35,44
698,ANANTAPUR,Putlur,DOSALEDU,148,0,281,429,42,0,6,48,45,2598,0,268,2866,1486,8,0,0,8
699,ANANTAPUR,Putlur,ELLUTLA,191,0,468,659,47,0,138,185,163,1717,0,7993,9710,4974,1,0,27,28
700,ANANTAPUR,Putlur,GANDLAPADU,53,0,319,372,27,0,146,173,150,1315,0,10113,11428,7728,1,0,24,25
701,ANANTAPUR,Putlur,JANGAMREDDIPETA,0,0,165,165,0,0,11,11,8,0,0,90,90,56,0,0,0,0
702,ANANTAPUR,Putlur,KADAVAKAL,265,14,746,1025,61,0,196,257,257,1620,0,8270,9890,7070,1,0,9,10
703,ANANTAPUR,Putlur,KANDIKAPULA,41,0,372,413,29,0,222,251,255,2215,0,16610,18825,11255,6,0,66,72
704,ANANTAPUR,Putlur,KOMATIKUNTLA,102,0,448,550,63,0,154,217,197,5420,0,11986,17406,9666,21,0,45,66
705,ANANTAPUR,Putlur,KONDAPURAM,1,0,185,186,0,0,59,59,61,0,0,3484,3484,2422,0,0,10,10
706,ANANTAPUR,Putlur,KONDEPALLI,45,0,50,95,7,0,3,10,9,162,0,5,167,103,0,0,0,0
707,ANANTAPUR,Putlur,KUMMANAMALA,47,1,383,431,30,0,227,257,262,2112,0,17522,19634,10101,3,0,59,62
708,ANANTAPUR,Putlur,MADDIPALLI,25,0,481,506,14,0,108,122,111,1009,0,6507,7516,3474,4,0,9,13
709,ANANTAPUR,Putlur,MADUGUPALLI,60,0,364,424,40,0,108,148,137,2348,0,5746,8094,3876,9,0,20,29
710,ANANTAPUR,Putlur,PUTLUR,176,2,1019,1197,62,0,591,653,626,5631,0,61653,67284,37312,30,0,300,330
711,ANANTAPUR,Putlur,RANGARAJUKUNTA,86,0,137,223,0,0,1,1,1,0,0,6,6,3,0,0,0,0
712,ANANTAPUR,Putlur,S.GUDUR,163,0,375,538,74,0,164,238,241,3646,0,12661,16307,10907,2,0,54,56
713,ANANTAPUR,Putlur,SUREPALLI,156,0,387,543,48,0,63,111,101,801,0,2026,2827,1709,0,0,0,0
714,ANANTAPUR,Putlur,TAKKALLAPALLI,137,1,238,376,48,0,97,145,137,2904,0,6685,9589,7463,11,0,29,40
715,ANANTAPUR,Puttaparthi,AMAGONDAPALEM,30,39,420,489,2,27,67,96,105,43,1593,2869,4505,2337,0,6,3,9
716,ANANTAPUR,Puttaparthi,BADENAIK THANDA,0,201,6,207,0,122,3,125,118,0,8704,116,8820,5350,0,24,1,25
717,ANANTAPUR,Puttaparthi,BATHALAPALLI,26,57,447,530,8,21,216,245,251,112,1029,9811,10952,6109,0,1,7,8
718,ANANTAPUR,Puttaparthi,BEEDUPALLE,40,5,430,475,8,0,208,216,204,588,0,16773,17361,12271,2,0,90,92
719,ANANTAPUR,Puttaparthi,BRAHMANAPALLE,74,102,253,429,10,57,86,153,139,427,3099,5120,8646,6620,2,10,22,34
720,ANANTAPUR,Puttaparthi,CHERLOPALLI,50,11,638,699,7,2,344,353,374,70,54,10535,10659,5713,0,0,0,0
721,ANANTAPUR,Puttaparthi,DIGUVACHERLOPALLI,95,54,566,715,20,16,249,285,293,641,205,9185,10031,5728,0,0,5,5
722,ANANTAPUR,Puttaparthi,ERAGARAJUPALLE,23,0,177,200,11,0,94,105,101,958,0,6987,7945,3866,6,0,35,41
723,ANANTAPUR,Puttaparthi,JAGARALUPALLE,93,11,255,359,13,2,63,78,66,158,31,3380,3569,1877,0,0,13,13
724,ANANTAPUR,Puttaparthi,KAPPALA BANDA,47,28,174,249,17,3,47,67,55,667,162,1847,2676,1592,1,0,2,3
725,ANANTAPUR,Puttaparthi,KOTLAPALLE,71,3,222,296,27,3,101,131,136,1526,339,7956,9821,5282,6,2,40,48
726,ANANTAPUR,Puttaparthi,NIDIMAMIDI,193,54,719,966,93,25,370,488,461,5513,930,19648,26091,13422,22,1,56,79
727,ANANTAPUR,Puttaparthi,PAIPALLE,64,1,155,220,4,0,8,12,4,14,0,14,28,10,0,0,0,0
728,ANANTAPUR,Puttaparthi,PEDABALLI,84,486,932,1502,38,83,462,583,595,2292,3296,19733,25321,13445,4,2,8,14
729,ANANTAPUR,Puttaparthi,PUTTAPARTHI,54,36,958,1048,2,14,261,277,276,65,849,14114,15028,9872,0,4,30,34
730,ANANTAPUR,Puttaparthi,RACHUVARIPALLE,113,4,215,332,68,0,134,202,200,4849,0,8525,13374,7353,18,0,27,45
731,ANANTAPUR,Puttaparthi,VENGALAMMACHERUVU,120,16,852,988,1,2,394,397,399,34,123,24292,24449,14678,0,1,83,84
732,ANANTAPUR,Puttaparthi,VENKATAGARIPALLE,44,6,183,233,12,6,69,87,70,744,544,4703,5991,2968,1,3,20,24
733,ANANTAPUR,Puttaparthi,YENUMALAPALLE,143,12,558,713,37,1,214,252,245,2294,107,14985,17386,14196,6,1,64,71
734,ANANTAPUR,Ramagiri,GANTHIMARRI,97,0,805,902,38,0,336,374,361,1601,0,13144,14745,8907,2,0,19,21
735,ANANTAPUR,Ramagiri,KONDAPURAM,205,1,517,723,121,0,207,328,303,8498,0,14361,22859,11358,28,0,47,75
736,ANANTAPUR,Ramagiri,KUNTIMADDI,151,153,1190,1494,40,61,320,421,387,1530,2416,12343,16289,8710,1,1,25,27
737,ANANTAPUR,Ramagiri,MADAPURAM,397,9,640,1046,114,1,252,367,319,3497,31,10837,14365,7354,2,0,20,22
738,ANANTAPUR,Ramagiri,MOTARCHINTALAPALLE,483,3,1005,1491,146,1,119,266,232,9335,180,6612,16127,7925,35,1,21,57
739,ANANTAPUR,Ramagiri,NASANAKOTA,429,29,995,1453,118,23,370,511,460,5986,2250,21361,29597,16269,11,17,53,81
740,ANANTAPUR,Ramagiri,PERUR,396,6,1773,2175,93,0,396,489,433,3969,0,13866,17835,8995,12,0,31,43
741,ANANTAPUR,Ramagiri,POLEPALLE,142,62,1133,1337,74,27,580,681,642,3464,1154,26751,31369,16076,3,3,46,52
742,ANANTAPUR,Ramagiri,RAMAGIRI,253,81,1038,1372,94,27,293,414,361,5856,1347,17741,24944,12546,31,2,70,103
743,ANANTAPUR,Raptadu,BANDAMEEDAPALLE,175,1,1089,1265,80,0,417,497,435,3180,0,16634,19814,9492,8,0,30,38
744,ANANTAPUR,Raptadu,BHOGINEPALLI,85,3,301,389,52,0,153,205,187,2964,0,9150,12114,6166,5,0,14,19
745,ANANTAPUR,Raptadu,BOMMEPARTHY,89,8,486,583,38,1,119,158,168,2499,27,9184,11710,7229,4,0,40,44
746,ANANTAPUR,Raptadu,BUKKACHERLA,92,3,369,464,52,0,144,196,182,2975,0,8273,11248,6237,3,0,10,13
747,ANANTAPUR,Raptadu,CHERLOPALLE,44,56,608,708,13,38,186,237,212,487,929,6410,7826,4228,1,0,6,7
748,ANANTAPUR,Raptadu,GANDLAPARTHY,123,4,369,496,7,0,67,74,57,362,0,1447,1809,1027,1,0,2,3
749,ANANTAPUR,Raptadu,GOLLAPALLE,80,51,255,386,66,24,194,284,278,3065,1791,9892,14748,7750,4,7,5,16
750,ANANTAPUR,Raptadu,GONDIREDDIPALLE,62,3,456,521,19,0,108,127,112,1048,0,6151,7199,4131,1,0,8,9
751,ANANTAPUR,Raptadu,HAMPAPURAM,160,1,465,626,79,0,245,324,312,5104,0,16291,21395,11915,6,0,13,19
752,ANANTAPUR,Raptadu,KOTHAPALLI,40,0,328,368,15,0,86,101,85,824,0,5027,5851,2797,2,0,16,18
753,ANANTAPUR,Raptadu,MARUR,178,23,836,1037,24,9,203,236,216,783,445,10690,11918,6405,0,0,24,24
754,ANANTAPUR,Raptadu,PALACHERLA,66,3,276,345,32,0,107,139,115,1337,0,5007,6344,3251,2,0,8,10
755,ANANTAPUR,Raptadu,PARASANNAYAPALLE,77,44,1254,1375,26,4,305,335,331,2182,133,25690,28005,22273,13,0,146,159
756,ANANTAPUR,Raptadu,PULLALAREVU,146,2,362,510,76,1,135,212,197,4000,9,6438,10447,5150,6,0,4,10
757,ANANTAPUR,Raptadu,RAPTADU,252,0,1357,1609,31,0,206,237,208,1369,0,9419,10788,7013,5,0,18,23
758,ANANTAPUR,Raptadu,YERRAGUNTA,58,2,331,391,34,0,186,220,197,1482,0,9084,10566,5788,2,0,10,12
759,ANANTAPUR,Rayadurg,AVULADATLA,83,191,218,492,19,61,49,129,138,1176,3157,3105,7438,3706,7,8,12,27
760,ANANTAPUR,Rayadurg,B.N. HALLI,239,8,860,1107,37,8,250,295,278,1973,321,14438,16732,8706,4,0,8,12
761,ANANTAPUR,Rayadurg,BONDANAKAL,126,332,326,784,14,91,22,127,111,1011,8085,1743,10839,5484,7,49,9,65
762,ANANTAPUR,Rayadurg,C. GOLLALA DODDI,13,2,530,545,0,1,115,116,95,0,90,8829,8919,3753,0,0,40,40
763,ANANTAPUR,Rayadurg,CHADAM,188,0,212,400,98,0,81,179,138,5684,0,5208,10892,4723,21,0,22,43
764,ANANTAPUR,Rayadurg,D. KONDAPURAM,116,0,698,814,56,0,140,196,167,2970,0,7751,10721,4505,1,0,17,18
765,ANANTAPUR,Rayadurg,GRAMADATLA,106,0,393,499,15,0,85,100,107,964,0,6943,7907,4052,1,0,44,45
766,ANANTAPUR,Rayadurg,JUNJURAMPALLE,224,1,687,912,153,0,391,544,563,6871,0,21623,28494,13916,15,0,57,72
767,ANANTAPUR,Rayadurg,KENCHANAPALLI,149,0,875,1024,82,0,337,419,485,6215,0,18719,24934,11242,29,0,58,87
768,ANANTAPUR,Rayadurg,KONTANAPALLI,92,1,203,296,17,0,51,68,73,630,0,3711,4341,2760,0,0,16,16
769,ANANTAPUR,Rayadurg,MALLAPURAM,96,68,381,545,22,32,90,144,127,1712,2378,5674,9764,5183,4,12,20,36
770,ANANTAPUR,Rayadurg,MECHIRI,122,0,426,548,55,0,148,203,158,3460,0,11200,14660,5605,4,0,41,45
771,ANANTAPUR,Rayadurg,NAGIREDDIPALLE,146,6,654,806,48,4,240,292,293,1179,123,10408,11710,5752,0,0,15,15
772,ANANTAPUR,Rayadurg,PALLEPALLI,106,0,446,552,56,0,104,160,160,2823,0,4817,7640,3794,7,0,9,16
773,ANANTAPUR,Rayadurg,REKULAKUNTA,90,1,348,439,33,0,92,125,122,1710,0,5221,6931,3026,3,0,15,18
774,ANANTAPUR,Rayadurg,T. VEERAPURAM,172,11,617,800,48,0,198,246,239,1527,0,14362,15889,8700,4,0,52,56
775,ANANTAPUR,Rayadurg,UDEGOLAM,362,0,441,803,95,0,81,176,133,5572,0,4546,10118,4293,15,0,12,27
776,ANANTAPUR,Rayadurg,VADRAHONNUR,44,1,369,414,25,0,206,231,240,708,0,11358,12066,6225,0,0,34,34
777,ANANTAPUR,Rayadurg,VEPARALLA,104,0,522,626,29,0,231,260,252,1553,0,15378,16931,10344,3,0,49,52
778,ANANTAPUR,Roddam,BOKKASAMPALLE,118,9,379,506,37,1,84,122,108,1511,91,5451,7053,3073,2,0,17,19
779,ANANTAPUR,Roddam,BUCHARLA,155,1,404,560,23,0,64,87,82,1186,0,2855,4041,2353,3,0,9,12
780,ANANTAPUR,Roddam,CHERUKUR,124,5,516,645,28,1,172,201,164,875,12,12464,13351,6035,1,0,56,57
781,ANANTAPUR,Roddam,CHINNAMANTHUR,175,0,374,549,67,0,132,199,178,5574,0,8990,14564,6897,30,0,45,75
782,ANANTAPUR,Roddam,CHOLEMARRI,205,6,560,771,38,0,87,125,98,2373,0,4538,6911,3552,7,0,16,23
783,ANANTAPUR,Roddam,DODAGATTA,165,73,741,979,33,4,119,156,133,1505,159,6232,7896,4261,5,0,12,17
784,ANANTAPUR,Roddam,KALIPI,251,2,965,1218,60,0,211,271,188,3441,0,14224,17665,7816,11,0,60,71
785,ANANTAPUR,Roddam,KAMBALAPALLE,96,61,485,642,44,35,266,345,316,1666,1744,10701,14111,6867,0,2,0,2
786,ANANTAPUR,Roddam,KOGIRA,139,3,528,670,32,0,163,195,160,1667,0,9713,11380,4918,2,0,26,28
787,ANANTAPUR,Roddam,M.KOTHAPALLE,102,0,417,519,43,0,240,283,256,1296,0,7003,8299,4217,0,0,4,4
788,ANANTAPUR,Roddam,NALLUR,145,0,471,616,64,0,40,104,96,1621,0,1318,2939,1354,0,0,3,3
789,ANANTAPUR,Roddam,NARANAGEPALLE,213,1,688,902,56,0,173,229,209,1717,0,8055,9772,5020,2,0,18,20
790,ANANTAPUR,Roddam,PEDDAMANTHUR,99,0,545,644,48,0,196,244,191,3330,0,9546,12876,6061,12,0,17,29
791,ANANTAPUR,Roddam,R.LOCHARLA,273,1,491,765,107,0,242,349,339,5653,0,14084,19737,9707,16,0,50,66
792,ANANTAPUR,Roddam,REDDIPALLE,180,2,604,786,45,1,192,238,225,2808,60,12063,14931,7916,7,0,26,33
793,ANANTAPUR,Roddam,RODDAM,401,18,2051,2470,24,3,225,252,190,1327,266,12654,14247,6870,1,1,43,45
794,ANANTAPUR,Roddam,SANIPALLE,126,1,565,692,46,0,39,85,64,1992,0,1668,3660,1617,6,0,3,9
795,ANANTAPUR,Roddam,THADANKIPALLE,82,4,313,399,47,2,189,238,225,2823,236,11008,14067,7160,7,1,18,26
796,ANANTAPUR,Roddam,THURAKALAPATNAM,132,3,479,614,44,1,193,238,196,2569,6,9747,12322,5565,11,0,17,28
797,ANANTAPUR,Rolla,BOMMAGONDANAHATTI,390,2,1402,1794,187,0,531,718,688,16241,0,38582,54823,26743,80,0,157,237
798,ANANTAPUR,Rolla,DODDERI,214,1,559,774,108,0,167,275,190,5253,0,9528,14781,5290,9,0,29,38
799,ANANTAPUR,Rolla,GUDDUGURLU,164,10,563,737,99,0,233,332,304,7601,0,16476,24077,10079,43,0,62,105
800,ANANTAPUR,Rolla,Hulikunta,193,14,460,667,0,0,0,0,0,0,0,0,0,0,0,0,0,0
801,ANANTAPUR,Rolla,KAKI,236,4,356,596,90,1,103,194,183,4429,32,3223,7684,3301,10,0,3,13
802,ANANTAPUR,Rolla,M.RAYAPURAM,304,1,673,978,99,0,113,212,189,5930,0,7108,13038,5911,23,0,28,51
803,ANANTAPUR,Rolla,Mallinamadugu,199,0,793,992,0,0,0,0,0,0,0,0,0,0,0,0,0,0
804,ANANTAPUR,Rolla,RATNAGIRI,194,0,720,914,55,0,175,230,177,2070,0,7206,9276,3709,2,0,18,20
805,ANANTAPUR,Rolla,ROLLA,459,128,1606,2193,227,53,287,567,466,14187,2946,16736,33869,14765,62,8,46,116
806,ANANTAPUR,Settur,ANUMPALLI,160,2,310,472,47,0,75,122,121,3689,0,3952,7641,3684,13,0,11,24
807,ANANTAPUR,Settur,AYYAGARLAPALLE,208,0,495,703,77,0,57,134,116,5099,0,2166,7265,3444,20,0,1,21
808,ANANTAPUR,Settur,BACHEHALLI,201,32,632,865,106,8,221,335,338,5318,294,10407,16019,7261,14,0,16,30
809,ANANTAPUR,Settur,CHERLOPALLI,201,4,763,968,60,1,123,184,198,2055,6,3900,5961,3512,1,0,2,3
810,ANANTAPUR,Settur,CHINNAMPALLI,136,2,520,658,63,0,111,174,149,2402,0,5047,7449,3849,0,0,6,6
811,ANANTAPUR,Settur,CHINTARLAPALLE,236,36,583,855,94,4,157,255,224,5394,156,7822,13372,6463,13,1,26,40
812,ANANTAPUR,Settur,IDUKAL,121,0,475,596,39,0,89,128,135,1487,0,4969,6456,3296,4,0,18,22
813,ANANTAPUR,Settur,KANUKUR,237,0,955,1192,136,0,293,429,373,13942,0,20315,34257,15921,71,0,72,143
814,ANANTAPUR,Settur,KHAIREVU,142,1,432,575,30,0,113,143,137,1040,0,4329,5369,2695,1,0,6,7
815,ANANTAPUR,Settur,LAKSHMAMPALLE,291,1,998,1290,27,0,107,134,130,671,0,2944,3615,1820,0,0,2,2
816,ANANTAPUR,Settur,MAKODIKI,100,138,455,693,21,92,144,257,232,460,3555,4315,8330,3994,0,0,0,0
817,ANANTAPUR,Settur,MULAKALEDU,263,1,703,967,85,0,108,193,180,4523,0,5495,10018,4159,9,0,15,24
818,ANANTAPUR,Settur,PERUGUPALYAM,0,2,742,744,0,0,238,238,209,0,0,12168,12168,5510,0,0,24,24
819,ANANTAPUR,Settur,SETTUR,295,3,775,1073,100,1,149,250,228,3619,60,3185,6864,3295,4,0,3,7
820,ANANTAPUR,Settur,THIPPANPALLI,27,1,550,578,13,0,112,125,123,845,0,4619,5464,2804,2,0,6,8
821,ANANTAPUR,Settur,YATAKAL,84,0,456,540,53,0,206,259,250,3503,0,14046,17549,9228,12,0,43,55
822,ANANTAPUR,Singanamala,AKULEDU,116,9,445,570,25,2,149,176,163,1198,128,5538,6864,3772,2,0,9,11
823,ANANTAPUR,Singanamala,CHAKRAYAPETA,128,1,866,995,52,1,627,680,704,2478,35,42953,45466,26068,2,0,115,117
824,ANANTAPUR,Singanamala,GUMMEPALLI,7,26,534,567,2,13,252,267,266,105,743,17318,18166,9444,1,3,46,50
825,ANANTAPUR,Singanamala,JOOLAKALVA,179,7,409,595,139,6,250,395,426,8255,539,20782,29576,15344,25,3,84,112
826,ANANTAPUR,Singanamala,KALLUMADI,322,2,380,704,87,0,147,234,207,4264,0,6874,11138,6842,4,0,11,15
827,ANANTAPUR,Singanamala,KORIVIPALLE,126,0,318,444,95,0,227,322,353,5633,0,13499,19132,9144,6,0,27,33
828,ANANTAPUR,Singanamala,LOLURU,74,43,309,426,31,1,49,81,68,1325,96,2583,4004,1998,5,0,5,10
829,ANANTAPUR,Singanamala,NAYANAVARIPALLI,3,2,327,332,0,0,117,117,109,0,0,2769,2769,1371,0,0,0,0
830,ANANTAPUR,Singanamala,NIDHANAWADA,182,3,207,392,142,0,126,268,278,10402,0,10569,20971,10696,45,0,52,97
831,ANANTAPUR,Singanamala,P.MATLAGONDI,80,0,480,560,46,0,262,308,288,2663,0,17596,20259,10153,4,0,49,53
832,ANANTAPUR,Singanamala,PERAVALI,140,13,393,546,63,9,148,220,228,5113,793,13339,19245,12673,25,4,62,91
833,ANANTAPUR,Singanamala,RACHEPALLE,275,8,901,1184,183,2,652,837,884,10612,54,31726,42392,21238,22,0,99,121
834,ANANTAPUR,Singanamala,SALAKAMCHERUVU,147,35,391,573,118,1,239,358,324,4443,6,8680,13129,6641,1,0,7,8
835,ANANTAPUR,Singanamala,SINGANAMALA,278,11,1032,1321,97,1,565,663,651,5419,28,37716,43163,26129,11,0,68,79
836,ANANTAPUR,Singanamala,SODANAPALLI,182,5,452,639,90,1,277,368,339,4685,97,15140,19922,11451,13,0,31,44
837,ANANTAPUR,Singanamala,TARIMELA,411,67,701,1179,137,12,196,345,344,6954,651,9694,17299,9593,3,2,23,28
838,ANANTAPUR,Singanamala,ULLIKALLU,154,1,528,683,113,1,201,315,310,4113,17,8969,13099,6689,1,0,11,12
839,ANANTAPUR,Singanamala,WEST NARASAPURAM,276,389,742,1407,105,186,398,689,710,3765,8105,26605,38475,18581,2,17,83,102
840,ANANTAPUR,Somandepalle,BRAHMANAPALLE,12,0,302,314,3,0,93,96,79,252,0,7356,7608,3876,2,0,49,51
841,ANANTAPUR,Somandepalle,BRAHMASAMUDRAM,87,1,346,434,26,1,164,191,130,1628,11,8088,9727,4368,6,0,22,28
842,ANANTAPUR,Somandepalle,CHALAKUR,147,1,473,621,81,0,162,243,196,6610,0,10637,17247,7530,34,0,40,74
843,ANANTAPUR,Somandepalle,CHALLAPALLE,165,28,504,697,46,0,118,164,148,3532,0,8020,11552,5643,21,0,37,58
844,ANANTAPUR,Somandepalle,EDULABALLAPURAM,58,1,244,303,26,0,60,86,58,1632,0,3407,5039,2201,3,0,8,11
845,ANANTAPUR,Somandepalle,GUDIPALLE,20,45,316,381,7,8,138,153,147,607,192,12431,13230,7263,4,0,64,68
846,ANANTAPUR,Somandepalle,JULUKUNTA,117,0,176,293,48,0,22,70,57,3778,0,1635,5413,2429,20,0,10,30
847,ANANTAPUR,Somandepalle,KETHAGANICHERUVU,45,0,395,440,26,0,146,172,146,2189,0,12023,14212,6385,6,0,55,61
848,ANANTAPUR,Somandepalle,MAGECHERUVU,151,2,624,777,16,0,143,159,137,549,0,7118,7667,4415,0,0,18,18
849,ANANTAPUR,Somandepalle,MANDLI,121,0,592,713,49,0,263,312,237,2231,0,15572,17803,9062,1,0,62,63
850,ANANTAPUR,Somandepalle,NADIMPALLE,117,0,300,417,22,0,112,134,106,543,0,5869,6412,3144,0,0,24,24
851,ANANTAPUR,Somandepalle,NAGINAYANICHERUVU,25,155,331,511,15,71,224,310,274,1573,6360,22136,30069,15913,10,41,124,175
852,ANANTAPUR,Somandepalle,PANDIPARTHI,191,5,319,515,87,1,136,224,185,5343,70,7764,13177,7213,17,0,24,41
853,ANANTAPUR,Somandepalle,SOMANDEPALLE,216,26,647,889,35,3,115,153,111,2789,103,8968,11860,5746,12,0,55,67
854,ANANTAPUR,Somandepalle,TUNGODU,163,0,291,454,49,0,82,131,106,2941,0,3542,6483,3066,10,0,12,22
855,ANANTAPUR,Somandepalle,VELIDADAKALA,117,2,202,321,50,2,39,91,66,4832,168,3185,8185,3691,30,1,15,46
856,ANANTAPUR,Tadimarri,ATMAKUR,108,38,491,637,49,9,218,276,278,2563,627,14856,18046,10773,5,1,40,46
857,ANANTAPUR,Tadimarri,C.C.REVU,122,27,483,632,21,10,128,159,155,822,374,7716,8912,4990,3,0,28,31
858,ANANTAPUR,Tadimarri,CHILLAKONDAIAHPALLI,110,1,440,551,21,0,228,249,222,373,0,12744,13117,7820,0,0,15,15
859,ANANTAPUR,Tadimarri,CHILLAVARIPALLI,72,0,379,451,18,0,153,171,156,1350,0,12889,14239,8385,8,0,67,75
860,ANANTAPUR,Tadimarri,DADITHOTA,234,0,1241,1475,152,0,526,678,660,13016,0,36629,49645,26157,72,0,173,245
861,ANANTAPUR,Tadimarri,EKAPADAMPALLI,2,5,350,357,0,4,227,231,209,0,205,16605,16810,8583,0,0,60,60
862,ANANTAPUR,Tadimarri,KUNUKUNTLA,199,14,557,770,1,8,142,151,139,3,386,6506,6895,4019,0,1,21,22
863,ANANTAPUR,Tadimarri,M.AGRAHARAM,144,20,794,958,51,13,408,472,452,3319,965,32492,36776,19997,13,1,154,168
864,ANANTAPUR,Tadimarri,NADIGULLU,127,36,257,420,74,3,107,184,181,4875,99,7945,12919,8039,17,0,32,49
865,ANANTAPUR,Tadimarri,NARSIMPALLI,113,21,498,632,55,7,194,256,245,4254,449,15017,19720,13056,20,0,56,76
866,ANANTAPUR,Tadimarri,PEDDAKOTLA,78,18,707,803,13,1,136,150,137,262,33,6847,7142,4584,0,0,23,23
867,ANANTAPUR,Tadimarri,PINNADARI,227,65,903,1195,121,33,461,615,579,7876,1598,23588,33062,19090,31,3,37,71
868,ANANTAPUR,Tadimarri,RAMAPURAM,84,0,274,358,42,0,78,120,117,1565,0,4316,5881,3733,1,0,10,11
869,ANANTAPUR,Tadimarri,TADIMARRI,728,57,1728,2513,230,7,337,574,538,14893,421,21091,36405,23564,48,0,58,106
870,ANANTAPUR,Tadpatri,ALUR,92,17,269,378,54,9,104,167,163,4332,717,7853,12902,10684,20,2,33,55
871,ANANTAPUR,Tadpatri,BHOGASAMUDRAM,284,80,815,1179,103,37,366,506,517,5688,1581,23585,30854,24529,9,0,78,87
872,ANANTAPUR,Tadpatri,BODAIPALLE,78,0,282,360,46,0,80,126,133,2655,0,3725,6380,5206,8,0,4,12
873,ANANTAPUR,Tadpatri,BONDALADINNE,76,9,202,287,14,1,6,21,21,41,2,27,70,64,0,0,0,0
874,ANANTAPUR,Tadpatri,BRAHMANAPALLE,105,0,621,726,77,0,390,467,478,5760,0,28760,34520,27074,12,0,104,116
875,ANANTAPUR,Tadpatri,CHALLAVARIPALLE,4,1,123,128,2,0,30,32,32,11,0,248,259,195,0,0,0,0
876,ANANTAPUR,Tadpatri,CHINNAPOLAMADA,100,0,334,434,49,0,95,144,148,1948,0,4063,6011,5447,0,0,0,0
877,ANANTAPUR,Tadpatri,CHUKKALUR,370,8,484,862,43,3,83,129,122,1783,150,5066,6999,4390,3,0,11,14
878,ANANTAPUR,Tadpatri,DIGUVAPALLI,75,0,497,572,34,0,267,301,301,1275,0,18900,20175,12870,2,0,56,58
879,ANANTAPUR,Tadpatri,GANGADEVIPALLI,119,0,372,491,72,0,86,158,151,4804,0,5120,9924,8566,12,0,4,16
880,ANANTAPUR,Tadpatri,GANNAVARIPALLI,38,2,273,313,1,0,13,14,14,48,0,225,273,230,0,0,0,0
881,ANANTAPUR,Tadpatri,HUSSAIN PURAM,55,0,112,167,0,0,0,0,0,0,0,0,0,0,0,0,0,0
882,ANANTAPUR,Tadpatri,IGUDUR,83,0,371,454,40,0,28,68,62,1457,0,772,2229,1341,2,0,1,3
883,ANANTAPUR,Tadpatri,KAVERISAMUDRAM,106,0,233,339,87,0,100,187,189,6324,0,7354,13678,11305,16,0,30,46
884,ANANTAPUR,Tadpatri,KOMALI,82,3,139,224,40,0,15,55,60,587,0,230,817,663,0,0,0,0
885,ANANTAPUR,Tadpatri,KONDEPALLI,21,0,48,69,0,0,0,0,0,0,0,0,0,0,0,0,0,0
886,ANANTAPUR,Tadpatri,PEDDAPOLAMADA,95,0,456,551,19,0,186,205,203,1030,0,9018,10048,8794,2,0,6,8
887,ANANTAPUR,Tadpatri,RAVIVENKATAMPALLI,164,0,328,492,84,0,139,223,232,4007,0,8704,12711,8100,7,0,24,31
888,ANANTAPUR,Tadpatri,SAJJALADINNE,49,0,301,350,1,0,44,45,49,53,0,2467,2520,2473,0,0,1,1
889,ANANTAPUR,Tadpatri,TERANNAPALLI,58,0,174,232,35,0,81,116,113,2253,0,6396,8649,6046,7,0,31,38
890,ANANTAPUR,Tadpatri,URICHINTHALA,89,14,383,486,64,6,247,317,312,5083,539,19582,25204,19415,21,1,84,106
891,ANANTAPUR,Tadpatri,VANGANUR,37,0,140,177,19,0,74,93,95,399,0,2487,2886,2144,0,0,1,1
892,ANANTAPUR,Tadpatri,VEERAPURAM,51,0,51,102,46,0,22,68,72,2112,0,490,2602,1664,1,0,0,1
893,ANANTAPUR,Tadpatri,VELAMAKUR,56,0,198,254,16,0,34,50,49,66,0,670,736,473,0,0,0,0
894,ANANTAPUR,Tadpatri,VENKATAREDDYPALLI,128,0,313,441,74,0,165,239,246,5719,0,12515,18234,15962,17,0,50,67
895,ANANTAPUR,Tadpatri,YERRAGUNTAPALLI,28,7,391,426,8,0,191,199,203,723,0,15288,16011,11994,2,0,72,74
896,ANANTAPUR,Talupula,BANDLAPALLI,225,1,357,583,96,0,152,248,227,4641,0,6801,11442,5852,5,0,18,23
897,ANANTAPUR,Talupula,BATREPALLI,21,7,408,436,13,5,139,157,140,761,365,8548,9674,4725,2,0,23,25
898,ANANTAPUR,Talupula,EDULAKUNTLAPALLI,54,207,586,847,34,129,301,464,479,2644,15480,30210,48334,25138,11,76,138,225
899,ANANTAPUR,Talupula,GUNDUVARIPALLI,1,0,631,632,1,0,255,256,235,71,0,13708,13779,7492,0,0,42,42
900,ANANTAPUR,Talupula,KURLI,152,9,567,728,36,1,147,184,171,1629,12,9509,11150,6760,4,0,28,32
901,ANANTAPUR,Talupula,LAKKASAMUDRAM,52,1,433,486,16,1,146,163,149,720,74,8178,8972,4639,0,0,25,25
902,ANANTAPUR,Talupula,NUTHANAKALVA,8,0,532,540,1,0,151,152,137,116,0,10232,10348,5657,1,0,41,42
903,ANANTAPUR,Talupula,OBULAREDDEPALLI,73,0,646,719,40,0,213,253,191,2673,0,13258,15931,7053,6,0,40,46
904,ANANTAPUR,Talupula,ODULAPALLI,12,232,466,710,0,16,100,116,115,0,220,5260,5480,3092,0,0,20,20
905,ANANTAPUR,Talupula,PEDDANNAVARIPALLI,71,58,916,1045,55,8,421,484,488,6427,590,40868,47885,26276,45,4,199,248
906,ANANTAPUR,Talupula,PENNABADAVANDLAPALLI,8,129,298,435,1,57,137,195,175,83,2436,11374,13893,7424,0,2,60,62
907,ANANTAPUR,Talupula,POLTHALAVANDLAPALLI,72,13,331,416,32,11,179,222,211,1413,533,9060,11006,5782,4,0,9,13
908,ANANTAPUR,Talupula,PULLIGUNDLAPALLI,69,45,510,624,28,26,267,321,298,1979,2015,22512,26506,13892,6,11,71,88
909,ANANTAPUR,Talupula,TALUPULA,299,68,2630,2997,114,5,253,372,309,4989,685,15380,21054,11380,9,4,43,56
910,ANANTAPUR,Talupula,UDUMULAKURTHY,90,6,545,641,45,0,225,270,255,1365,0,10105,11470,6546,1,0,22,23
911,ANANTAPUR,Talupula,VEPAMANIPETA,183,6,1472,1661,34,3,356,393,353,1207,287,23279,24773,13626,0,2,91,93
912,ANANTAPUR,Tanakal,BALASAMUDRAM,71,36,213,320,18,13,60,91,83,450,739,3180,4369,2646,2,3,8,13
913,ANANTAPUR,Tanakal,BONTHALAPALLI,145,5,489,639,18,0,140,158,127,1345,0,9093,10438,4996,4,0,30,34
914,ANANTAPUR,Tanakal,CHEEKATIMANI PALLI,160,3,251,414,5,0,10,15,7,107,0,20,127,55,0,0,0,0
915,ANANTAPUR,Tanakal,CHINNARAMANNAGARIPALLI,63,0,220,283,37,0,79,116,92,2029,0,4633,6662,3263,4,0,18,22
916,ANANTAPUR,Tanakal,D.THOTTIPALLI,118,19,350,487,14,4,9,27,21,201,144,251,596,311,0,0,0,0
917,ANANTAPUR,Tanakal,DIGUVACHAKKAVARIPALLI,3,0,178,181,0,0,83,83,83,0,0,4970,4970,2654,0,0,19,19
918,ANANTAPUR,Tanakal,ETHODU,161,27,302,490,51,16,111,178,163,3792,1352,7155,12299,5901,16,7,32,55
919,ANANTAPUR,Tanakal,GEMENAIK TANDA,10,540,328,878,0,63,31,94,82,0,1259,1583,2842,1298,0,0,6,6
920,ANANTAPUR,Tanakal,KOKKANTI,77,2,425,504,26,0,58,84,77,1627,0,3663,5290,2550,7,0,9,16
921,ANANTAPUR,Tanakal,KORTHIKOTA,74,74,546,694,8,13,115,136,104,99,271,5194,5564,2726,0,0,16,16
922,ANANTAPUR,Tanakal,KOTAPALLI,60,119,268,447,20,38,71,129,117,664,2063,3455,6182,3477,1,5,9,15
923,ANANTAPUR,Tanakal,MALLIREDDIPALLI,84,94,272,450,0,7,12,19,11,0,27,143,170,77,0,0,0,0
924,ANANTAPUR,Tanakal,MUNDLAVARIPALLI,12,128,220,360,9,33,131,173,158,625,1373,6742,8740,4191,1,4,18,23
925,ANANTAPUR,Tanakal,RACHENE PALLI,53,0,243,296,25,0,110,135,123,1519,0,6443,7962,3873,8,0,18,26
926,ANANTAPUR,Tanakal,T.SADUM,85,3,558,646,14,2,77,93,80,746,98,4828,5672,2855,3,0,17,20
927,ANANTAPUR,Tanakal,TANAKAL,637,176,1381,2194,124,4,162,290,251,5082,215,7224,12521,5853,14,1,17,32
928,ANANTAPUR,Tanakal,TAVALAM,102,0,384,486,4,0,21,25,26,142,0,490,632,337,0,0,0,0
929,ANANTAPUR,Uravakonda,AMIDALA,432,20,2302,2754,29,0,180,209,199,595,0,4800,5395,3111,0,0,1,1
930,ANANTAPUR,Uravakonda,BUDAGAVI,42,1,648,691,11,0,59,70,77,283,0,520,803,470,0,0,0,0
931,ANANTAPUR,Uravakonda,CHINNAMUSTURU,204,5,722,931,120,1,339,460,452,8050,38,20346,28434,16152,27,0,47,74
932,ANANTAPUR,Uravakonda,INDRAVATHI,45,0,407,452,12,0,115,127,103,618,0,5445,6063,3586,1,0,7,8
933,ANANTAPUR,Uravakonda,LATHAVARAM,130,211,534,875,53,131,97,281,251,3421,6768,5661,15850,7463,16,12,22,50
934,ANANTAPUR,Uravakonda,MOPIDI,127,0,765,892,71,0,236,307,296,3550,0,11161,14711,7793,5,0,3,8
935,ANANTAPUR,Uravakonda,NERIMETLA,120,0,521,641,34,0,106,140,126,271,0,1998,2269,1267,0,0,0,0
936,ANANTAPUR,Uravakonda,NIMBAGAL,130,0,803,933,81,0,259,340,324,3515,0,7380,10895,5766,3,0,0,3
937,ANANTAPUR,Uravakonda,PEDDA MUSTURU,224,12,233,469,132,1,156,289,291,5448,20,8516,13984,7101,5,0,16,21
938,ANANTAPUR,Uravakonda,PEDDAKOWKUNTLA,751,9,3194,3954,227,2,389,618,740,5188,72,8691,13951,7553,1,0,0,1
939,ANANTAPUR,Uravakonda,RAKETLA,244,139,1131,1514,6,5,26,37,32,36,94,247,377,195,0,0,0,0
940,ANANTAPUR,Uravakonda,RAYAMPALLE,89,0,320,409,5,0,72,77,70,114,0,2958,3072,1828,0,0,1,1
941,ANANTAPUR,Uravakonda,RENIMAKULAPALLE,108,0,526,634,59,0,199,258,236,4753,0,14925,19678,11678,29,0,71,100
942,ANANTAPUR,Uravakonda,SHAIKSANIPALLI,293,242,1168,1703,96,31,105,232,241,5354,794,4776,10924,5537,12,0,8,20
943,ANANTAPUR,Uravakonda,URAVAKONDA,509,20,651,1180,2,2,202,206,173,40,35,8134,8209,5427,0,0,10,10
944,ANANTAPUR,Uravakonda,VELIGONDA,105,0,538,643,58,0,105,163,159,3640,0,5150,8790,4545,11,0,1,12
945,ANANTAPUR,Uravakonda,VYASAPURAM,94,0,432,526,35,0,110,145,122,729,0,4691,5420,2637,0,0,1,1
946,ANANTAPUR,Vajrakarur,CHABALA,268,0,554,822,153,0,330,483,512,8022,0,17935,25957,13569,11,0,23,34
947,ANANTAPUR,Vajrakarur,CHAYAPURAM,71,0,491,562,55,0,246,301,374,3530,0,17771,21301,11657,6,0,64,70
948,ANANTAPUR,Vajrakarur,CHINNA HOTHUR,160,0,287,447,103,0,118,221,222,5166,0,5781,10947,5675,8,0,9,17
949,ANANTAPUR,Vajrakarur,DHARMAPURI,24,9,363,396,9,5,134,148,141,227,273,6939,7439,4044,0,0,6,6
950,ANANTAPUR,Vajrakarur,GADE HOTHUR,228,3,967,1198,140,1,536,677,735,3996,1,26276,30273,16386,3,0,28,31
951,ANANTAPUR,Vajrakarur,GANJIKUNTA,109,9,441,559,44,4,132,180,166,2370,270,6746,9386,5415,10,0,13,23
952,ANANTAPUR,Vajrakarur,GULAPALEM,70,0,695,765,18,0,233,251,272,583,0,9367,9950,5172,0,0,7,7
953,ANANTAPUR,Vajrakarur,J.RAMPURAM,27,65,248,340,12,47,87,146,192,466,1779,4145,6390,3659,0,1,10,11
954,ANANTAPUR,Vajrakarur,KAMALAPADI,55,63,562,680,13,13,234,260,261,663,274,10548,11485,6624,1,1,16,18
955,ANANTAPUR,Vajrakarur,KONAKONDLA,531,29,2613,3173,182,6,626,814,857,4830,115,12883,17828,10088,2,0,1,3
956,ANANTAPUR,Vajrakarur,PANDIKUNTA,126,45,497,668,58,40,234,332,326,3283,3075,11239,17597,9284,4,10,17,31
957,ANANTAPUR,Vajrakarur,PATHA KADAMALAKUNTA,87,0,355,442,62,0,207,269,287,4013,0,10197,14210,7513,13,0,6,19
958,ANANTAPUR,Vajrakarur,PEDDA PYAPILI,316,268,522,1106,202,174,328,704,837,14334,7781,17175,39290,20908,63,16,34,113
959,ANANTAPUR,Vajrakarur,RAGULAPADU,101,31,546,678,62,8,249,319,324,1038,268,10784,12090,6475,0,0,13,13
960,ANANTAPUR,Vajrakarur,THATRAKAL,108,500,455,1063,58,196,216,470,486,3195,9433,12159,24787,13751,6,24,31,61
961,ANANTAPUR,Vajrakarur,VAJRAKARUR,394,54,1765,2213,21,1,323,345,350,1300,66,13390,14756,10356,6,0,23,29
962,ANANTAPUR,Vajrakarur,VENKATAMPALLI,80,142,181,403,54,60,79,193,195,3448,3218,4896,11562,6059,12,9,20,41
963,ANANTAPUR,Vajrakarur,VENKATAMPALLI PEDATANDA,1,553,0,554,0,248,0,248,257,0,18162,0,18162,8658,0,94,0,94
964,ANANTAPUR,Vidapanakal,Chikalaguriki,106,0,459,565,54,0,155,209,185,4039,0,7514,11553,6370,15,0,9,24
965,ANANTAPUR,Vidapanakal,DONEKAL,67,2,584,653,19,1,276,296,284,779,40,15645,16464,8590,0,0,31,31
966,ANANTAPUR,Vidapanakal,GODEKAL,259,4,1121,1384,95,4,399,498,470,3668,166,18579,22413,12032,1,0,23,24
967,ANANTAPUR,Vidapanakal,HANCHANAHAL,91,0,523,614,63,0,169,232,236,4660,0,4046,8706,4753,14,0,3,17
968,ANANTAPUR,Vidapanakal,HAVALIGI,256,2,1227,1485,123,0,334,457,453,1695,0,7078,8773,4567,0,0,3,3
969,ANANTAPUR,Vidapanakal,JANARDHANA PALLI,4,0,139,143,0,0,47,47,43,0,0,1698,1698,1043,0,0,3,3
970,ANANTAPUR,Vidapanakal,KADADARABENCHI,38,0,306,344,22,0,93,115,104,1526,0,7500,9026,4567,7,0,40,47
971,ANANTAPUR,Vidapanakal,KARAKAMUKKALA,159,5,491,655,76,0,109,185,146,3131,0,6206,9337,4428,5,0,12,17
972,ANANTAPUR,Vidapanakal,KOTTALA PALLI,86,0,326,412,44,0,106,150,137,2696,0,8098,10794,6090,5,0,33,38
973,ANANTAPUR,Vidapanakal,MALAPURAM,50,0,311,361,29,0,134,163,157,2024,0,8997,11021,6279,1,0,19,20
974,ANANTAPUR,Vidapanakal,PALTHURU,246,1,1413,1660,102,0,219,321,341,3656,0,11105,14761,7646,4,0,24,28
975,ANANTAPUR,Vidapanakal,POLIKI,202,4,542,748,97,1,224,322,338,3498,44,14470,18012,9769,1,0,35,36
976,ANANTAPUR,Vidapanakal,R.KOTTALA,65,0,198,263,37,0,85,122,142,1294,0,3495,4789,2651,1,0,3,4
977,ANANTAPUR,Vidapanakal,UNDABANDA,73,2,495,570,55,0,313,368,360,2589,0,20047,22636,12250,1,0,53,54
978,ANANTAPUR,Vidapanakal,V.KOTHAKOTA,131,1,509,641,55,1,233,289,259,1799,21,8798,10618,5380,1,0,10,11
979,ANANTAPUR,Vidapanakal,VELPUMADUGU,90,1,295,386,49,0,77,126,121,998,0,2551,3549,1900,0,0,0,0
980,ANANTAPUR,Vidapanakal,VIDAPANAKAL,227,8,1267,1502,141,0,341,482,438,7793,0,16162,23955,13580,14,0,25,39
981,ANANTAPUR,Yadiki,CHANDANA,180,10,869,1059,70,7,322,399,398,1329,189,12005,13523,9751,0,0,3,3
982,ANANTAPUR,Yadiki,GUDIPADU,29,0,410,439,3,0,171,174,244,280,0,11244,11524,10594,2,0,27,29
983,ANANTAPUR,Yadiki,KAMALAPADU,269,1,843,1113,79,0,170,249,236,1306,0,3754,5060,3475,0,0,4,4
984,ANANTAPUR,Yadiki,KONUPPALAPADU,136,0,690,826,81,0,515,596,554,4117,0,22409,26526,15008,10,0,33,43
985,ANANTAPUR,Yadiki,LAKSHMIPALLI,71,28,546,645,39,15,185,239,229,2721,621,10795,14137,8265,13,1,32,46
986,ANANTAPUR,Yadiki,N.CHIKKEPALLI,2,0,334,336,0,0,161,161,163,0,0,8955,8955,7440,0,0,6,6
987,ANANTAPUR,Yadiki,NAGARUR,223,6,653,882,131,5,248,384,385,9028,373,13262,22663,14172,32,0,15,47
988,ANANTAPUR,Yadiki,NITTURU,148,3,395,546,65,0,128,193,186,3952,0,8106,12058,10767,7,0,11,18
989,ANANTAPUR,Yadiki,P.VENGANNAPALLI,81,2,380,463,51,1,149,201,196,4007,100,10799,14906,8635,15,1,37,53
990,ANANTAPUR,Yadiki,PUPPALA,40,94,202,336,31,72,141,244,261,976,2851,4510,8337,5035,0,0,0,0
991,ANANTAPUR,Yadiki,RAYALACHERUVU,101,3,946,1050,18,1,138,157,146,498,31,3062,3591,3180,0,0,0,0
992,ANANTAPUR,Yadiki,TUTRALAPALLI,119,0,243,362,87,0,168,255,250,5236,0,13276,18512,12201,15,0,68,83
993,ANANTAPUR,Yadiki,VEMULAPADU,144,2,443,589,53,1,108,162,132,1634,29,7804,9467,6921,4,0,40,44
994,ANANTAPUR,Yadiki,YADIKI,1095,87,4095,5277,260,2,876,1138,1168,10465,101,47624,58190,45465,6,0,102,108
995,ANANTAPUR,Yellanur,85 NITTOR,103,6,249,358,64,2,105,171,160,4736,101,8415,13252,8302,22,0,41,63
996,ANANTAPUR,Yellanur,BOPPEPALLE,174,1,392,567,97,0,210,307,298,7616,0,15722,23338,14065,30,0,66,96
997,ANANTAPUR,Yellanur,BUKKAPURAM,255,0,581,836,121,0,303,424,415,9200,0,21974,31174,20058,48,0,75,123
998,ANANTAPUR,Yellanur,CHILAMAKURU,128,0,877,1005,60,0,387,447,360,3327,0,24372,27699,14806,19,0,73,92
999,ANANTAPUR,Yellanur,CHINTHAKAYAMANDA,242,1,1079,1322,164,1,615,780,723,14552,143,46127,60822,37179,75,1,189,265
1000,ANANTAPUR,Yellanur,DANTHALAPALLI,1,1,446,448,0,0,224,224,199,0,0,12159,12159,6712,0,0,48,48
1001,ANANTAPUR,Yellanur,GODDUMARRI,197,5,322,524,101,3,171,275,257,4162,169,10783,15114,9098,4,0,27,31
1002,ANANTAPUR,Yellanur,JANGAMPALLI,1,1,252,254,0,1,165,166,147,0,83,13621,13704,7545,0,0,50,50
1003,ANANTAPUR,Yellanur,KALLURU,128,4,541,673,45,2,312,359,318,3112,16,24095,27223,18050,18,0,148,166
1004,ANANTAPUR,Yellanur,KUCHIVARIPALLI,68,0,392,460,43,0,136,179,156,1531,0,4558,6089,3340,0,0,0,0
1005,ANANTAPUR,Yellanur,MALLAGUNDALA,69,0,654,723,34,1,347,382,435,1283,6,24949,26238,13632,2,0,97,99
1006,ANANTAPUR,Yellanur,MEDIKURTHI,58,0,174,232,30,0,87,117,109,1721,0,4887,6608,4052,0,0,3,3
1007,ANANTAPUR,Yellanur,NEERAJAMPALLI,13,0,395,408,0,0,2,2,0,0,0,12,12,0,0,0,0,0
1008,ANANTAPUR,Yellanur,PATHAPALLE,16,0,329,345,11,0,134,145,139,1021,0,12723,13744,7433,6,0,71,77
1009,ANANTAPUR,Yellanur,PEDDAMALLEPALLE,82,0,366,448,48,0,195,243,211,2549,0,8912,11461,7029,2,0,24,26
1010,ANANTAPUR,Yellanur,SINGAVARAM,173,1,288,462,102,0,73,175,165,7808,0,5047,12855,8778,30,0,21,51
1011,ANANTAPUR,Yellanur,THIRUMALAPURAM,78,0,160,238,61,0,104,165,156,6067,0,9793,15860,10003,46,0,66,112
1012,ANANTAPUR,Yellanur,VEMULAPALLE,112,0,258,370,45,0,97,142,135,1799,0,4661,6460,4186,1,0,6,7
1013,ANANTAPUR,Yellanur,VENKATAMPALLI,10,6,456,472,0,4,157,161,149,0,337,12123,12460,7047,0,1,42,43
1014,ANANTAPUR,Yellanur,VENNAPUSAPALLE,98,0,496,594,37,0,108,145,116,1507,0,6191,7698,4609,0,0,13,13
1015,ANANTAPUR,Yellanur,YELLANUR,225,5,1360,1590,66,5,719,790,717,1278,166,31863,33307,19318,0,0,39,39
1016,CHITTOOR,B Kothakota,B.KOTHAKOTA,297,159,3064,3520,19,5,53,77,33,572,84,2116,2772,617,0,0,5,5
1017,CHITTOOR,B Kothakota,BADIKAYALAPALLI,221,27,1156,1404,56,0,203,259,213,2065,0,11437,13502,6671,4,0,39,43
1018,CHITTOOR,B Kothakota,BANDARUVARIPALLE,57,5,234,296,9,0,27,36,26,167,0,845,1012,493,0,0,1,1
1019,CHITTOOR,B Kothakota,BAYYAPPAGARIPALLI,174,60,463,697,65,10,204,279,225,4582,399,13623,18604,8988,20,1,61,82
1020,CHITTOOR,B Kothakota,BEERANGI,177,51,933,1161,42,12,292,346,245,2209,594,20124,22927,9534,12,2,90,104
1021,CHITTOOR,B Kothakota,GATTU,190,178,1404,1772,26,14,163,203,147,700,480,4405,5585,2432,1,0,0,1
1022,CHITTOOR,B Kothakota,GOLLAPALLE,124,35,433,592,19,10,107,136,117,654,720,5860,7234,3733,1,4,25,30
1023,CHITTOOR,B Kothakota,GUMMASAMUDRAM,191,18,625,834,81,2,168,251,196,2568,21,6083,8672,5158,6,0,15,21
1024,CHITTOOR,B Kothakota,KOTAVOOR,69,1,362,432,5,1,47,53,40,237,29,1229,1495,836,1,0,0,1
1025,CHITTOOR,B Kothakota,SEELAMVARIPALLE,51,12,311,374,0,5,122,127,108,0,101,8164,8265,4845,0,0,41,41
1026,CHITTOOR,B Kothakota,THUMMANAMGUTTA,92,5,349,446,7,2,59,68,66,414,83,3183,3680,1926,1,0,3,4
1027,CHITTOOR,Baireddi Palle,ALAPALLE,155,0,298,453,73,0,77,150,138,4298,0,4389,8687,4362,12,0,13,25
1028,CHITTOOR,Baireddi Palle,BAIREDDIPALLE,271,4,799,1074,27,0,66,93,84,1898,0,5656,7554,3910,3,0,42,45
1029,CHITTOOR,Baireddi Palle,BELUPALLE,248,6,504,758,64,3,145,212,144,2110,96,7848,10054,4950,3,0,29,32
1030,CHITTOOR,Baireddi Palle,CHAPPIDIPALLE,382,15,298,695,157,6,111,274,257,11615,190,9945,21750,10996,63,1,66,130
1031,CHITTOOR,Baireddi Palle,DEVADODDI,30,22,574,626,4,0,28,32,26,138,0,480,618,318,0,0,0,0
1032,CHITTOOR,Baireddi Palle,DHARMAPURI,163,36,331,530,68,7,216,291,281,6019,717,17769,24505,12731,32,4,104,140
1033,CHITTOOR,Baireddi Palle,G.T.PALLE,101,0,183,284,43,0,83,126,109,2279,0,3714,5993,2965,12,0,15,27
1034,CHITTOOR,Baireddi Palle,GADDUR,13,1,316,330,0,0,10,10,9,0,0,126,126,66,0,0,0,0
1035,CHITTOOR,Baireddi Palle,GANGINAYANIPALLE,83,10,333,426,37,4,89,130,119,2969,357,6153,9479,5110,11,1,21,33
1036,CHITTOOR,Baireddi Palle,GOLLACHEMANAPALLE,140,0,426,566,63,0,116,179,163,3840,0,6249,10089,5191,9,0,24,33
1037,CHITTOOR,Baireddi Palle,KADAPANATHAM,135,4,340,479,45,1,65,111,86,1751,48,3681,5480,3602,1,0,11,12
1038,CHITTOOR,Baireddi Palle,KAMMANAPALLE,126,7,268,401,83,0,62,145,125,5684,0,1840,7524,3849,28,0,2,30
1039,CHITTOOR,Baireddi Palle,KHAMBAMPALLE,99,0,290,389,49,0,65,114,101,1584,0,1657,3241,1623,3,0,5,8
1040,CHITTOOR,Baireddi Palle,KOTHUR,140,0,201,341,46,0,10,56,55,2217,0,319,2536,1266,7,0,1,8
1041,CHITTOOR,Baireddi Palle,LAKKANAPALLE,205,0,686,891,74,0,58,132,108,2581,0,2754,5335,2815,4,0,3,7
1042,CHITTOOR,Baireddi Palle,NELLIPTLA,256,174,739,1169,44,26,55,125,72,1417,2415,4637,8469,2871,4,18,29,51
1043,CHITTOOR,Baireddi Palle,PATHAPET,78,24,509,611,8,1,80,89,74,47,6,4494,4547,2350,0,0,15,15
1044,CHITTOOR,Baireddi Palle,PATHURNATHAM,36,1,233,270,17,0,35,52,48,858,0,1413,2271,1612,1,0,3,4
1045,CHITTOOR,Baireddi Palle,PEDDACHELLARAGUNTA,92,5,351,448,40,2,104,146,115,1371,84,3581,5036,2574,3,0,4,7
1046,CHITTOOR,Baireddi Palle,THEERTHAM,82,42,495,619,33,0,20,53,50,1925,0,844,2769,1516,3,0,2,5
1047,CHITTOOR,Baireddi Palle,VENGAMVARIPALLE,113,54,308,475,67,5,55,127,97,4115,378,2686,7179,4433,14,2,9,25
1048,CHITTOOR,Bangarupalem,170.GOLLAPALLI,111,2,170,283,63,0,26,89,81,4804,0,1522,6326,3666,17,0,5,22
1049,CHITTOOR,Bangarupalem,BANGARU PALYAM,393,37,517,947,39,4,36,79,65,2324,263,2587,5174,2675,10,0,16,26
1050,CHITTOOR,Bangarupalem,BODABANDLA,7,2,452,461,2,0,130,132,123,42,0,8736,8778,4312,0,0,42,42
1051,CHITTOOR,Bangarupalem,BOMMAIPALLI,156,4,117,277,59,0,36,95,66,3901,0,1432,5333,2330,16,0,4,20
1052,CHITTOOR,Bangarupalem,CHEEKURU PALLI,24,0,248,272,0,0,78,78,64,0,0,6569,6569,3264,0,0,42,42
1053,CHITTOOR,Bangarupalem,CHILLAGUNDLAPALLI,36,0,186,222,8,0,54,62,50,617,0,3039,3656,1855,2,0,7,9
1054,CHITTOOR,Bangarupalem,ECHANERI PALLI,25,3,334,362,1,0,44,45,19,1,0,1978,1979,674,0,0,6,6
1055,CHITTOOR,Bangarupalem,GUNDLAKATTAMANCHI,179,0,79,258,55,0,24,79,71,2773,0,1844,4617,3259,11,0,11,22
1056,CHITTOOR,Bangarupalem,GUNTHUR,142,8,227,377,52,0,93,145,122,3189,0,5918,9107,5128,16,0,27,43
1057,CHITTOOR,Bangarupalem,JAMBUVARIPALLE,148,7,140,295,40,1,14,55,52,1518,119,583,2220,1545,5,1,2,8
1058,CHITTOOR,Bangarupalem,JILLADUPALLI,68,9,141,218,16,1,18,35,27,172,6,1049,1227,610,0,0,4,4
1059,CHITTOOR,Bangarupalem,K.M.KANDRIGA,21,15,248,284,1,5,91,97,80,114,434,6872,7420,3197,1,4,42,47
1060,CHITTOOR,Bangarupalem,KALLURUPALLE,144,8,139,291,64,0,43,107,92,3040,0,3251,6291,3166,16,0,21,37
1061,CHITTOOR,Bangarupalem,KARIDIVARIPALLI,112,0,46,158,24,0,3,27,19,1578,0,150,1728,726,6,0,0,6
1062,CHITTOOR,Bangarupalem,KATAPPAGARI PALLI,121,0,267,388,61,0,85,146,139,4538,0,5088,9626,6048,25,0,25,50
1063,CHITTOOR,Bangarupalem,KEERAMANDA,147,49,430,626,45,2,96,143,121,2442,36,4990,7468,4363,10,0,17,27
1064,CHITTOOR,Bangarupalem,KODALAMADUGU,193,53,193,439,54,5,54,113,72,1302,131,2585,4018,1814,2,0,9,11
1065,CHITTOOR,Bangarupalem,KURMAIPALLI,39,0,222,261,1,0,42,43,35,48,0,2986,3034,1205,0,0,16,16
1066,CHITTOOR,Bangarupalem,MAHASAMUDRAM,144,3,166,313,24,0,15,39,38,1332,0,890,2222,1550,4,0,4,8
1067,CHITTOOR,Bangarupalem,MANGALAPALLI,66,20,242,328,6,0,76,82,57,352,0,5405,5757,3144,0,0,26,26
1068,CHITTOOR,Bangarupalem,MOGILI,173,50,348,571,32,0,22,54,34,1771,0,1204,2975,1519,6,0,5,11
1069,CHITTOOR,Bangarupalem,MOGILIVARIPALLI,198,142,415,755,19,0,30,49,40,244,0,1405,1649,876,1,0,2,3
1070,CHITTOOR,Bangarupalem,MUNGARAMADUGU,195,0,0,195,29,0,0,29,27,1153,0,0,1153,535,2,0,0,2
1071,CHITTOOR,Bangarupalem,NALAGAMPALLI,363,3,225,591,57,0,60,117,68,3998,0,3797,7795,3420,18,0,17,35
1072,CHITTOOR,Bangarupalem,NALLANGADU,244,12,254,510,54,0,27,81,62,2862,0,1714,4576,2152,11,0,9,20
1073,CHITTOOR,Bangarupalem,PALERU,177,36,334,547,4,2,48,54,28,61,24,1431,1516,650,0,0,3,3
1074,CHITTOOR,Bangarupalem,PERUMALLAPALLI,60,19,228,307,25,1,24,50,34,570,42,1055,1667,780,0,0,0,0
1075,CHITTOOR,Bangarupalem,RAGIMANIPENTA,296,16,475,787,61,0,78,139,124,1035,0,5143,6178,2959,0,0,24,24
1076,CHITTOOR,Bangarupalem,SADAKUPPAM,119,0,190,309,28,0,61,89,81,705,0,4575,5280,2669,0,0,24,24
1077,CHITTOOR,Bangarupalem,SANKRANTHIPALLI,90,19,294,403,42,2,94,138,108,2416,96,7387,9899,4257,12,0,44,56
1078,CHITTOOR,Bangarupalem,SETTERI,130,1,183,314,56,0,50,106,83,4497,0,2998,7495,3939,27,0,11,38
1079,CHITTOOR,Bangarupalem,TEKUMANDA,53,63,487,603,2,10,66,78,82,48,386,2312,2746,1426,0,0,3,3
1080,CHITTOOR,Bangarupalem,THAGGUVARIPALLI,236,16,559,811,31,0,20,51,41,2846,0,1090,3936,1770,18,0,5,23
1081,CHITTOOR,Bangarupalem,THAMBUGANIPALLE,109,2,232,343,29,0,26,55,51,1717,0,1345,3062,1740,6,0,5,11
1082,CHITTOOR,Bangarupalem,THIMMOJIPALLI,102,1,127,230,31,0,22,53,30,1274,0,1526,2800,1114,3,0,6,9
1083,CHITTOOR,Bangarupalem,THOOMPAYANAPALLE,7,23,182,212,1,0,29,30,25,63,0,2093,2156,1093,0,0,10,10
1084,CHITTOOR,Bangarupalem,THUMBA KUPPAM,249,0,447,696,59,0,70,129,101,4729,0,4945,9674,4731,30,0,23,53
1085,CHITTOOR,Bangarupalem,TUMBA,60,40,187,287,1,7,20,28,21,102,454,1382,1938,875,1,2,7,10
1086,CHITTOOR,Bangarupalem,VELUTHURUCHENU,14,52,347,413,8,10,168,186,149,784,426,8731,9941,4276,7,0,35,42
1087,CHITTOOR,Bangarupalem,VENKATAGIRI,135,0,61,196,14,0,0,14,13,120,0,0,120,78,0,0,0,0
1088,CHITTOOR,Buchinaidu Khandriga,ALATHUR,201,74,177,452,104,25,47,176,156,6141,466,1443,8050,4341,25,0,2,27
1089,CHITTOOR,Buchinaidu Khandriga,B.N.KHANDRIGA,113,150,379,642,62,53,150,265,211,4247,682,5284,10213,5963,20,0,2,22
1090,CHITTOOR,Buchinaidu Khandriga,G.N.KHANDRIGA,6,0,364,370,4,0,245,249,238,100,0,9374,9474,6133,0,0,14,14
1091,CHITTOOR,Buchinaidu Khandriga,GAJULAPELLURE,133,143,291,567,82,49,136,267,210,2710,1418,3182,7310,3920,3,8,3,14
1092,CHITTOOR,Buchinaidu Khandriga,KALLIVETTU,117,23,199,339,91,0,79,170,155,4648,0,2176,6824,4358,8,0,0,8
1093,CHITTOOR,Buchinaidu Khandriga,KAMPALEM,210,95,130,435,133,47,99,279,269,3805,2734,2879,9418,5185,3,12,1,16
1094,CHITTOOR,Buchinaidu Khandriga,KANAMANAMBEDU,200,58,39,297,138,14,15,167,158,5880,261,567,6708,4013,4,0,1,5
1095,CHITTOOR,Buchinaidu Khandriga,KANCHANAPUTTUR,118,51,259,428,51,22,102,175,161,1397,340,2071,3808,2515,1,0,4,5
1096,CHITTOOR,Buchinaidu Khandriga,KARANI,255,109,253,617,179,0,125,304,249,4322,0,3431,7753,4527,1,0,6,7
1097,CHITTOOR,Buchinaidu Khandriga,KATURU,219,90,288,597,98,18,112,228,209,2723,723,4666,8112,5989,2,1,2,5
1098,CHITTOOR,Buchinaidu Khandriga,KOTHAPALEM,90,8,186,284,53,0,107,160,143,3134,0,5092,8226,5778,10,0,11,21
1099,CHITTOOR,Buchinaidu Khandriga,KUKKAMBAKAM,85,61,261,407,35,26,189,250,222,1024,1054,9220,11298,5825,1,0,14,15
1100,CHITTOOR,Buchinaidu Khandriga,NEERPAKOTA,306,135,211,652,180,26,94,300,275,4964,529,3031,8524,5729,7,0,3,10
1101,CHITTOOR,Buchinaidu Khandriga,NELAVOY,96,7,120,223,71,0,54,125,113,3127,0,3331,6458,4070,6,0,13,19
1102,CHITTOOR,Buchinaidu Khandriga,P.V.KHANDRIGA,88,97,260,445,48,31,119,198,159,3451,1362,6299,11112,5954,15,0,20,35
1103,CHITTOOR,Buchinaidu Khandriga,PALLAMALA,158,136,345,639,98,50,51,199,174,4651,2227,2691,9569,6893,7,2,7,16
1104,CHITTOOR,Buchinaidu Khandriga,PARLAPALLI,209,17,197,423,107,2,116,225,206,3242,86,4113,7441,4674,2,0,5,7
1105,CHITTOOR,Buchinaidu Khandriga,PEDDAPALAVEDU,110,72,75,257,84,19,34,137,104,4523,1262,1933,7718,4393,5,4,5,14
1106,CHITTOOR,Buchinaidu Khandriga,PUTTERI,159,64,77,300,99,33,30,162,123,4953,2231,730,7914,3766,11,7,0,18
1107,CHITTOOR,Buchinaidu Khandriga,R.ANANTHAPURAM,140,21,186,347,107,6,147,260,225,4573,152,6144,10869,5663,5,0,9,14
1108,CHITTOOR,Buchinaidu Khandriga,TALARIVETTU,214,36,132,382,141,7,54,202,206,7590,330,1079,8999,6869,19,1,1,21
1109,CHITTOOR,Buchinaidu Khandriga,V.S.PURAM,215,70,72,357,146,11,62,219,196,7310,342,1757,9409,7066,11,0,0,11
1110,CHITTOOR,Buchinaidu Khandriga,VENUGOPALAPURAM,134,126,134,394,87,15,74,176,151,4460,479,4538,9477,5769,5,0,10,15
1111,CHITTOOR,Buchinaidu Khandriga,WEST WARATHUR,199,10,115,324,155,0,62,217,222,5738,0,1246,6984,4032,10,0,1,11
1112,CHITTOOR,Chandragiri,A.G.GARI PALLE,3,66,82,151,1,28,33,62,51,120,2192,2780,5092,2785,1,13,17,31
1113,CHITTOOR,Chandragiri,AGARALA,119,2,178,299,42,0,0,42,39,1748,0,0,1748,1417,0,0,0,0
1114,CHITTOOR,Chandragiri,ARE PALLE RANGAMPET,189,76,425,690,24,1,108,133,128,1303,100,5839,7242,6596,4,1,19,24
1115,CHITTOOR,Chandragiri,B.KONGARAVARI PALLE,2,7,106,115,2,3,56,61,51,118,151,3640,3909,2263,1,0,12,13
1116,CHITTOOR,Chandragiri,BANDARLA PALLE,72,1,102,175,33,0,0,33,33,1754,0,0,1754,1368,2,0,0,2
1117,CHITTOOR,Chandragiri,BHEEMAVARAM,1,51,195,247,0,26,81,107,95,0,931,4995,5926,3194,0,4,19,23
1118,CHITTOOR,Chandragiri,BUCHINAIDUPALLE,108,13,70,191,16,0,0,16,17,911,0,0,911,797,2,0,0,2
1119,CHITTOOR,Chandragiri,CHANDRAGIRI,273,36,1653,1962,13,0,24,37,34,565,0,464,1029,602,1,0,1,2
1120,CHITTOOR,Chandragiri,CHINNARAMA PURAM,142,0,31,173,98,0,20,118,114,7148,0,1418,8566,6560,31,0,8,39
1121,CHITTOOR,Chandragiri,DORNAKAMBALA,154,155,436,745,77,12,209,298,271,4566,213,11576,16355,11766,8,0,7,15
1122,CHITTOOR,Chandragiri,GANGUDU PALLE,64,5,482,551,25,0,190,215,202,998,0,9235,10233,7697,0,0,10,10
1123,CHITTOOR,Chandragiri,ITHEPALLE,59,18,213,290,33,3,24,60,54,1938,85,1167,3190,2202,4,0,0,4
1124,CHITTOOR,Chandragiri,KALROADPALLE,104,62,104,270,35,38,27,100,69,1963,1675,590,4228,2024,8,4,0,12
1125,CHITTOOR,Chandragiri,KANDULAVARI PALLE,67,7,139,213,20,0,39,59,46,870,0,2287,3157,1870,1,0,5,6
1126,CHITTOOR,Chandragiri,KASIPENTLA,97,17,175,289,34,2,20,56,46,2465,237,1505,4207,2402,8,2,5,15
1127,CHITTOOR,Chandragiri,KONDREDDY KHANDRIGA,70,47,93,210,58,21,38,117,104,5128,1694,2745,9567,5328,28,13,12,53
1128,CHITTOOR,Chandragiri,KOTALA,205,25,329,559,72,3,50,125,107,3758,18,2354,6130,4448,10,0,4,14
1129,CHITTOOR,Chandragiri,M.KONGAVARI PALLE,20,5,158,183,15,2,67,84,74,917,132,4881,5930,3653,3,0,27,30
1130,CHITTOOR,Chandragiri,MAMANDDUR,53,6,70,129,31,0,4,35,28,1531,0,87,1618,1108,2,0,0,2
1131,CHITTOOR,Chandragiri,MITTAPALEM,118,94,168,380,1,7,6,14,14,5,49,57,111,111,0,0,0,0
1132,CHITTOOR,Chandragiri,MUNGILIPATTU,79,27,79,185,8,1,7,16,15,152,36,240,428,250,0,0,0,0
1133,CHITTOOR,Chandragiri,MUNGILIPATTUKOTHAPALLE,24,21,122,167,18,16,74,108,90,1742,1398,6746,9886,5925,13,12,51,76
1134,CHITTOOR,Chandragiri,NARASINGA PURAM,132,29,167,328,37,5,6,48,44,2871,519,707,4097,3033,13,4,5,22
1135,CHITTOOR,Chandragiri,PANAPAKAM,188,6,871,1065,86,0,90,176,149,5738,0,3564,9302,6286,22,0,8,30
1136,CHITTOOR,Chandragiri,PICHINAIDUPALLE,211,2,100,313,112,0,35,147,136,5987,0,2364,8351,5256,20,0,9,29
1137,CHITTOOR,Chandragiri,PULITHAVARI PALLE,141,0,2,143,61,0,0,61,54,3220,0,0,3220,2231,14,0,0,14
1138,CHITTOOR,Chandragiri,PULLAIAHGARI PALLE,30,57,109,196,0,0,3,3,4,0,0,36,36,24,0,0,0,0
1139,CHITTOOR,Chandragiri,RAMIREDDI PALLE,134,69,166,369,11,17,28,56,54,97,338,656,1091,764,0,0,0,0
1140,CHITTOOR,Chandragiri,RAYAL PURAM,463,0,49,512,122,0,3,125,111,7520,0,214,7734,7032,25,0,0,25
1141,CHITTOOR,Chandragiri,REDDIVARI PALLE,7,0,21,28,2,0,0,2,2,229,0,0,229,229,2,0,0,2
1142,CHITTOOR,Chandragiri,REDDIVARIPALLE,3,5,80,88,1,3,44,48,46,20,326,4158,4504,3454,0,3,29,32
1143,CHITTOOR,Chandragiri,SANAMBATLA,125,10,547,682,52,1,181,234,205,1773,25,6870,8668,5173,0,0,15,15
1144,CHITTOOR,Chandragiri,SESHA PURAM,94,3,107,204,24,0,67,91,69,1723,0,5715,7438,4049,9,0,32,41
1145,CHITTOOR,Chandragiri,THONDA WADA,159,110,242,511,21,32,6,59,46,186,1294,318,1798,936,0,4,0,4
1146,CHITTOOR,Chinnagottigallu,BHAKARAPET,230,18,430,678,25,0,82,107,94,1190,0,5124,6314,3061,5,0,19,24
1147,CHITTOOR,Chinnagottigallu,CHATTEVARIPALEM,227,37,530,794,89,11,218,318,310,5624,122,13045,18791,9773,29,0,59,88
1148,CHITTOOR,Chinnagottigallu,CHINNAGOTTI GALLU,244,71,858,1173,99,6,269,374,344,7284,274,21739,29297,13711,36,1,125,162
1149,CHITTOOR,Chinnagottigallu,CHITTECHERLA,173,140,500,813,46,27,104,177,144,1772,1312,4678,7762,3447,6,4,14,24
1150,CHITTOOR,Chinnagottigallu,DEENDARUPALLE,81,2,607,690,20,0,140,160,120,557,0,6703,7260,3052,2,0,21,23
1151,CHITTOOR,Chinnagottigallu,DEVARAKONDA,120,15,228,363,38,0,109,147,123,1769,0,7343,9112,3678,5,0,37,42
1152,CHITTOOR,Chinnagottigallu,DIGUVURU,109,48,234,391,46,11,109,166,155,2714,362,7613,10689,5001,14,1,44,59
1153,CHITTOOR,Chinnagottigallu,JANGAVANDLA PALLE,155,3,443,601,81,0,222,303,275,5330,0,17447,22777,11228,28,0,94,122
1154,CHITTOOR,Chinnagottigallu,KOTABYLU,34,0,371,405,21,0,158,179,165,1195,0,10438,11633,5647,5,0,51,56
1155,CHITTOOR,Chinnagottigallu,NELLUTLA VARI PALLE,317,24,372,713,88,7,162,257,247,5011,194,12709,17914,8602,19,1,65,85
1156,CHITTOOR,Chinnagottigallu,RANGANNAGARI GADDA,23,11,296,330,14,0,104,118,103,721,0,5115,5836,2942,4,0,20,24
1157,CHITTOOR,Chinnagottigallu,THIPPIREDDIGARI PALLE,26,3,576,605,8,0,215,223,204,775,0,12586,13361,6667,3,0,50,53
1158,CHITTOOR,Chinnagottigallu,YEGUVURU,59,23,178,260,31,12,67,110,90,2150,710,4880,7740,3648,8,3,25,36
1159,CHITTOOR,Chittoor,ANAGALLU,167,0,68,235,120,0,11,131,113,9061,0,1000,10061,5038,50,0,7,57
1160,CHITTOOR,Chittoor,ANANTHAPURAM,171,1,110,282,67,0,36,103,97,5356,0,1346,6702,6041,26,0,2,28
1161,CHITTOOR,Chittoor,ANUPALLE,126,5,110,241,0,0,4,4,4,0,0,450,450,204,0,0,3,3
1162,CHITTOOR,Chittoor,B.N.R.PETA,2,0,130,132,0,0,0,0,0,0,0,0,0,0,0,0,0,0
1163,CHITTOOR,Chittoor,CHERLOPALLE,229,50,301,580,37,1,34,72,64,2110,5,605,2720,1757,7,0,1,8
1164,CHITTOOR,Chittoor,CHINTHALAGUNTA,114,1,139,254,64,0,6,70,53,3151,0,399,3550,1451,3,0,2,5
1165,CHITTOOR,Chittoor,DIGUVAMASAPALLE,344,42,408,794,42,0,45,87,83,1236,0,1650,2886,1893,0,0,1,1
1166,CHITTOOR,Chittoor,DODDIPALLE,1,0,329,330,0,0,0,0,0,0,0,0,0,0,0,0,0,0
1167,CHITTOOR,Chittoor,GUVVAKALLU,142,0,95,237,48,0,8,56,55,1143,0,364,1507,1160,0,0,0,0
1168,CHITTOOR,Chittoor,KURCHIVEDU,206,1,158,365,72,0,55,127,128,3897,0,4187,8084,4934,9,0,19,28
1169,CHITTOOR,Chittoor,L.B.PURAM,148,10,222,380,2,0,18,20,18,132,0,1236,1368,732,0,0,5,5
1170,CHITTOOR,Chittoor,MANGASAMUDRAM,86,34,301,421,0,0,0,0,0,0,0,0,0,0,0,0,0,0
1171,CHITTOOR,Chittoor,MANGASAMUDRAM HOUSING C,135,27,526,688,0,0,0,0,0,0,0,0,0,0,0,0,0,0
1172,CHITTOOR,Chittoor,MAPAKSHI,216,68,151,435,10,1,10,21,19,306,12,672,990,504,0,0,2,2
1173,CHITTOOR,Chittoor,MURAKAMBATTU,91,0,359,450,0,0,0,0,0,0,0,0,0,0,0,0,0,0
1174,CHITTOOR,Chittoor,MUTHUKURU,300,1,77,378,113,0,28,141,129,6838,0,2246,9084,6013,26,0,11,37
1175,CHITTOOR,Chittoor,NARIGAPALLE,49,27,312,388,1,0,8,9,11,24,0,798,822,480,0,0,4,4
1176,CHITTOOR,Chittoor,NAYANICHERUVU,4,2,221,227,4,0,90,94,96,117,0,7576,7693,4153,0,0,37,37
1177,CHITTOOR,Chittoor,PACHANAPALLE,205,0,66,271,94,0,12,106,114,7084,0,1149,8233,6251,27,0,6,33
1178,CHITTOOR,Chittoor,PALURU,38,7,146,191,20,1,77,98,81,953,13,5008,5974,3062,2,0,16,18
1179,CHITTOOR,Chittoor,PEDDISETTIPALLE,3,0,283,286,0,0,77,77,75,0,0,5968,5968,3579,0,0,36,36
1180,CHITTOOR,Chittoor,PERUMALLUKANDIGA,97,0,136,233,59,0,49,108,106,4619,0,4701,9320,5013,21,0,26,47
1181,CHITTOOR,Chittoor,THALAMBEDU,187,13,381,581,28,0,17,45,47,413,0,691,1104,672,0,0,2,2
1182,CHITTOOR,Chittoor,THENEBANDA,150,1,216,367,11,0,2,13,13,66,0,12,78,78,0,0,0,0
1183,CHITTOOR,Chittoor,THIMMASANIPALLE,85,4,181,270,1,1,28,30,27,54,124,2471,2649,1328,0,1,13,14
1184,CHITTOOR,Chittoor,THOPPATIPALLE,21,20,239,280,6,7,91,104,86,198,302,6577,7077,3473,0,2,32,34
1185,CHITTOOR,Chittoor,THUMMINDA,203,4,341,548,31,0,80,111,84,1157,0,4652,5809,2485,2,0,21,23
1186,CHITTOOR,Chowdepalle,29 A.CHINTAMAKULA PALLE,69,0,279,348,26,0,76,102,85,1356,0,3731,5087,2302,4,0,14,18
1187,CHITTOOR,Chowdepalle,A.KOTHA KOTA,132,3,499,634,5,0,19,24,23,47,0,233,280,141,0,0,0,0
1188,CHITTOOR,Chowdepalle,AMINIGUNTA,86,52,300,438,23,16,66,105,94,1192,674,3827,5693,2774,3,2,12,17
1189,CHITTOOR,Chowdepalle,CHARALA,215,4,392,611,56,0,25,81,85,3669,0,1440,5109,2850,17,0,7,24
1190,CHITTOOR,Chowdepalle,CHOWDEPALLE,209,30,732,971,46,1,47,94,95,1565,6,2481,4052,2301,4,0,12,16
1191,CHITTOOR,Chowdepalle,DIGUVAPALLE,108,114,511,733,9,27,49,85,90,298,1809,2020,4127,2073,0,6,2,8
1192,CHITTOOR,Chowdepalle,DURGASAMUDRAM,149,38,542,729,22,5,1,28,31,1106,102,5,1213,661,2,0,0,2
1193,CHITTOOR,Chowdepalle,GADDAMVARIPALLE,216,9,182,407,58,2,27,87,60,2753,73,1493,4319,1652,5,0,4,9
1194,CHITTOOR,Chowdepalle,KAGITHI,95,11,700,806,19,0,125,144,143,765,0,4832,5597,2793,1,0,8,9
1195,CHITTOOR,Chowdepalle,KATIPERI,145,2,438,585,8,0,13,21,19,88,0,251,339,181,0,0,0,0
1196,CHITTOOR,Chowdepalle,KONDAIAHGARI PALLE,105,8,127,240,33,1,19,53,48,749,6,1015,1770,934,0,0,3,3
1197,CHITTOOR,Chowdepalle,KONDAMARRI,66,9,372,447,35,1,82,118,98,2176,30,3750,5956,3757,5,0,7,12
1198,CHITTOOR,Chowdepalle,LADDIGAM,150,0,208,358,72,0,38,110,77,5051,0,2093,7144,3478,29,0,7,36
1199,CHITTOOR,Chowdepalle,PANDILLAPALLE,129,34,306,469,30,0,97,127,106,763,0,3174,3937,1960,0,0,1,1
1200,CHITTOOR,Chowdepalle,PARIKIDONA,101,8,369,478,29,0,68,97,84,1074,0,2920,3994,1824,2,0,4,6
1201,CHITTOOR,Chowdepalle,PEDDAYELLA KUNTLA,70,0,101,171,15,0,15,30,34,520,0,844,1364,673,1,0,4,5
1202,CHITTOOR,Chowdepalle,PEDDAYELLAKUNTLA,46,0,207,253,27,0,58,85,92,810,0,1220,2030,1210,0,0,0,0
1203,CHITTOOR,Chowdepalle,PUDIPATLA,46,0,326,372,18,0,62,80,86,846,0,2713,3559,2113,1,0,7,8
1204,CHITTOOR,Chowdepalle,SETTI PETA,60,8,206,274,3,3,72,78,54,300,249,4269,4818,1651,2,1,22,25
1205,CHITTOOR,Chowdepalle,VENGALA PALLE,35,4,300,339,12,0,85,97,75,441,0,2783,3224,1584,1,0,2,3
1206,CHITTOOR,Gangadhara Nellore,AGARAMANGALAM,142,0,205,347,79,0,14,93,94,3852,0,378,4230,3243,11,0,0,11
1207,CHITTOOR,Gangadhara Nellore,AMBODHARAPALLE,175,7,130,312,79,0,16,95,93,5077,0,1771,6848,4492,16,0,11,27
1208,CHITTOOR,Gangadhara Nellore,ATMAKUR,213,1,60,274,101,0,6,107,97,4561,0,292,4853,3252,7,0,1,8
1209,CHITTOOR,Gangadhara Nellore,BALAGANGANAPALLE,247,16,734,997,104,8,274,386,349,4034,334,14023,18391,9455,10,0,54,64
1210,CHITTOOR,Gangadhara Nellore,BANGAREDDIPALLE,2,2,190,194,1,1,97,99,78,101,125,6623,6849,4308,1,1,30,32
1211,CHITTOOR,Gangadhara Nellore,BUKKAPATNAM,263,6,353,622,70,5,111,186,160,2271,356,6007,8634,4768,7,2,22,31
1212,CHITTOOR,Gangadhara Nellore,CHINNAVEPANJERI,84,8,156,248,3,0,31,34,30,24,0,1056,1080,639,0,0,2,2
1213,CHITTOOR,Gangadhara Nellore,ELLAPALLE,76,0,40,116,63,0,33,96,83,3482,0,1542,5024,2909,8,0,3,11
1214,CHITTOOR,Gangadhara Nellore,GANGADHARNELLORE,537,14,444,995,127,0,51,178,175,4942,0,2976,7918,5906,5,0,9,14
1215,CHITTOOR,Gangadhara Nellore,K.V PURAM,33,0,141,174,0,0,27,27,24,0,0,791,791,475,0,0,0,0
1216,CHITTOOR,Gangadhara Nellore,KADAPA GUNTA,411,0,95,506,106,0,18,124,99,5245,0,1501,6746,3972,11,0,7,18
1217,CHITTOOR,Gangadhara Nellore,KALIJAVEDU,114,24,204,342,44,8,81,133,109,2135,486,4366,6987,3636,8,1,15,24
1218,CHITTOOR,Gangadhara Nellore,KONDEPALLE,128,6,174,308,48,1,57,106,99,2095,35,4744,6874,3563,10,0,28,38
1219,CHITTOOR,Gangadhara Nellore,KOTAGARAM,260,3,215,478,141,1,58,200,168,9672,106,2929,12707,6697,36,1,4,41
1220,CHITTOOR,Gangadhara Nellore,KOTRAKONA,140,0,268,408,72,0,48,120,112,2581,0,3920,6501,4383,4,0,25,29
1221,CHITTOOR,Gangadhara Nellore,MD. MANGALAM,125,1,135,261,0,0,23,23,25,0,0,1020,1020,558,0,0,2,2
1222,CHITTOOR,Gangadhara Nellore,MUKKALATHURU,277,1,133,411,51,0,0,51,56,1260,0,0,1260,974,1,0,0,1
1223,CHITTOOR,Gangadhara Nellore,NALLEPALLE,365,13,510,888,56,0,155,211,174,1544,0,7030,8574,5193,3,0,12,15
1224,CHITTOOR,Gangadhara Nellore,NANDANOOR,69,0,150,219,31,0,62,93,74,2915,0,4334,7249,3138,19,0,25,44
1225,CHITTOOR,Gangadhara Nellore,P.V PURAM,273,11,145,429,65,0,42,107,107,3479,0,1344,4823,4007,5,0,1,6
1226,CHITTOOR,Gangadhara Nellore,PACHIGUNTA,204,7,176,387,77,0,28,105,102,2069,0,1087,3156,2430,4,0,0,4
1227,CHITTOOR,Gangadhara Nellore,PAPIREDDIPALLE,82,9,333,424,34,1,107,142,118,2067,89,6015,8171,4586,3,0,16,19
1228,CHITTOOR,Gangadhara Nellore,PATHAPALEM,90,12,69,171,66,0,2,68,70,3285,0,54,3339,2400,8,0,0,8
1229,CHITTOOR,Gangadhara Nellore,PEDDAVAKALVA,133,1,365,499,22,0,110,132,117,712,0,7071,7783,4829,0,0,27,27
1230,CHITTOOR,Gangadhara Nellore,T.V. KUPPAM,8,0,47,55,0,0,0,0,0,0,0,0,0,0,0,0,0,0
1231,CHITTOOR,Gangadhara Nellore,THUGUNDRUM,354,34,470,858,109,3,118,230,211,2887,182,5263,8332,5873,5,1,11,17
1232,CHITTOOR,Gangadhara Nellore,VARATHUR,394,17,709,1120,16,2,67,85,75,288,24,1477,1789,966,1,0,0,1
1233,CHITTOOR,Gangadhara Nellore,VEERAKANELLORE,202,0,138,340,50,0,21,71,68,925,0,1371,2296,1193,0,0,6,6
1234,CHITTOOR,Gangadhara Nellore,VELKUR,376,2,353,731,47,0,119,166,162,1648,0,4455,6103,4076,2,0,11,13
1235,CHITTOOR,Gangadhara Nellore,VEPANJERI,176,8,467,651,10,0,196,206,190,261,0,5738,5999,4888,0,0,4,4
1236,CHITTOOR,Gangadhara Nellore,VEZZUPALLE,210,0,406,616,51,0,107,158,122,1902,0,3239,5141,2353,3,0,6,9
1237,CHITTOOR,Gangadhara Nellore,VINJAM,244,0,473,717,74,0,122,196,169,2827,0,5030,7857,4463,6,0,12,18
1238,CHITTOOR,Gangavaram,CHOWDIREDDIPALLE,88,38,282,408,31,13,89,133,123,2099,323,5738,8160,4798,9,0,20,29
1239,CHITTOOR,Gangavaram,DANDAPALLE,133,0,540,673,70,0,116,186,176,3381,0,6761,10142,6320,6,0,20,26
1240,CHITTOOR,Gangavaram,GANDRAJUPALLE,333,6,947,1286,87,0,125,212,182,5639,0,9171,14810,6894,31,0,53,84
1241,CHITTOOR,Gangavaram,GANGAVARAM,304,18,1729,2051,11,0,139,150,145,738,0,8695,9433,4962,4,0,30,34
1242,CHITTOOR,Gangavaram,GUNDUGALLU,267,20,425,712,50,2,58,110,90,2450,114,3121,5685,2272,10,0,10,20
1243,CHITTOOR,Gangavaram,JEEDIMAKULAPALLE,45,3,383,431,14,1,182,197,175,1074,27,14419,15520,7570,6,0,82,88
1244,CHITTOOR,Gangavaram,KALAGATOOR,268,3,216,487,135,0,42,177,146,9899,0,1860,11759,5943,40,0,1,41
1245,CHITTOOR,Gangavaram,KALLUPALLE,219,10,504,733,67,0,142,209,143,3778,0,8958,12736,6235,13,0,31,44
1246,CHITTOOR,Gangavaram,KEELAPALLE,199,1,249,449,80,0,60,140,112,3974,0,3656,7630,3760,13,0,22,35
1247,CHITTOOR,Gangavaram,KEELAPATLA,197,47,559,803,29,15,124,168,152,532,705,5663,6900,3542,0,0,20,20
1248,CHITTOOR,Gangavaram,KOTHAPALLE,197,73,526,796,33,14,99,146,119,937,587,4059,5583,2987,4,2,8,14
1249,CHITTOOR,Gangavaram,MAMADUGU,115,4,430,549,67,1,152,220,158,3118,1,4644,7763,3550,5,0,7,12
1250,CHITTOOR,Gangavaram,MELUMOY,167,9,753,929,15,1,174,190,155,326,27,7703,8056,4632,0,0,22,22
1251,CHITTOOR,Gangavaram,PASUPATHURU,84,3,513,600,27,1,146,174,139,1298,92,7764,9154,4644,6,0,19,25
1252,CHITTOOR,Gangavaram,PATHIKONDA,48,16,496,560,4,5,97,106,100,50,190,5210,5450,2794,0,0,28,28
1253,CHITTOOR,Gangavaram,THALLAPALLE,178,9,209,396,92,1,66,159,132,7562,80,3821,11463,5286,53,0,22,75
1254,CHITTOOR,Gudi Palle,AGARAM,10,0,342,352,6,0,164,170,148,431,0,15048,15479,8934,3,0,107,110
1255,CHITTOOR,Gudi Palle,BEGGILAPALLE,101,14,389,504,40,6,142,188,173,2652,250,11143,14045,10553,12,0,66,78
1256,CHITTOOR,Gudi Palle,CHEEKATIPALLE,127,0,182,309,57,0,50,107,105,4426,0,4457,8883,6317,23,0,28,51
1257,CHITTOOR,Gudi Palle,CHINNAGOLLAPALLE,31,0,401,432,9,0,135,144,137,760,0,8974,9734,8546,4,0,43,47
1258,CHITTOOR,Gudi Palle,DASIMANIPALLE,34,1,291,326,3,0,41,44,39,70,0,2190,2260,1701,0,0,12,12
1259,CHITTOOR,Gudi Palle,GUDIPALLE,65,1,425,491,24,0,163,187,172,2566,0,13288,15854,10943,21,0,78,99
1260,CHITTOOR,Gudi Palle,GUNDLASAGARAM,3,0,350,353,0,0,12,12,14,0,0,602,602,470,0,0,0,0
1261,CHITTOOR,Gudi Palle,KANAMANAPALLE,82,0,402,484,0,0,12,12,13,0,0,480,480,430,0,0,1,1
1262,CHITTOOR,Gudi Palle,KANCHIBANDARLAPALLE,2,0,392,394,0,0,132,132,134,0,0,10485,10485,8651,0,0,73,73
1263,CHITTOOR,Gudi Palle,KODATHANAPALLE,63,0,249,312,24,0,107,131,119,1394,0,7230,8624,6878,0,0,26,26
1264,CHITTOOR,Gudi Palle,KUPPIGANIPALLE,98,1,463,562,40,0,190,230,212,3348,0,15462,18810,15646,21,0,91,112
1265,CHITTOOR,Gudi Palle,ONNAPPANAYANIKOTHUR,127,0,332,459,47,0,44,91,80,3403,0,2807,6210,4191,20,0,16,36
1266,CHITTOOR,Gudi Palle,PEDDABADANIWADA,49,27,914,990,10,3,134,147,148,627,131,11581,12339,10824,4,1,70,75
1267,CHITTOOR,Gudi Palle,POGURUPALLE,126,5,283,414,53,0,70,123,109,5351,0,5482,10833,8098,41,0,29,70
1268,CHITTOOR,Gudi Palle,SANGANAPALLE,130,4,665,799,41,0,326,367,366,2690,0,28732,31422,23635,11,0,200,211
1269,CHITTOOR,Gudi Palle,SETTIPALLE,140,16,434,590,52,0,112,164,140,4455,0,9091,13546,9837,29,0,51,80
1270,CHITTOOR,Gudi Palle,SODIGANIPALLE,119,4,772,895,40,1,217,258,272,3107,98,16565,19770,12881,16,0,78,94
1271,CHITTOOR,Gudi Palle,YAMAGANIPALLE,15,0,663,678,1,0,105,106,101,6,0,6902,6908,6327,0,0,31,31
1272,CHITTOOR,Gudipala,190 RAMAPURAM,254,8,89,351,78,0,1,79,62,7316,0,108,7424,4849,52,0,1,53
1273,CHITTOOR,Gudipala,197 RAMAPURAM,233,0,236,469,88,0,56,144,154,5041,0,2453,7494,5270,25,0,7,32
1274,CHITTOOR,Gudipala,ADILAKSHMAMBAPURAM,6,3,251,260,3,1,118,122,106,18,38,6362,6418,4140,0,0,16,16
1275,CHITTOOR,Gudipala,BANDAPALLE,30,5,214,249,21,2,71,94,89,1227,54,4453,5734,3286,1,0,20,21
1276,CHITTOOR,Gudipala,BASAVAPALLE,283,2,196,481,57,1,11,69,57,1688,43,296,2027,1239,4,0,0,4
1277,CHITTOOR,Gudipala,BOMMASAMUDRAM,278,12,149,439,54,0,3,57,53,1447,0,52,1499,1068,0,0,0,0
1278,CHITTOOR,Gudipala,CHEELAPALLE,166,6,225,397,68,1,47,116,104,2651,42,2644,5337,3340,4,0,7,11
1279,CHITTOOR,Gudipala,CHITTAPARA,148,9,333,490,35,0,9,44,40,1298,0,155,1453,1163,0,0,0,0
1280,CHITTOOR,Gudipala,GETRALAMITTA,191,20,102,313,75,0,10,85,88,4414,0,349,4763,3067,14,0,1,15
1281,CHITTOOR,Gudipala,GOLLAMADUGU,94,7,135,236,0,0,6,6,5,0,0,120,120,60,0,0,0,0
1282,CHITTOOR,Gudipala,GUDIPALA,139,27,219,385,15,0,12,27,25,567,0,264,831,570,0,0,0,0
1283,CHITTOOR,Gudipala,KOTHAPALLE,443,5,190,638,49,0,13,62,56,1926,0,450,2376,1608,5,0,0,5
1284,CHITTOOR,Gudipala,KRISHNA JIMMA PURAM,2,3,160,165,1,2,79,82,82,12,72,3529,3613,2410,0,0,9,9
1285,CHITTOOR,Gudipala,KUPPIGANIPALLE,98,3,127,228,23,2,29,54,55,672,24,872,1568,1070,2,0,0,2
1286,CHITTOOR,Gudipala,MANDIKRISHNAPURAM,161,36,88,285,0,0,0,0,0,0,0,0,0,0,0,0,0,0
1287,CHITTOOR,Gudipala,MARAKALAKUPPAM,279,22,221,522,82,0,33,115,108,2772,0,950,3722,2973,1,0,1,2
1288,CHITTOOR,Gudipala,MOGARALAPALLE,184,13,118,315,63,3,27,93,82,2715,102,758,3575,1880,6,0,0,6
1289,CHITTOOR,Gudipala,NANGAMANGALAM,29,35,100,164,0,4,5,9,9,0,24,36,60,54,0,0,0,0
1290,CHITTOOR,Gudipala,NARAGALLU,194,9,245,448,41,1,47,89,80,699,24,1684,2407,1542,1,0,4,5
1291,CHITTOOR,Gudipala,PANATURU,243,12,222,477,66,0,10,76,76,1937,0,569,2506,1810,2,0,4,6
1292,CHITTOOR,Gudipala,PAPASAMUDRAM,101,5,275,381,0,0,34,34,35,0,0,1797,1797,1641,0,0,3,3
1293,CHITTOOR,Gudipala,PEYANAPALLE,104,29,163,296,20,6,12,38,27,759,207,916,1882,862,3,0,4,7
1294,CHITTOOR,Gudipala,RAMABHADRAPURAM,53,13,284,350,34,9,152,195,188,2428,217,7982,10627,6266,10,0,30,40
1295,CHITTOOR,Gudipala,SRIRANGAMPALLE,152,1,43,196,37,0,0,37,29,635,0,0,635,343,0,0,0,0
1296,CHITTOOR,Gudipala,THIMMAIAHPALLE,69,2,119,190,4,1,55,60,58,36,14,2154,2204,1365,0,0,8,8
1297,CHITTOOR,Gudipala,VASANTHAPURAM,162,20,162,344,40,0,11,51,46,1296,0,670,1966,1150,1,0,3,4
1298,CHITTOOR,Gudipala,VENGAMAMBAPURAM,151,4,82,237,61,0,22,83,83,2362,0,495,2857,1940,7,0,0,7
1299,CHITTOOR,Gudipala,VEPPALAMANUCHENU,19,3,228,250,0,0,26,26,25,0,0,1210,1210,854,0,0,3,3
1300,CHITTOOR,Gurramkonda,AMILEPALLE,87,19,234,340,20,11,107,138,114,1163,351,7223,8737,5158,2,1,41,44
1301,CHITTOOR,Gurramkonda,CHERLOPALLE,104,53,808,965,40,8,186,234,192,1651,174,10024,11849,6491,1,0,29,30
1302,CHITTOOR,Gurramkonda,GURRAMKONDA,287,15,1783,2085,58,1,134,193,182,2829,22,5465,8316,4438,12,0,22,34
1303,CHITTOOR,Gurramkonda,KHANDRIGA,1,0,52,53,0,0,0,0,0,0,0,0,0,0,0,0,0,0
1304,CHITTOOR,Gurramkonda,MARRIMAKULAPALLE,113,32,166,311,36,5,26,67,56,1427,188,937,2552,1378,3,0,4,7
1305,CHITTOOR,Gurramkonda,MARRIPADU,73,12,630,715,33,2,156,191,150,2128,114,9567,11809,6232,6,1,38,45
1306,CHITTOOR,Gurramkonda,NADIMIKHANDRIGA,89,14,775,878,21,0,129,150,132,1174,0,5317,6491,3645,3,0,16,19
1307,CHITTOOR,Gurramkonda,RAMAPURAM,76,3,451,530,35,0,148,183,175,2208,0,7447,9655,4596,9,0,27,36
1308,CHITTOOR,Gurramkonda,SANGASAMUDRAM,42,6,503,551,4,0,53,57,50,107,0,1805,1912,1154,0,0,3,3
1309,CHITTOOR,Gurramkonda,SARIMADUGU,30,103,402,535,0,3,67,70,53,0,87,1751,1838,811,0,0,0,0
1310,CHITTOOR,Gurramkonda,SETTYVARIPALLI,149,2,468,619,83,0,141,224,217,5446,0,5765,11211,5914,29,0,16,45
1311,CHITTOOR,Gurramkonda,T.PASALAVANDLAPALLE,51,5,598,654,24,0,218,242,210,1095,0,11197,12292,6070,1,0,28,29
1312,CHITTOOR,Gurramkonda,T.RACHAPALLE,162,8,280,450,46,4,94,144,128,2798,348,5926,9072,4579,11,2,33,46
1313,CHITTOOR,Gurramkonda,THARIGONDA,153,8,846,1007,41,1,181,223,170,2568,82,10907,13557,6409,12,0,39,51
1314,CHITTOOR,Gurramkonda,YELLUTLA,253,3,628,884,48,1,177,226,209,3356,10,9565,12931,8391,18,0,35,53
1315,CHITTOOR,Irala,BHEEMINENIVARIPALLE,87,16,157,260,52,3,81,136,110,3329,119,5009,8457,3659,11,0,10,21
1316,CHITTOOR,Irala,BOMMASAMUDRAM,228,0,142,370,38,0,9,47,39,2469,0,261,2730,1394,10,0,0,10
1317,CHITTOOR,Irala,CHIGARAPALLE,149,1,99,249,31,0,2,33,24,959,0,40,999,760,0,0,0,0
1318,CHITTOOR,Irala,CHINAKAMPALLE,41,1,143,185,8,0,56,64,41,380,0,3590,3970,1425,0,0,10,10
1319,CHITTOOR,Irala,EGUVACHAVATAPALLE,146,0,115,261,22,0,22,44,27,998,0,879,1877,798,3,0,3,6
1320,CHITTOOR,Irala,ERREPALLE,183,2,246,431,48,0,32,80,30,2174,0,1184,3358,1073,4,0,4,8
1321,CHITTOOR,Irala,ERRTAMPALLE,174,12,392,578,36,7,67,110,75,1233,439,3401,5073,2145,1,2,8,11
1322,CHITTOOR,Irala,GUNDLAPALLE,143,45,301,489,15,0,54,69,55,261,0,1596,1857,1008,0,0,1,1
1323,CHITTOOR,Irala,IRALA,79,61,763,903,2,0,47,49,38,28,0,1200,1228,568,0,0,1,1
1324,CHITTOOR,Irala,IRUVARAMPALLE,139,0,170,309,15,0,34,49,38,282,0,1522,1804,899,0,0,2,2
1325,CHITTOOR,Irala,KAMINAYANIPALLE,178,7,298,483,49,0,85,134,54,1505,0,3392,4897,1318,0,0,7,7
1326,CHITTOOR,Irala,KANIPAKAM,185,54,176,415,0,0,1,1,0,0,0,20,20,0,0,0,0,0
1327,CHITTOOR,Irala,KOLLAPALLE,100,1,318,419,21,0,64,85,61,1334,0,3180,4514,2257,5,0,6,11
1328,CHITTOOR,Irala,KOTHAPALLE,121,0,75,196,6,0,13,19,9,90,0,346,436,72,0,0,2,2
1329,CHITTOOR,Irala,M.PAIPALLE,124,2,236,362,22,0,20,42,35,699,0,643,1342,653,1,0,1,2
1330,CHITTOOR,Irala,MADDIPATLAPALLE,101,8,313,422,11,0,38,49,40,157,0,1878,2035,900,0,0,4,4
1331,CHITTOOR,Irala,MITTOOR,66,0,252,318,15,0,100,115,77,741,0,4295,5036,2257,2,0,4,6
1332,CHITTOOR,Irala,MORAMPALLE,106,16,95,217,36,0,20,56,38,1178,0,698,1876,918,0,0,0,0
1333,CHITTOOR,Irala,MUDIGOLAM,70,0,224,294,13,0,0,13,10,445,0,0,445,226,0,0,0,0
1334,CHITTOOR,Irala,NAGAMVANDLAPALLE,71,4,467,542,23,0,42,65,53,1374,0,2191,3565,1914,4,0,7,11
1335,CHITTOOR,Irala,NAMPALLE,122,1,90,213,37,1,38,76,66,2496,25,2590,5111,2975,10,0,13,23
1336,CHITTOOR,Irala,PERRAIAHGARIPALLE,118,19,165,302,34,6,72,112,103,2475,482,5879,8836,4426,16,2,34,52
1337,CHITTOOR,Irala,POLAKALA,389,56,746,1191,84,19,135,238,182,4323,1292,5375,10990,5650,8,5,5,18
1338,CHITTOOR,Irala,POTHAPALEM,31,0,281,312,0,0,64,64,47,0,0,2767,2767,1448,0,0,4,4
1339,CHITTOOR,Irala,PULLURU,238,1,321,560,44,0,64,108,53,1087,0,1678,2765,1042,0,0,1,1
1340,CHITTOOR,Irala,PUTHURAMADDI,133,19,331,483,63,0,54,117,96,1284,0,1086,2370,1239,0,0,0,0
1341,CHITTOOR,Irala,VADRAMPALLE,43,9,189,241,0,0,67,67,58,0,0,4863,4863,2361,0,0,22,22
1342,CHITTOOR,Irala,VEDAGIRIVARIPALLE,68,31,279,378,25,16,70,111,79,925,1119,3455,5499,2425,1,2,7,10
1343,CHITTOOR,K V B Puram,ADARAM,160,125,565,850,80,70,326,476,427,3224,4521,16344,24089,12445,9,23,49,81
1344,CHITTOOR,K V B Puram,ANJURU,109,73,336,518,48,1,104,153,112,402,6,2374,2782,1604,0,0,0,0
1345,CHITTOOR,K V B Puram,ARAI,97,20,320,437,52,0,116,168,153,5675,0,5158,10833,5844,28,0,13,41
1346,CHITTOOR,K V B Puram,BRAHMANAPALLE,161,0,149,310,93,0,21,114,90,4795,0,1534,6329,2762,11,0,6,17
1347,CHITTOOR,K V B Puram,DIGUVAPUTHURU,90,34,243,367,63,27,160,250,241,2160,1668,9736,13564,8289,2,6,36,44
1348,CHITTOOR,K V B Puram,EGUVAPUDI,0,37,198,235,0,10,123,133,107,0,160,4651,4811,2396,0,0,14,14
1349,CHITTOOR,K V B Puram,GUNTIPEDU,169,30,157,356,68,0,53,121,110,2803,0,2709,5512,3191,9,0,5,14
1350,CHITTOOR,K V B Puram,K.V.B.PURAM,95,17,269,381,57,3,90,150,160,2201,60,4786,7047,4172,9,0,14,23
1351,CHITTOOR,K V B Puram,KALATHURU,333,134,255,722,177,26,66,269,304,8447,501,3393,12341,6769,23,0,10,33
1352,CHITTOOR,K V B Puram,KANDLURU,286,32,97,415,161,6,53,220,204,4779,100,1225,6104,3516,21,0,1,22
1353,CHITTOOR,K V B Puram,KATRAPALLE,186,57,148,391,57,9,94,160,150,1912,216,1803,3931,2030,4,0,1,5
1354,CHITTOOR,K V B Puram,KOTAMANGAPURAM,117,21,323,461,68,10,163,241,232,2594,417,6353,9364,5442,4,0,6,10
1355,CHITTOOR,K V B Puram,KOVANUR,306,108,145,559,172,0,47,219,195,7049,0,1436,8485,3950,16,0,3,19
1356,CHITTOOR,K V B Puram,MATTAM,15,18,193,226,7,9,115,131,114,110,435,6344,6889,4664,0,1,24,25
1357,CHITTOOR,K V B Puram,MIDDI KHANDRIGA,0,10,200,210,0,0,116,116,97,0,0,4774,4774,2893,0,0,4,4
1358,CHITTOOR,K V B Puram,OLLURU,76,41,191,308,49,23,124,196,188,1389,239,4418,6046,3731,0,0,8,8
1359,CHITTOOR,K V B Puram,PATHAPALYAM,102,0,148,250,55,0,50,105,100,1112,0,1159,2271,1318,0,0,0,0
1360,CHITTOOR,K V B Puram,PAVANIVARIKHANDRIGA,158,104,210,472,101,12,111,224,203,4174,496,2866,7536,4260,10,0,3,13
1361,CHITTOOR,K V B Puram,PERINDESAM,409,0,94,503,193,0,32,225,213,12144,0,1270,13414,6636,38,0,0,38
1362,CHITTOOR,K V B Puram,PUDI C.K.PURAM,18,5,162,185,2,0,48,50,41,72,0,1774,1846,931,0,0,2,2
1363,CHITTOOR,K V B Puram,RAGIGUNTA,6,16,398,420,0,0,169,169,153,0,0,4135,4135,2459,0,0,2,2
1364,CHITTOOR,K V B Puram,RANGAIAHGUNTA,19,69,205,293,4,26,139,169,150,328,1243,7259,8830,4548,2,0,24,26
1365,CHITTOOR,K V B Puram,RAYAPEDU,261,61,160,482,157,23,78,258,260,5667,690,1950,8307,4960,6,0,2,8
1366,CHITTOOR,K V B Puram,RAYULA KHANDRIGA,141,27,123,291,67,4,36,107,104,3463,108,1818,5389,3157,13,0,9,22
1367,CHITTOOR,K V B Puram,SADASIVA PURAM,36,0,468,504,12,0,138,150,123,93,0,9307,9400,5354,0,0,30,30
1368,CHITTOOR,K V B Puram,SIDDAMANAIDU KHANDRIGA,83,0,168,251,61,0,100,161,148,2949,0,5979,8928,4979,8,0,26,34
1369,CHITTOOR,K V B Puram,SURAMALA,96,0,180,276,67,0,116,183,175,2157,0,1745,3902,2102,0,0,2,2
1370,CHITTOOR,K V B Puram,THIMMASAMUDRAM,97,83,255,435,50,29,108,187,155,1525,951,3294,5770,2894,1,2,3,6
1371,CHITTOOR,Kalakada,BALAIAHGARIPALLE,166,77,1077,1320,37,0,351,388,409,872,0,24232,25104,13991,3,0,99,102
1372,CHITTOOR,Kalakada,BATAVARIPALLE,148,18,437,603,81,2,159,242,229,4854,114,8535,13503,7156,13,1,27,41
1373,CHITTOOR,Kalakada,DEVALAPALLE,122,0,232,354,32,0,64,96,68,1250,0,3823,5073,2166,5,0,13,18
1374,CHITTOOR,Kalakada,GANGAPURAM,29,0,352,381,19,0,169,188,171,1446,0,14175,15621,8093,4,0,86,90
1375,CHITTOOR,Kalakada,GUDIBANDA,109,9,529,647,25,2,168,195,167,804,46,9008,9858,5592,1,0,32,33
1376,CHITTOOR,Kalakada,KADIRAYACHERUVU,59,1,574,634,27,0,183,210,147,1334,0,7469,8803,3798,8,0,14,22
1377,CHITTOOR,Kalakada,KALAKADA,130,16,476,622,6,9,6,21,28,318,384,192,894,648,0,0,1,1
1378,CHITTOOR,Kalakada,KALAKADADODDIPALLE,5,0,218,223,1,0,78,79,64,6,0,4462,4468,2126,0,0,15,15
1379,CHITTOOR,Kalakada,KONA,149,7,642,798,53,0,195,248,197,3191,0,13738,16929,8362,15,0,74,89
1380,CHITTOOR,Kalakada,MUDIAMVARIPALLE,37,9,254,300,15,3,119,137,102,1003,332,8707,10042,4642,6,2,42,50
1381,CHITTOOR,Kalakada,NADIMICHERLA,113,7,677,797,31,0,249,280,292,1400,0,13543,14943,8179,5,0,48,53
1382,CHITTOOR,Kalakada,NAWABPET,67,13,199,279,32,7,83,122,111,2712,288,5932,8932,4164,19,1,27,47
1383,CHITTOOR,Kalakada,RATHIGUNTAPALLE,69,0,257,326,41,0,166,207,183,3342,0,14604,17946,9592,16,0,90,106
1384,CHITTOOR,Kalakada,YENUGONDAPALEM,73,272,661,1006,38,23,294,355,331,1318,1020,24183,26521,14395,6,5,141,152
1385,CHITTOOR,Kalakada,YERRAKOTAPALLE,122,17,968,1107,57,2,452,511,444,4618,36,32765,37419,18982,28,0,174,202
1386,CHITTOOR,Kalikiri,ADDAVARI PALLE,103,6,474,583,28,1,101,130,95,1556,4,4904,6464,3540,3,0,3,6
1387,CHITTOOR,Kalikiri,CHEEKATIPALLE,40,0,219,259,25,0,136,161,154,1459,0,9371,10830,5689,5,0,43,48
1388,CHITTOOR,Kalikiri,GUNDLORU,49,0,627,676,16,0,90,106,94,964,0,3368,4332,2551,1,0,5,6
1389,CHITTOOR,Kalikiri,GUTTAPALEM,257,6,977,1240,67,0,171,238,225,3137,0,4644,7781,3916,8,0,4,12
1390,CHITTOOR,Kalikiri,KALIKIRI,626,97,2577,3300,91,3,229,323,353,4897,30,8030,12957,9843,15,0,13,28
1391,CHITTOOR,Kalikiri,MAHAL,61,0,254,315,26,0,63,89,77,1502,0,3533,5035,2365,0,0,9,9
1392,CHITTOOR,Kalikiri,MARRIKUNTA PALLE,206,1,661,868,55,0,70,125,114,2084,0,3123,5207,2436,2,0,6,8
1393,CHITTOOR,Kalikiri,MEDIKURTHI,92,1,710,803,35,0,204,239,213,1205,0,10240,11445,6765,1,0,21,22
1394,CHITTOOR,Kalikiri,MORAMKINDA PALLE,38,2,121,161,20,1,58,79,67,1229,44,3156,4429,2161,6,0,3,9
1395,CHITTOOR,Kalikiri,MUNELLAPALLE,79,0,512,591,23,0,110,133,140,1019,0,6463,7482,5294,5,0,19,24
1396,CHITTOOR,Kalikiri,PALLAVOLU,43,13,532,588,30,5,185,220,171,2500,383,13262,16145,9465,10,0,62,72
1397,CHITTOOR,Kalikiri,PARAPATLA,64,1,147,212,41,1,69,111,99,3023,111,5525,8659,4787,18,1,28,47
1398,CHITTOOR,Kalikiri,PATHEGADA,197,9,1118,1324,33,0,316,349,311,1128,0,18771,19899,11218,0,0,112,112
1399,CHITTOOR,Kalikiri,TSANDRAVARIPALLE,0,14,373,387,0,6,71,77,65,0,204,2483,2687,1272,0,0,10,10
1400,CHITTOOR,Kambhamvaripalle,GALIVARIPALLI,112,36,261,409,50,10,69,129,107,2362,864,3670,6896,3332,7,6,13,26
1401,CHITTOOR,Kambhamvaripalle,GARNIMITTA,130,16,585,731,50,2,144,196,151,1171,83,8401,9655,4759,3,0,37,40
1402,CHITTOOR,Kambhamvaripalle,GORANTLA PALLI,36,24,267,327,11,3,70,84,76,145,24,2692,2861,1612,0,0,7,7
1403,CHITTOOR,Kambhamvaripalle,GYARAM PALLI,101,12,315,428,29,2,79,110,87,2090,126,4245,6461,3299,12,1,16,29
1404,CHITTOOR,Kambhamvaripalle,JILLELLAMANDA,75,363,952,1390,11,18,82,111,69,501,923,5600,7024,3018,2,3,37,42
1405,CHITTOOR,Kambhamvaripalle,KAMBHAMVARIPALLI,340,98,1007,1445,87,12,110,209,161,3184,760,8381,12325,5324,7,5,47,59
1406,CHITTOOR,Kambhamvaripalle,KOTHA PALLI,16,10,306,332,1,7,84,92,75,108,442,6698,7248,3228,1,2,36,39
1407,CHITTOOR,Kambhamvaripalle,MADDIPATLAVANDLAPALLI,310,82,565,957,68,10,79,157,123,3192,404,3535,7131,3525,13,0,8,21
1408,CHITTOOR,Kambhamvaripalle,MAHAL RAJU PALLI,60,4,180,244,26,0,80,106,97,1634,0,5367,7001,3610,8,0,25,33
1409,CHITTOOR,Kambhamvaripalle,MARELLA,125,34,525,684,26,11,96,133,107,2089,919,4531,7539,3487,12,7,19,38
1410,CHITTOOR,Kambhamvaripalle,MATAMPALLI,15,14,248,277,6,0,87,93,84,156,0,5678,5834,3289,0,0,27,27
1411,CHITTOOR,Kambhamvaripalle,MUTTUPALLIVANDLAPALLI,125,23,167,315,49,8,21,78,59,3064,662,1412,5138,2405,13,4,10,27
1412,CHITTOOR,Kambhamvaripalle,NOOTHAKALVA,129,7,1107,1243,35,0,184,219,193,2204,0,12251,14455,6884,11,0,64,75
1413,CHITTOOR,Kambhamvaripalle,SORAKAYALA PET,40,0,315,355,3,0,32,35,39,271,0,1533,1804,1159,2,0,5,7
1414,CHITTOOR,Kambhamvaripalle,THEETHAVA GUNTA PALLE,80,2,405,487,18,0,82,100,96,1181,0,4914,6095,3334,6,0,16,22
1415,CHITTOOR,Kambhamvaripalle,THIMMAPURAM,84,2,351,437,10,0,69,79,75,687,0,5565,6252,3319,3,0,31,34
1416,CHITTOOR,Kambhamvaripalle,THUVVAPALLI,98,10,226,334,38,0,68,106,97,2347,0,3864,6211,3143,12,0,16,28
1417,CHITTOOR,Kambhamvaripalle,VAGALLA,83,9,260,352,28,1,103,132,122,1259,49,7299,8607,4874,6,0,30,36
1418,CHITTOOR,Karvetinagar,ALATHUR,211,3,344,558,89,0,94,183,166,5036,0,5582,10618,7287,12,0,10,22
1419,CHITTOOR,Karvetinagar,AMMAPALLE,51,14,249,314,40,9,184,233,202,3735,304,12214,16253,9524,23,1,74,98
1420,CHITTOOR,Karvetinagar,ANNUR,534,6,127,667,214,0,30,244,215,12458,0,3007,15465,10270,36,0,21,57
1421,CHITTOOR,Karvetinagar,C.D. KANDRIGA,44,9,257,310,30,4,209,243,216,3197,310,19198,22705,14712,28,2,107,137
1422,CHITTOOR,Karvetinagar,D. M. PURAM,121,0,497,618,63,0,216,279,253,5563,0,13701,19264,12452,39,0,48,87
1423,CHITTOOR,Karvetinagar,ERRAMARAJUPALLE,89,0,163,252,74,0,111,185,157,6404,0,7088,13492,8811,48,0,37,85
1424,CHITTOOR,Karvetinagar,GAJANKI,150,5,196,351,112,3,135,250,214,9974,96,9405,19475,9760,79,0,45,124
1425,CHITTOOR,Karvetinagar,GOPICHETTY PALLE,350,16,68,434,187,0,0,187,166,16032,0,0,16032,13239,111,0,0,111
1426,CHITTOOR,Karvetinagar,K.M. PURAM,123,4,141,268,104,4,109,217,200,7016,216,6184,13416,9850,52,1,20,73
1427,CHITTOOR,Karvetinagar,K.P AGRAHARAM,21,18,233,272,13,6,131,150,130,1096,299,7520,8915,4607,8,1,11,20
1428,CHITTOOR,Karvetinagar,KARVETINAGAR,479,199,419,1097,205,37,93,335,287,19402,1391,7790,28583,18446,127,3,43,173
1429,CHITTOOR,Karvetinagar,KATHERAPALLI,193,2,159,354,128,1,89,218,190,9485,5,4225,13715,9098,53,0,16,69
1430,CHITTOOR,Karvetinagar,KESAVAKUPPAM,21,27,143,191,19,17,97,133,113,1827,1168,7436,10431,5665,15,5,36,56
1431,CHITTOOR,Karvetinagar,KOLLAGUNTA,201,3,213,417,64,1,30,95,76,5938,61,2501,8500,6416,47,0,17,64
1432,CHITTOOR,Karvetinagar,KOTARVEDU,212,0,140,352,128,0,9,137,133,11398,0,983,12381,8928,82,0,8,90
1433,CHITTOOR,Karvetinagar,L.R.PETA,38,53,226,317,2,20,93,115,116,113,1180,8025,9318,7137,1,4,56,61
1434,CHITTOOR,Karvetinagar,M.M. VILASAM,161,8,124,293,86,0,45,131,132,8285,0,2302,10587,8428,64,0,8,72
1435,CHITTOOR,Karvetinagar,MUKKARAVARIPALLE,93,1,134,228,31,0,38,69,57,2175,0,2390,4565,3440,12,0,3,15
1436,CHITTOOR,Karvetinagar,R.K.V.B. PETA,377,0,245,622,224,0,100,324,302,17733,0,6350,24083,18948,97,0,22,119
1437,CHITTOOR,Karvetinagar,SURENDRANAGARAM,83,2,195,280,55,0,122,177,156,4818,0,8185,13003,9410,27,0,25,52
1438,CHITTOOR,Karvetinagar,T.K.M.PETA,143,28,32,203,121,17,9,147,150,9828,1781,875,12484,9685,47,13,5,65
1439,CHITTOOR,Kuppam,ADAVIBUDUGUR,252,23,412,687,159,5,219,383,409,9532,393,14865,24790,15112,35,3,61,99
1440,CHITTOOR,Kuppam,ANIMIGANIPALLE,178,0,323,501,44,0,68,112,107,88,0,136,224,214,0,0,0,0
1441,CHITTOOR,Kuppam,CHANDAM,90,0,233,323,42,0,70,112,105,3241,0,4420,7661,5160,20,0,23,43
1442,CHITTOOR,Kuppam,CHEELEPALLE,320,0,86,406,7,0,1,8,7,140,0,22,162,104,0,0,0,0
1443,CHITTOOR,Kuppam,CHEEMANAYANIPALLE,111,0,212,323,0,0,0,0,0,0,0,0,0,0,0,0,0,0
1444,CHITTOOR,Kuppam,CHEKKUNATHAM,79,28,467,574,51,5,140,196,202,4570,224,12600,17394,12201,28,0,76,104
1445,CHITTOOR,Kuppam,DALAVAIKOTHAPALLE,111,3,238,352,1,0,18,19,19,20,0,873,893,479,0,0,3,3
1446,CHITTOOR,Kuppam,DASEGOWNIYUR,128,8,423,559,14,0,72,86,81,443,0,4247,4690,3728,0,0,18,18
1447,CHITTOOR,Kuppam,GARIGACHINNEPALLE,70,0,203,273,25,0,28,53,53,1607,0,1462,3069,2255,5,0,3,8
1448,CHITTOOR,Kuppam,GONUGUR,58,0,115,173,16,0,22,38,38,274,0,467,741,623,0,0,0,0
1449,CHITTOOR,Kuppam,GUDLANAYANI PALLE,56,0,400,456,45,0,294,339,286,4468,0,29023,33491,20686,37,0,227,264
1450,CHITTOOR,Kuppam,JARUGU,20,11,337,368,15,1,158,174,146,1436,90,15721,17247,11038,11,0,128,139
1451,CHITTOOR,Kuppam,KAMATHAMUR,91,1,283,375,5,0,40,45,46,5,0,443,448,405,0,0,0,0
1452,CHITTOOR,Kuppam,KANGUNDI,553,73,1690,2316,274,17,559,850,847,21046,858,32547,54451,39541,118,3,116,237
1453,CHITTOOR,Kuppam,KOTALURU,17,3,950,970,6,1,476,483,483,503,95,35456,36054,23941,3,0,169,172
1454,CHITTOOR,Kuppam,KOTHAPALLE,10,4,448,462,2,0,174,176,180,180,0,16041,16221,12568,1,0,97,98
1455,CHITTOOR,Kuppam,KRISHNADASANAPALLE,77,17,496,590,38,3,89,130,139,2027,92,2706,4825,3355,6,0,3,9
1456,CHITTOOR,Kuppam,KUPPAM(MAJOR PTS),336,1,276,613,16,0,6,22,21,697,0,178,875,657,1,0,0,1
1457,CHITTOOR,Kuppam,MALLANURU,84,48,1824,1956,7,14,389,410,427,378,1229,35871,37478,25503,2,10,244,256
1458,CHITTOOR,Kuppam,MANKALADODDI,29,10,820,859,6,7,59,72,77,509,594,5405,6508,5022,2,4,39,45
1459,CHITTOOR,Kuppam,MITTAPALLE,91,8,715,814,13,0,251,264,248,279,0,15370,15649,10936,0,0,64,64
1460,CHITTOOR,Kuppam,NADIMUR,47,2,281,330,22,0,93,115,88,1368,0,8142,9510,6043,5,0,55,60
1461,CHITTOOR,Kuppam,NOOLAKUNTA,69,1,371,441,7,0,86,93,95,304,0,7417,7721,5870,1,0,39,40
1462,CHITTOOR,Kuppam,PAIPALYAM,25,1,744,770,9,0,380,389,320,925,0,41083,42008,28805,6,0,322,328
1463,CHITTOOR,Kuppam,PEDDA BANGARUNATHAM,26,0,460,486,9,0,135,144,132,670,0,9848,10518,7028,4,0,45,49
1464,CHITTOOR,Kuppam,SAMAGUTTAPALLE,170,21,625,816,84,0,167,251,241,5661,0,12572,18233,13792,27,0,78,105
1465,CHITTOOR,Kuppam,THAMBIGANI PALLE,27,0,215,242,1,0,0,1,2,8,0,0,8,8,0,0,0,0
1466,CHITTOOR,Kuppam,URLAOBANAPALLE,54,0,448,502,0,0,1,1,1,0,0,6,6,3,0,0,0,0
1467,CHITTOOR,Kuppam,VANAGUTTAPALLE,15,1,282,298,5,0,77,82,76,303,0,4813,5116,3916,1,0,18,19
1468,CHITTOOR,Kuppam,VASANADU,16,0,90,106,0,0,0,0,0,0,0,0,0,0,0,0,0,0
1469,CHITTOOR,Kuppam,VENDUGAMPALLE,2,1,206,209,0,0,1,1,1,0,0,116,116,58,0,0,1,1
1470,CHITTOOR,Kurabalakota,ANGALLU,193,22,732,947,6,0,115,121,119,105,0,5608,5713,3229,0,0,17,17
1471,CHITTOOR,Kurabalakota,KURABALAKOTA,327,20,1443,1790,41,4,250,295,253,1527,147,10750,12424,6581,3,0,32,35
1472,CHITTOOR,Kurabalakota,MATLIVARIPALLE,119,46,1012,1177,22,4,281,307,276,829,159,16133,17121,8486,3,0,65,68
1473,CHITTOOR,Kurabalakota,MUDIVEDU,183,24,902,1109,49,4,204,257,245,2798,298,11235,14331,7241,11,2,35,48
1474,CHITTOOR,Kurabalakota,PITCHALAVANDLAPALLE,142,22,603,767,47,0,146,193,169,3275,0,7097,10372,5663,17,0,28,45
1475,CHITTOOR,Kurabalakota,THETTU,230,24,781,1035,23,6,212,241,212,596,344,12307,13247,7449,0,1,58,59
1476,CHITTOOR,Madanapalle,ANKISETTIPALLE,45,12,36,93,1,0,0,1,1,20,0,0,20,6,0,0,0,0
1477,CHITTOOR,Madanapalle,BASINIKONDA,112,33,480,625,33,1,116,150,140,2595,20,8793,11408,9820,17,0,60,77
1478,CHITTOOR,Madanapalle,BOMMANACHERUVU,85,14,371,470,14,0,59,73,63,322,0,1988,2310,1216,1,0,3,4
1479,CHITTOOR,Madanapalle,CHEEKALABYLU,83,45,358,486,10,11,43,64,54,32,703,1309,2044,1206,0,2,5,7
1480,CHITTOOR,Madanapalle,CHINNATHIPPASAMUDRAM,153,74,906,1133,27,6,216,249,227,1141,99,9529,10769,6296,4,0,28,32
1481,CHITTOOR,Madanapalle,KOLLABYLU,120,8,332,460,72,2,144,218,153,5005,116,6547,11668,6263,29,0,21,50
1482,CHITTOOR,Madanapalle,KONDAMARRI PALLE,66,21,256,343,10,1,51,62,56,257,20,2614,2891,1901,0,0,12,12
1483,CHITTOOR,Madanapalle,KOTAVARIPALLE,57,169,244,470,27,30,45,102,94,2336,1652,2085,6073,3157,13,7,6,26
1484,CHITTOOR,Madanapalle,KOTHAPALLE,70,5,172,247,27,0,9,36,33,2261,0,129,2390,1508,16,0,0,16
1485,CHITTOOR,Madanapalle,KOTHAVARI PALLE,268,5,706,979,66,0,124,190,165,3150,0,4941,8091,5046,8,0,8,16
1486,CHITTOOR,Madanapalle,MALEPADU,111,40,365,516,32,5,35,72,60,1560,155,2132,3847,1683,7,0,12,19
1487,CHITTOOR,Madanapalle,PENCHUPADU,186,51,407,644,22,0,105,127,95,369,0,3604,3973,1895,0,0,6,6
1488,CHITTOOR,Madanapalle,PONNETIPALEM,64,6,248,318,28,1,77,106,88,2498,20,4299,6817,4746,16,0,17,33
1489,CHITTOOR,Madanapalle,POTHAPOLU,188,3,362,553,88,1,75,164,136,5069,5,2662,7736,4586,22,0,2,24
1490,CHITTOOR,Madanapalle,VALASEPALLE,154,2,318,474,1,0,25,26,23,20,0,2254,2274,1048,0,0,12,12
1491,CHITTOOR,Madanapalle,VEMPALLE,97,36,181,314,28,2,28,58,46,1274,132,908,2314,1166,2,0,1,3
1492,CHITTOOR,Mulakalacheruvu,BURAKAYALAKOTA,269,33,758,1060,97,5,192,294,264,6073,348,10928,17349,8951,22,1,37,60
1493,CHITTOOR,Mulakalacheruvu,COWDASAMUDRAM,144,107,623,874,13,20,75,108,116,588,808,3971,5367,2882,2,2,10,14
1494,CHITTOOR,Mulakalacheruvu,DEVALCHERUVU,197,22,1139,1358,43,0,207,250,227,1113,0,7133,8246,4164,0,0,11,11
1495,CHITTOOR,Mulakalacheruvu,GUDUPALLE,81,28,567,676,33,13,191,237,212,2271,368,12463,15102,7487,7,1,44,52
1496,CHITTOOR,Mulakalacheruvu,KADIRINATHUNIKOTA,129,5,317,451,45,1,102,148,127,2120,12,5450,7582,4122,8,0,14,22
1497,CHITTOOR,Mulakalacheruvu,KALAVAPALLE,63,2,646,711,12,0,103,115,107,575,0,5524,6099,3589,2,0,18,20
1498,CHITTOOR,Mulakalacheruvu,MADDINAMAYANIPALLE,179,6,1215,1400,59,1,325,385,334,2359,5,14650,17014,9053,4,0,26,30
1499,CHITTOOR,Mulakalacheruvu,MOLAKALACHERUVU,116,9,1051,1176,27,0,161,188,189,1221,0,12235,13456,9461,4,0,64,68
1500,CHITTOOR,Mulakalacheruvu,NAYANICHERUVUPALLE,135,36,236,407,42,14,43,99,89,1572,919,1508,3999,2454,4,4,4,12
1501,CHITTOOR,Mulakalacheruvu,PEDDAPALEM,202,3,443,648,44,0,136,180,168,1298,0,6602,7900,4228,4,0,19,23
1502,CHITTOOR,Mulakalacheruvu,SOMPALLE,345,58,1622,2025,57,25,566,648,514,3177,1575,33123,37875,17948,11,7,114,132
1503,CHITTOOR,Mulakalacheruvu,VEPURIKOTA,69,4,662,735,40,0,310,350,331,2025,0,18173,20198,11367,9,0,71,80
1504,CHITTOOR,Nagalapuram,ACHAMANAIDU KANDRIGA,44,6,50,100,30,4,25,59,57,1387,262,989,2638,2106,6,0,3,9
1505,CHITTOOR,Nagalapuram,BAITAKODIAMBEDU,215,57,156,428,95,0,42,137,151,3373,0,1741,5114,3898,4,0,1,5
1506,CHITTOOR,Nagalapuram,BEERAKUPPAM,328,50,75,453,217,9,42,268,324,13518,204,1990,15712,10406,50,0,4,54
1507,CHITTOOR,Nagalapuram,CHINNA PATTU,28,2,220,250,21,0,166,187,202,1215,0,4004,5219,3620,3,0,0,3
1508,CHITTOOR,Nagalapuram,KADIVEDU,113,31,188,332,93,16,141,250,264,9588,859,12339,22786,15082,71,0,80,151
1509,CHITTOOR,Nagalapuram,KALANJERI,107,20,98,225,32,13,2,47,42,203,369,40,612,416,0,0,0,0
1510,CHITTOOR,Nagalapuram,KARANI,0,26,182,208,0,0,82,82,88,0,0,1757,1757,1547,0,0,0,0
1511,CHITTOOR,Nagalapuram,KOTTA KADU,141,17,137,295,8,0,49,57,53,146,0,1102,1248,775,0,0,0,0
1512,CHITTOOR,Nagalapuram,KRISHNA PURAM,171,28,71,270,92,10,31,133,129,3617,351,939,4907,4158,1,0,0,1
1513,CHITTOOR,Nagalapuram,NAGALAPURAM,881,39,670,1590,142,10,280,432,451,3446,255,14574,18275,17406,1,0,24,25
1514,CHITTOOR,Nagalapuram,NANDANAM,97,4,206,307,19,0,82,101,102,476,0,2498,2974,2329,0,0,1,1
1515,CHITTOOR,Nagalapuram,RAJULA KANDRIGA,186,60,256,502,119,31,145,295,313,7011,2541,10913,20465,12769,20,13,40,73
1516,CHITTOOR,Nagalapuram,SADASIVA SANKARAPURAM,290,124,478,892,165,27,236,428,422,7839,437,7922,16198,9232,25,0,12,37
1517,CHITTOOR,Nagalapuram,SUBBANAIDU KANDRIGA,26,30,57,113,23,26,27,76,76,1453,1917,1286,4656,2962,6,8,3,17
1518,CHITTOOR,Nagalapuram,SURUTUPALLE,3,66,161,230,1,33,103,137,148,70,1778,5712,7560,6599,0,5,13,18
1519,CHITTOOR,Nagalapuram,TRIPURANATHAKAPURAMPALM,127,37,246,410,73,17,153,243,251,3385,1294,6234,10913,7018,6,8,16,30
1520,CHITTOOR,Nagalapuram,TRIPURANTHAKA PURAMKOTA,97,0,207,304,69,0,112,181,178,4516,0,7855,12371,9210,19,0,44,63
1521,CHITTOOR,Nagalapuram,VELLOR,216,2,77,295,165,2,52,219,229,7521,54,2751,10326,8114,8,0,1,9
1522,CHITTOOR,Nagalapuram,VEMBAKAM,218,0,252,470,155,0,180,335,326,5591,0,8353,13944,8049,6,0,13,19
1523,CHITTOOR,Nagari,ADAVIKOTHURU,68,1,299,368,43,0,121,164,165,2414,0,6236,8650,6682,2,0,14,16
1524,CHITTOOR,Nagari,BEERAKUPPAM,107,2,484,593,51,0,280,331,334,3613,0,17641,21254,16860,18,0,83,101
1525,CHITTOOR,Nagari,BUGGAAGRAHARAM@T.V.B.P,133,48,166,347,87,18,69,174,195,6394,711,3876,10981,9969,38,2,9,49
1526,CHITTOOR,Nagari,DAMARAPAKAM,117,25,187,329,51,11,142,204,221,1724,967,10065,12756,11085,2,6,38,46
1527,CHITTOOR,Nagari,GUNDRAJUKUPPAM,5,9,276,290,0,5,150,155,163,0,43,5506,5549,4315,0,0,15,15
1528,CHITTOOR,Nagari,GUNDRAJUKUPPAM H.W,347,0,0,347,142,0,0,142,140,9178,0,0,9178,8131,43,0,0,43
1529,CHITTOOR,Nagari,INAMBAKAM,57,18,70,145,40,14,49,103,118,4161,1050,3720,8931,6120,31,5,25,61
1530,CHITTOOR,Nagari,M.KOTHURU,29,1,304,334,21,0,135,156,142,1111,0,6241,7352,6272,1,0,10,11
1531,CHITTOOR,Nagari,MANAGADU,144,1,149,294,92,1,109,202,227,4103,102,7711,11916,10404,7,1,20,28
1532,CHITTOOR,Nagari,MELAPATTU,147,0,83,230,76,0,57,133,149,1626,0,3843,5469,4629,0,0,14,14
1533,CHITTOOR,Nagari,MITTAPALEM,24,0,309,333,15,0,111,126,119,786,0,3947,4733,3524,1,0,0,1
1534,CHITTOOR,Nagari,MUDIPALLE,197,60,275,532,118,13,133,264,257,6604,780,6953,14337,12153,11,0,7,18
1535,CHITTOOR,Nagari,NAMBAKAM,187,25,387,599,137,10,220,367,414,8861,336,9553,18750,14905,23,0,7,30
1536,CHITTOOR,Nagari,ORANTHANGALGOLLAKUPPAM,109,70,231,410,34,29,81,144,134,1064,1245,2544,4853,3339,1,5,2,8
1537,CHITTOOR,Nagari,THERANI,85,2,344,431,32,0,155,187,189,1873,0,8834,10707,9527,3,0,27,30
1538,CHITTOOR,Nagari,V.K.R.PURAM,71,54,410,535,29,21,144,194,166,2026,756,7600,10382,7951,12,0,16,28
1539,CHITTOOR,Nagari,V.N.R.PET,153,61,325,539,49,5,131,185,172,3826,241,10861,14928,10627,20,1,51,72
1540,CHITTOOR,Narayanavanam,ARANYAMKHANDRIGA,281,100,488,869,157,16,80,253,258,7671,594,4232,12497,9743,18,0,15,33
1541,CHITTOOR,Narayanavanam,BHEEMUNICHERUVU,366,2,1,369,165,1,0,166,168,8712,20,0,8732,5794,41,0,0,41
1542,CHITTOOR,Narayanavanam,BOPPARAJUPALEM,6,82,136,224,3,52,103,158,133,321,4669,9647,14637,9692,3,32,65,100
1543,CHITTOOR,Narayanavanam,BRAHMANATHANGAL,133,0,40,173,61,0,16,77,76,1854,0,666,2520,2152,0,0,0,0
1544,CHITTOOR,Narayanavanam,ERIKAMBATTU,270,8,193,471,98,0,62,160,159,5601,0,2921,8522,7029,23,0,8,31
1545,CHITTOOR,Narayanavanam,Kalyanapuram,87,1,131,219,6,0,6,12,11,227,0,512,739,736,0,0,3,3
1546,CHITTOOR,Narayanavanam,KASIMATTA,330,97,1,428,136,0,0,136,143,8190,0,0,8190,7127,28,0,0,28
1547,CHITTOOR,Narayanavanam,KEELAGARAM,180,1,191,372,124,0,1,125,134,6402,0,63,6465,5094,10,0,0,10
1548,CHITTOOR,Narayanavanam,KONDALA CHERUVU,1,0,418,419,1,0,163,164,149,110,0,9281,9391,7478,1,0,43,44
1549,CHITTOOR,Narayanavanam,NAINARUKHANDRIGA,219,4,106,329,113,0,22,135,124,2459,0,799,3258,2042,0,0,0,0
1550,CHITTOOR,Narayanavanam,NARAYANAVANAM,26,26,813,865,1,0,198,199,193,54,0,9946,10000,9466,0,0,7,7
1551,CHITTOOR,Narayanavanam,PALAMANGALAM NORTH,107,63,267,437,72,36,90,198,178,3829,1674,4517,10020,6612,9,2,3,14
1552,CHITTOOR,Narayanavanam,PALAMANGALAM SOUTH,277,30,193,500,97,11,38,146,130,4169,644,1289,6102,4180,7,3,0,10
1553,CHITTOOR,Narayanavanam,SAMUDAYAM,3,28,214,245,0,0,123,123,87,0,0,5256,5256,3797,0,0,11,11
1554,CHITTOOR,Narayanavanam,THIRUVATYAM,129,39,101,269,72,23,47,142,147,5014,2005,3933,10952,7952,23,13,20,56
1555,CHITTOOR,Narayanavanam,THUMBURU,52,46,283,381,3,22,108,133,126,95,1519,4572,6186,3622,0,5,7,12
1556,CHITTOOR,Narayanavanam,VENKATAKRISHNAPALEM,86,20,208,314,39,0,49,88,86,505,0,947,1452,1159,0,0,0,0
1557,CHITTOOR,Narayanavanam,VETHALATHADUKU,101,25,97,223,38,0,67,105,97,995,0,2760,3755,2842,1,0,2,3
1558,CHITTOOR,Nimmanapalle,AGRAHARAM,140,9,472,621,59,0,111,170,146,1467,0,3986,5453,3030,1,0,9,10
1559,CHITTOOR,Nimmanapalle,BANDLAPAI,81,0,286,367,14,0,32,46,37,301,0,1176,1477,765,0,0,4,4
1560,CHITTOOR,Nimmanapalle,KONDAIGAHGARI PALLE,181,7,463,651,58,0,82,140,106,2219,0,3309,5528,2978,2,0,4,6
1561,CHITTOOR,Nimmanapalle,MUSTOOR,77,10,703,790,5,0,206,211,165,122,0,10471,10593,4987,0,0,35,35
1562,CHITTOOR,Nimmanapalle,NIMANAPALLE,298,15,730,1043,33,0,115,148,119,936,0,5174,6110,3122,0,0,11,11
1563,CHITTOOR,Nimmanapalle,RACHAVETIVARI PALLE,246,16,610,872,77,0,60,137,125,3846,0,1895,5741,4008,11,0,3,14
1564,CHITTOOR,Nimmanapalle,REDDIVARIPALLE,236,30,738,1004,65,1,150,216,160,1972,89,7527,9588,5492,5,0,25,30
1565,CHITTOOR,Nimmanapalle,SAMAKOTAVARI PALLE,66,0,283,349,44,0,153,197,162,3418,0,11562,14980,6847,15,0,65,80
1566,CHITTOOR,Nimmanapalle,THAVALAM,108,23,470,601,54,8,152,214,159,3383,536,6194,10113,5067,15,0,7,22
1567,CHITTOOR,Nimmanapalle,VENGAMVARI PALLE,96,7,847,950,39,0,226,265,197,2837,0,14482,17319,7938,12,0,54,66
1568,CHITTOOR,Nindra,AGARAM,149,10,185,344,102,5,131,238,231,8178,265,10357,18800,13938,47,0,49,96
1569,CHITTOOR,Nindra,ARURU,99,79,135,313,70,16,89,175,178,3284,1241,7430,11955,8305,2,7,50,59
1570,CHITTOOR,Nindra,ATHURU,148,45,231,424,121,21,109,251,239,8964,1692,7280,17936,11529,38,8,31,77
1571,CHITTOOR,Nindra,CHAVARAMBAKAM,102,0,97,199,96,0,84,180,192,7868,0,8256,16124,11898,50,0,70,120
1572,CHITTOOR,Nindra,ELAKATUR,150,0,273,423,63,0,167,230,242,1239,0,8470,9709,7034,4,0,18,22
1573,CHITTOOR,Nindra,G.N. KANDRIGA,9,14,262,285,0,7,115,122,109,0,856,8796,9652,7543,0,7,65,72
1574,CHITTOOR,Nindra,I.R. KANDRIGA,16,1,110,127,10,1,86,97,86,817,78,8212,9107,5970,3,0,65,68
1575,CHITTOOR,Nindra,IRUGUVAI,289,41,160,490,188,12,63,263,264,11674,192,3020,14886,12956,34,0,8,42
1576,CHITTOOR,Nindra,KACHARAVEDU,61,3,89,153,46,1,72,119,112,4793,101,7346,12240,9799,42,1,69,112
1577,CHITTOOR,Nindra,KAIPAKAM,33,5,64,102,22,3,22,47,45,1174,44,671,1889,1354,0,0,0,0
1578,CHITTOOR,Nindra,KAVANURU,191,6,162,359,130,0,67,197,198,9566,0,3432,12998,10720,27,0,9,36
1579,CHITTOOR,Nindra,KEELAM BAKAM,2,14,17,33,0,5,6,11,10,0,48,111,159,102,0,0,0,0
1580,CHITTOOR,Nindra,KOPPEDU,239,45,127,411,122,23,91,236,229,7226,598,5663,13487,10997,41,0,14,55
1581,CHITTOOR,Nindra,KUNAMA RAJU PALEM,76,2,93,171,7,0,1,8,11,54,0,20,74,48,0,0,0,0
1582,CHITTOOR,Nindra,M.S.V.M. PURAM,9,20,119,148,8,15,93,116,105,803,1314,9393,11510,7595,7,9,70,86
1583,CHITTOOR,Nindra,MELAM BAKAM,18,55,72,145,11,33,25,69,70,662,2826,1474,4962,2859,3,17,3,23
1584,CHITTOOR,Nindra,NETTERI,38,32,122,192,30,23,84,137,139,2261,1572,6861,10694,6949,13,7,37,57
1585,CHITTOOR,Nindra,NINDRA,370,76,277,723,177,37,74,288,270,12217,1644,2088,15949,10587,59,4,1,64
1586,CHITTOOR,Nindra,PADIRI,118,1,167,286,98,1,117,216,243,4216,56,8994,13266,8491,10,0,39,49
1587,CHITTOOR,Nindra,SRI RAMA PURAM,139,72,120,331,75,12,46,133,130,3709,273,1988,5970,4550,13,0,2,15
1588,CHITTOOR,Nindra,URURU PETA,69,3,78,150,53,1,49,103,94,4344,17,3935,8296,5449,19,0,21,40
1589,CHITTOOR,Pakala,ACHMMAAGRAHARAM,57,2,139,198,15,0,33,48,42,1332,0,3888,5220,2791,8,0,29,37
1590,CHITTOOR,Pakala,ADENAPALLE,25,19,115,159,8,8,25,41,25,497,473,1328,2298,1011,1,3,5,9
1591,CHITTOOR,Pakala,CHENNUGARIPALLE,155,0,164,319,31,0,68,99,92,1542,0,5780,7322,4161,8,0,37,45
1592,CHITTOOR,Pakala,CHINNAGORPADU,100,0,210,310,17,0,57,74,35,1158,0,4192,5350,1163,5,0,21,26
1593,CHITTOOR,Pakala,DAMALCHERUVU,500,61,1061,1622,70,4,149,223,176,3431,66,9819,13316,5935,11,0,45,56
1594,CHITTOOR,Pakala,GADANKI,130,39,421,590,13,16,67,96,70,463,1125,3663,5251,2401,1,4,11,16
1595,CHITTOOR,Pakala,GANUGAPENTA,51,9,465,525,20,0,104,124,101,1737,0,9228,10965,6304,11,0,56,67
1596,CHITTOOR,Pakala,INAMATHIPALAGUTTAPALLE,81,16,161,258,38,7,50,95,58,1998,392,4541,6931,2721,11,1,32,44
1597,CHITTOOR,Pakala,IRRAMGARIPALLE,325,0,184,509,31,0,32,63,51,1695,0,2292,3987,2020,3,0,9,12
1598,CHITTOOR,Pakala,K.ODDEPALLE,109,26,302,437,26,7,75,108,68,1177,679,4836,6692,3114,3,4,20,27
1599,CHITTOOR,Pakala,KAVALIVARIPALLE,28,1,182,211,14,0,86,100,49,950,0,5465,6415,2193,1,0,22,23
1600,CHITTOOR,Pakala,MADDINAYANIPALLE,107,5,318,430,41,0,40,81,54,1728,0,2578,4306,1700,5,0,17,22
1601,CHITTOOR,Pakala,MOGARALA,195,48,614,857,58,3,162,223,175,2182,108,10251,12541,5819,1,0,42,43
1602,CHITTOOR,Pakala,NENDRAGUNTA,1,6,107,114,0,1,13,14,6,0,12,464,476,126,0,0,2,2
1603,CHITTOOR,Pakala,OBULUCHETTIVARIPALLE,46,0,151,197,13,0,10,23,14,160,0,609,769,292,0,0,3,3
1604,CHITTOOR,Pakala,PADIPATLABAYALU,47,1,317,365,5,0,65,70,42,151,0,3630,3781,1470,1,0,17,18
1605,CHITTOOR,Pakala,PAKALA,309,31,746,1086,1,1,35,37,25,16,84,1036,1136,398,0,0,0,0
1606,CHITTOOR,Pakala,PANTAPALLE,189,2,226,417,26,1,56,83,58,2306,71,4316,6693,3543,14,0,23,37
1607,CHITTOOR,Pakala,PEDDABYNAPALLE,10,5,104,119,5,0,53,58,36,442,0,4421,4863,1785,4,0,27,31
1608,CHITTOOR,Pakala,PEDDAGORPADU,56,2,131,189,22,1,38,61,54,1886,93,2113,4092,2662,10,0,7,17
1609,CHITTOOR,Pakala,PEDDARAMAPURAM,168,16,273,457,91,14,144,249,222,8396,1551,13441,23388,12095,62,12,87,161
1610,CHITTOOR,Pakala,PEPASANIPALLE,12,22,319,353,0,0,20,20,16,0,0,536,536,251,0,0,0,0
1611,CHITTOOR,Pakala,RAMANAIAHGARIPALLE,85,0,213,298,18,0,11,29,26,866,0,1027,1893,953,2,0,7,9
1612,CHITTOOR,Pakala,SAMIREDDIPALLE,117,5,314,436,43,0,30,73,50,4258,0,1919,6177,2796,35,0,11,46
1613,CHITTOOR,Pakala,SAMKAMPALLE,96,2,42,140,42,0,3,45,39,2311,0,96,2407,1573,8,0,0,8
1614,CHITTOOR,Pakala,THOTATHIMMATAHPALLE,16,7,177,200,4,6,62,72,60,128,524,3955,4607,2146,0,2,14,16
1615,CHITTOOR,Pakala,UPPARAPALLE,309,10,592,911,22,0,88,110,108,1320,0,5822,7142,3679,5,0,31,36
1616,CHITTOOR,Pakala,VALLIVEDU,114,36,216,366,16,4,18,38,30,136,192,1106,1434,737,0,0,6,6
1617,CHITTOOR,Palamaner,BAIPPAGARI PALLE,454,127,767,1348,70,9,42,121,98,3864,586,1751,6201,2930,15,4,9,28
1618,CHITTOOR,Palamaner,JAGAMARLA,3,105,73,181,0,1,6,7,2,0,15,348,363,48,0,0,0,0
1619,CHITTOOR,Palamaner,JARAVARIPALLE,215,87,453,755,30,10,94,134,107,1736,562,6664,8962,3859,9,4,42,55
1620,CHITTOOR,Palamaner,KARIDIMADUGU,153,57,393,603,54,16,58,128,118,3609,1023,3099,7731,3826,19,4,18,41
1621,CHITTOOR,Palamaner,KOLAMASANAPALLE,347,85,986,1418,71,4,72,147,109,3916,151,2421,6488,3215,9,0,8,17
1622,CHITTOOR,Palamaner,KURMOI,159,20,269,448,42,1,48,91,61,3799,48,2566,6413,2457,28,0,10,38
1623,CHITTOOR,Palamaner,MORAM,162,103,681,946,40,9,155,204,144,1419,625,8313,10357,4639,1,1,13,15
1624,CHITTOOR,Palamaner,PENGARA GUNTA,192,62,646,900,14,1,45,60,51,643,36,3266,3945,2467,3,0,14,17
1625,CHITTOOR,Palamaner,SAMUDRAPALLE,86,69,185,340,13,7,23,43,32,848,369,658,1875,1061,5,2,1,8
1626,CHITTOOR,Palamaner,T.VADDURU,34,15,259,308,0,0,0,0,0,0,0,0,0,0,0,0,0,0
1627,CHITTOOR,Palasamudram,AMUDALA,295,16,308,619,178,4,89,271,274,8952,113,3323,12388,8043,17,0,2,19
1628,CHITTOOR,Palasamudram,BALAKRISHNAPURAM,194,0,181,375,69,0,60,129,125,3461,0,2932,6393,3608,11,0,9,20
1629,CHITTOOR,Palasamudram,GANGAMAMBAPURAM,106,0,141,247,78,0,31,109,98,6070,0,577,6647,4877,49,0,2,51
1630,CHITTOOR,Palasamudram,KOYDANDARAMAPURAM,1,6,23,30,0,0,1,1,0,0,0,114,114,0,0,0,1,1
1631,CHITTOOR,Palasamudram,KRISHNAJAMMAPURAM,184,0,183,367,142,0,115,257,248,8226,0,6593,14819,10260,16,0,10,26
1632,CHITTOOR,Palasamudram,NARASIMHAPURAM,39,5,439,483,10,0,235,245,227,204,0,14601,14805,11932,1,0,34,35
1633,CHITTOOR,Palasamudram,PALASAMUDRAM,288,2,112,402,97,0,42,139,132,2521,0,1413,3934,2905,2,0,1,3
1634,CHITTOOR,Palasamudram,S.R.R.KHANDRIGA,84,19,56,159,55,9,13,77,77,3654,388,785,4827,3019,15,1,2,18
1635,CHITTOOR,Palasamudram,SIMHARAJUPURAM,74,0,155,229,57,0,63,120,117,4108,0,4623,8731,7638,1,0,18,19
1636,CHITTOOR,Palasamudram,SRIBOMMARAJAPURAM,157,16,160,333,95,1,27,123,112,3109,41,681,3831,2833,2,0,0,2
1637,CHITTOOR,Palasamudram,SRIKAVERIRAJUPURAM,161,6,319,486,67,0,6,73,64,3823,0,272,4095,2621,1,0,1,2
1638,CHITTOOR,Palasamudram,TIRUMALARAJUPURAM,139,5,90,234,14,0,2,16,17,368,0,72,440,322,0,0,0,0
1639,CHITTOOR,Palasamudram,VANADURGAPURAM,54,12,182,248,24,8,95,127,127,750,134,4554,5438,3602,1,0,15,16
1640,CHITTOOR,Palasamudram,VENGALARAJUKUPPAM,330,20,123,473,168,2,56,226,208,9013,23,3807,12843,9483,22,0,8,30
1641,CHITTOOR,Pedda Panjani,AMMARAJUPALLE,82,2,254,338,23,0,32,55,37,879,0,769,1648,789,4,0,0,4
1642,CHITTOOR,Pedda Panjani,APPINEPALLE,34,1,245,280,14,0,24,38,23,168,0,1025,1193,377,0,0,5,5
1643,CHITTOOR,Pedda Panjani,BATTAMDODDI,104,20,432,556,36,2,52,90,82,1674,216,2272,4162,2156,6,1,6,13
1644,CHITTOOR,Pedda Panjani,BOMMARAJUPALLE,59,0,218,277,22,0,36,58,52,1368,0,1595,2963,1457,7,0,1,8
1645,CHITTOOR,Pedda Panjani,CHALAMANGALAM,106,6,528,640,19,1,95,115,93,930,11,5323,6264,3428,4,0,21,25
1646,CHITTOOR,Pedda Panjani,CHAMANERU,79,2,143,224,20,0,24,44,41,734,0,1175,1909,1209,1,0,6,7
1647,CHITTOOR,Pedda Panjani,KARASANAPALLE,64,0,249,313,30,0,100,130,110,2228,0,6775,9003,5487,11,0,30,41
1648,CHITTOOR,Pedda Panjani,KOGILERU,47,12,470,529,14,0,99,113,107,867,0,5057,5924,2845,5,0,17,22
1649,CHITTOOR,Pedda Panjani,KOLATHUR,190,1,526,717,78,0,73,151,137,6113,0,3521,9634,4319,38,0,15,53
1650,CHITTOOR,Pedda Panjani,LINGAPURAM,5,0,235,240,2,0,100,102,96,88,0,6738,6826,3775,0,0,32,32
1651,CHITTOOR,Pedda Panjani,MAADANAPALLE,74,0,217,291,5,0,53,58,65,161,0,1476,1637,880,0,0,1,1
1652,CHITTOOR,Pedda Panjani,MUDARAMPALLE,26,0,134,160,12,0,18,30,16,887,0,1071,1958,455,5,0,3,8
1653,CHITTOOR,Pedda Panjani,MUTHUKUR,290,12,549,851,103,0,131,234,188,6051,0,7759,13810,6312,30,0,31,61
1654,CHITTOOR,Pedda Panjani,NAGIREDDIPALLE,142,23,354,519,48,0,29,77,64,1563,0,794,2357,1281,3,0,1,4
1655,CHITTOOR,Pedda Panjani,NIDIGUNTA,81,12,153,246,27,6,30,63,56,1175,655,2196,4026,2589,3,5,13,21
1656,CHITTOOR,Pedda Panjani,PEDDAKAPALLE,100,45,524,669,31,0,104,135,108,1484,0,6520,8004,3124,5,0,25,30
1657,CHITTOOR,Pedda Panjani,PEDDAPANJANI,92,0,468,560,37,0,64,101,91,1079,0,3143,4222,3056,1,0,6,7
1658,CHITTOOR,Pedda Panjani,PEDDARIKUNTA,23,0,296,319,6,0,150,156,152,518,0,12096,12614,6173,3,0,71,74
1659,CHITTOOR,Pedda Panjani,PEDDAVELAGATUR,87,11,395,493,34,1,68,103,80,2667,120,4205,6992,3697,14,1,18,33
1660,CHITTOOR,Pedda Panjani,RAJUPALLE,94,60,124,278,1,8,2,11,8,20,81,11,112,43,0,0,0,0
1661,CHITTOOR,Pedda Panjani,RAYALAPETA,299,7,728,1034,59,0,65,124,118,3078,0,4182,7260,3789,12,0,20,32
1662,CHITTOOR,Pedda Panjani,SANKARAYALAPETA,2,2,232,236,0,1,36,37,24,0,20,1697,1717,547,0,0,7,7
1663,CHITTOOR,Pedda Panjani,SIVADI,76,1,250,327,30,0,53,83,80,1620,0,2486,4106,2695,4,0,10,14
1664,CHITTOOR,Pedda Panjani,THURLAPALLE,50,0,237,287,38,0,68,106,73,2763,0,2900,5663,2167,13,0,8,21
1665,CHITTOOR,Pedda Panjani,VEERAPALLE,144,10,334,488,67,1,20,88,81,1896,60,516,2472,1360,2,0,1,3
1666,CHITTOOR,Peddamandyam,BANDAMEEDA PALLE,32,18,563,613,4,1,84,89,76,66,44,3686,3796,1968,0,0,14,14
1667,CHITTOOR,Peddamandyam,C.GOLLA PALLE,86,9,669,764,0,0,4,4,4,0,0,233,233,125,0,0,1,1
1668,CHITTOOR,Peddamandyam,DIGUVA PALLE,57,129,468,654,28,89,299,416,423,1848,7193,18536,27577,14829,4,42,73,119
1669,CHITTOOR,Peddamandyam,GURRAMVANDLA PALLE,16,83,389,488,0,4,96,100,96,0,54,3418,3472,1837,0,0,8,8
1670,CHITTOOR,Peddamandyam,KALICHERLA,73,13,388,474,34,2,180,216,212,1257,45,8542,9844,6455,2,0,20,22
1671,CHITTOOR,Peddamandyam,KOTAKADA PALLE,45,16,393,454,23,8,198,229,199,1306,558,13987,15851,8981,3,2,37,42
1672,CHITTOOR,Peddamandyam,MANDALAVANDLA palle,45,247,229,521,5,168,0,173,170,340,15847,0,16187,8588,1,111,0,112
1673,CHITTOOR,Peddamandyam,MUSALIKUNTA,45,353,473,871,20,152,197,369,331,1032,4639,7602,13273,7112,2,10,10,22
1674,CHITTOOR,Peddamandyam,NATHIOBANNAGARI PALLE,36,72,404,512,5,12,189,206,195,144,191,14107,14442,9515,0,0,69,69
1675,CHITTOOR,Peddamandyam,PAPEPALLE,62,4,844,910,10,0,234,244,213,147,0,8111,8258,5076,0,0,7,7
1676,CHITTOOR,Peddamandyam,PEDDAMANDYAM,100,23,642,765,71,3,343,417,400,1394,160,20272,21826,12494,0,1,34,35
1677,CHITTOOR,Peddamandyam,SIDDAVARAM,24,0,319,343,5,0,92,97,73,146,0,2507,2653,1283,0,0,5,5
1678,CHITTOOR,Peddamandyam,SIVAPURAM,26,3,307,336,10,2,127,139,104,371,47,4477,4895,2663,0,0,14,14
1679,CHITTOOR,Peddamandyam,VELIGALLU,85,26,580,691,11,9,193,213,180,755,293,8397,9445,4686,3,1,16,20
1680,CHITTOOR,Peddathippasamudram,ANKIREDDIPALLE,106,1,283,390,30,0,59,89,63,1664,0,2534,4198,2160,1,0,5,6
1681,CHITTOOR,Peddathippasamudram,BOORLAPALLE,429,0,596,1025,40,0,113,153,126,1129,0,7644,8773,4964,1,0,33,34
1682,CHITTOOR,Peddathippasamudram,BUCHIPALLE,134,16,261,411,11,4,32,47,27,477,110,1139,1726,569,1,0,0,1
1683,CHITTOOR,Peddathippasamudram,KANDUKURU,187,58,920,1165,74,0,91,165,130,3570,0,3546,7116,3929,11,0,6,17
1684,CHITTOOR,Peddathippasamudram,KATNAGALLU,151,4,495,650,37,0,144,181,154,855,0,7079,7934,4270,1,0,17,18
1685,CHITTOOR,Peddathippasamudram,MADDAIAHGARIPALLE,18,1,717,736,0,0,57,57,48,0,0,2774,2774,1466,0,0,11,11
1686,CHITTOOR,Peddathippasamudram,MADUMURU,77,21,758,856,11,4,220,235,195,791,325,14943,16059,8197,1,2,55,58
1687,CHITTOOR,Peddathippasamudram,MALLELA,186,18,740,944,30,9,240,279,174,1629,660,18166,20455,8797,3,2,87,92
1688,CHITTOOR,Peddathippasamudram,PATTEMVANDLAPALLE,380,113,768,1261,72,5,100,177,149,1636,58,4924,6618,3416,1,0,16,17
1689,CHITTOOR,Peddathippasamudram,PEDDATHIPPASAMUDRAM,311,0,853,1164,35,0,53,88,78,1192,0,1863,3055,1923,1,0,3,4
1690,CHITTOOR,Peddathippasamudram,PULIKALLU,118,6,551,675,26,3,116,145,125,663,142,5043,5848,3017,3,1,11,15
1691,CHITTOOR,Peddathippasamudram,RANGASAMUDRAM,161,8,876,1045,27,2,209,238,175,1062,125,12105,13292,6038,4,1,45,50
1692,CHITTOOR,Peddathippasamudram,RAPOORIVANDLAPALLE,170,72,847,1089,7,4,47,58,42,118,66,1111,1295,741,0,0,1,1
1693,CHITTOOR,Peddathippasamudram,SAMPATHIKOTA,36,4,418,458,0,1,50,51,41,0,27,2778,2805,1519,0,0,6,6
1694,CHITTOOR,Peddathippasamudram,T.SADUM,295,10,792,1097,77,0,190,267,200,4576,0,14722,19298,9844,18,0,70,88
1695,CHITTOOR,Peddathippasamudram,THUMMARAKUNTA,324,19,1043,1386,96,0,88,184,135,4966,0,2489,7455,3169,15,0,1,16
1696,CHITTOOR,Penumuru,C.R.KHANDRIGA,104,0,162,266,11,0,14,25,15,230,0,248,478,180,0,0,0,0
1697,CHITTOOR,Penumuru,CHARVAGANIPALLE,48,0,213,261,4,0,98,102,79,38,0,4435,4473,2223,0,0,6,6
1698,CHITTOOR,Penumuru,CHINNA KALIGIRI,3,0,146,149,0,0,18,18,10,0,0,946,946,367,0,0,3,3
1699,CHITTOOR,Penumuru,CHINTHAPENTA,163,16,183,362,41,2,45,88,72,2750,202,3351,6303,2681,11,1,14,26
1700,CHITTOOR,Penumuru,CHIPPARAPALLE,45,39,227,311,13,2,47,62,38,153,15,896,1064,370,0,0,0,0
1701,CHITTOOR,Penumuru,GANGUPALLE,122,0,192,314,5,0,36,41,39,124,0,1571,1695,733,0,0,3,3
1702,CHITTOOR,Penumuru,GUDYANAMPALLE,96,3,165,264,37,2,62,101,82,2084,90,4415,6589,3400,6,0,22,28
1703,CHITTOOR,Penumuru,GUNTIPALLE,126,7,381,514,15,0,76,91,79,392,0,2728,3120,1900,1,0,3,4
1704,CHITTOOR,Penumuru,GUTHAVANDLAVURU,60,0,245,305,8,0,94,102,86,117,0,3389,3506,1819,0,0,5,5
1705,CHITTOOR,Penumuru,K.C.PALLE,390,18,317,725,169,2,72,243,204,7584,24,2307,9915,5040,13,0,6,19
1706,CHITTOOR,Penumuru,KALIGIRI,63,0,288,351,13,0,80,93,66,240,0,3651,3891,1340,0,0,8,8
1707,CHITTOOR,Penumuru,KALVAGUNTA,123,23,324,470,10,0,8,18,10,364,0,560,924,344,0,0,3,3
1708,CHITTOOR,Penumuru,KATHIREDDIPALLE,49,1,259,309,25,0,57,82,70,1478,0,2379,3857,2225,4,0,5,9
1709,CHITTOOR,Penumuru,KAVURIVARIPALLE,72,1,194,267,15,0,119,134,134,1093,0,9505,10598,5536,6,0,42,48
1710,CHITTOOR,Penumuru,L.K.P.VURU,29,22,130,181,9,9,75,93,73,367,355,4120,4842,1998,1,0,5,6
1711,CHITTOOR,Penumuru,MOPIREDDIPALLE,21,0,119,140,11,0,74,85,78,978,0,6957,7935,4583,4,0,44,48
1712,CHITTOOR,Penumuru,NANJARAPALLE,54,0,87,141,2,0,29,31,24,110,0,2028,2138,706,0,0,6,6
1713,CHITTOOR,Penumuru,PENUMURU,157,12,247,416,31,1,42,74,77,1209,6,2709,3924,3134,1,0,8,9
1714,CHITTOOR,Penumuru,PULIKALLU,254,31,494,779,77,0,144,221,182,5734,0,6344,12078,5906,30,0,10,40
1715,CHITTOOR,Penumuru,RAMAKRISHNAPURAM,92,35,310,437,6,6,107,119,105,40,42,5664,5746,3782,0,0,13,13
1716,CHITTOOR,Penumuru,SAMIREDDIPALLE,242,37,351,630,98,20,90,208,151,4408,1119,4380,9907,4608,12,4,15,31
1717,CHITTOOR,Penumuru,SATHAMBAKAM,122,2,373,497,50,0,127,177,133,1484,0,4165,5649,2426,1,0,8,9
1718,CHITTOOR,Penumuru,THATIMAKULAPALLE,138,3,438,579,56,0,212,268,244,4246,0,9660,13906,8882,31,0,20,51
1719,CHITTOOR,Penumuru,THIRIVIREDDIPALLE,58,0,116,174,28,0,46,74,54,1743,0,3133,4876,2051,2,0,13,15
1720,CHITTOOR,Pichatur,ADIVIKODINVEDU,173,31,163,367,78,22,49,149,165,5741,1915,2358,10014,6933,31,13,5,49
1721,CHITTOOR,Pichatur,ADIVISANKARPURAM,43,0,30,73,28,0,15,43,34,2021,0,703,2724,1500,6,0,0,6
1722,CHITTOOR,Pichatur,APPALARAJU KONDRIGA,46,0,31,77,26,0,18,44,46,426,0,429,855,615,0,0,0,0
1723,CHITTOOR,Pichatur,APPAMBATTU,10,0,162,172,4,0,0,4,4,101,0,0,101,51,0,0,0,0
1724,CHITTOOR,Pichatur,BANGALA,116,18,191,325,48,0,86,134,127,2700,0,4178,6878,5496,2,0,10,12
1725,CHITTOOR,Pichatur,GOVERDHANAGI,130,40,151,321,68,16,4,88,89,2671,466,84,3221,2619,3,0,0,3
1726,CHITTOOR,Pichatur,HANUMANTHAPURAM,50,3,199,252,16,0,33,49,44,84,0,263,347,239,0,0,0,0
1727,CHITTOOR,Pichatur,KARURU,126,0,274,400,79,0,155,234,221,2660,0,5564,8224,5809,0,0,2,2
1728,CHITTOOR,Pichatur,KEELAPUDI,180,14,263,457,82,0,14,96,95,2753,0,192,2945,2686,1,0,0,1
1729,CHITTOOR,Pichatur,MUDIYURU,98,67,410,575,52,25,179,256,229,1793,887,4022,6702,3355,0,1,2,3
1730,CHITTOOR,Pichatur,NEERVOY,355,11,72,438,181,0,1,182,174,8162,0,51,8213,6825,10,0,0,10
1731,CHITTOOR,Pichatur,PICHATURU,119,38,265,422,39,0,29,68,62,2581,0,609,3190,2785,11,0,0,11
1732,CHITTOOR,Pichatur,PULIGUNDRAM,66,16,168,250,38,10,84,132,139,2578,158,2384,5120,3720,11,0,3,14
1733,CHITTOOR,Pichatur,RAJANAGARAM,53,10,102,165,2,0,1,3,3,15,0,5,20,15,0,0,0,0
1734,CHITTOOR,Pichatur,RAMAGIRI,120,17,301,438,44,1,77,122,112,801,59,2593,3453,2588,0,0,11,11
1735,CHITTOOR,Pichatur,RAMAPURAM,131,52,266,449,40,16,98,154,135,589,970,2868,4427,2836,0,5,7,12
1736,CHITTOOR,Pichatur,SIDDIRAJU KANDRIGA,84,39,97,220,47,25,32,104,100,2229,1219,1253,4701,2939,6,3,0,9
1737,CHITTOOR,Pichatur,SIVAGIRI,73,17,64,154,12,10,20,42,37,436,588,692,1716,957,0,3,0,3
1738,CHITTOOR,Pichatur,SSB PET,309,2,171,482,182,0,96,278,281,4590,0,2919,7509,5147,12,0,1,13
1739,CHITTOOR,Pichatur,VELUR,210,0,98,308,93,0,10,103,105,5646,0,40,5686,4313,29,0,0,29
1740,CHITTOOR,Pichatur,VENGALATHURU,362,34,256,652,154,10,93,257,225,7538,489,4289,12316,8497,8,1,10,19
1741,CHITTOOR,Pileru,AGRAHARAM,48,18,393,459,5,0,7,12,13,590,0,396,986,473,5,0,3,8
1742,CHITTOOR,Pileru,BALAMVARIPALLE,199,8,326,533,86,1,113,200,170,4149,6,4073,8228,4046,15,0,12,27
1743,CHITTOOR,Pileru,BODUMALLUVARIPALLE,97,3,463,563,12,0,0,12,10,396,0,0,396,194,1,0,0,1
1744,CHITTOOR,Pileru,DODDIPALLE,159,43,485,687,38,5,72,115,103,1005,309,4971,6285,2950,4,2,26,32
1745,CHITTOOR,Pileru,GUDAREVUPALLE,188,180,380,748,19,35,64,118,106,939,2894,5756,9589,4372,2,17,40,59
1746,CHITTOOR,Pileru,JANDLA,73,106,226,405,50,50,71,171,156,3970,4038,4129,12137,6170,25,25,25,75
1747,CHITTOOR,Pileru,KAKULARAMVARIPALLE,87,9,363,459,12,3,20,35,31,675,69,796,1540,811,2,0,2,4
1748,CHITTOOR,Pileru,KAVALIPALLE,27,8,359,394,13,1,133,147,144,405,56,9612,10073,5121,1,0,51,52
1749,CHITTOOR,Pileru,MELLACHERUVU,39,3,375,417,14,0,98,112,84,1051,0,7281,8332,3518,7,0,38,45
1750,CHITTOOR,Pileru,MUDUPULAVEMULA,74,13,499,586,15,2,180,197,203,686,192,11450,12328,6226,2,1,45,48
1751,CHITTOOR,Pileru,PILERU,42,10,1368,1420,1,1,3,5,5,132,106,319,557,330,1,1,2,4
1752,CHITTOOR,Pileru,REGALLU,106,20,552,678,19,6,110,135,120,1482,638,6009,8129,3890,6,4,22,32
1753,CHITTOOR,Pileru,TALUPULA,75,15,1254,1344,34,4,250,288,252,2732,153,21108,23993,10679,11,0,138,149
1754,CHITTOOR,Pileru,VEPULABYLU,107,9,665,781,8,3,46,57,50,314,59,3126,3499,1973,2,0,17,19
1755,CHITTOOR,Pileru,YERRAGUNTLAPALLE,44,59,554,657,5,1,67,73,72,342,48,5892,6282,3283,2,0,43,45
1756,CHITTOOR,Pulicherla,AYYAVANDLAPALLE,22,0,251,273,6,0,103,109,109,350,0,8421,8771,4816,2,0,54,56
1757,CHITTOOR,Pulicherla,BODIREDDI GARI PALLE,23,0,211,234,7,0,96,103,38,692,0,8461,9153,2293,6,0,62,68
1758,CHITTOOR,Pulicherla,CHALLA VARI PALLE,54,66,137,257,28,20,23,71,70,1872,1373,1659,4904,2832,9,7,8,24
1759,CHITTOOR,Pulicherla,DEVALAMPET,64,32,418,514,22,15,94,131,108,1390,823,5569,7782,3419,4,0,22,26
1760,CHITTOOR,Pulicherla,DIGUVA  POKALAVARIPALLE,39,1,187,227,25,0,92,117,110,2287,0,6724,9011,5100,16,0,28,44
1761,CHITTOOR,Pulicherla,E.RAMIREDDIGARIPALLE,18,20,190,228,3,6,100,109,88,323,521,9274,10118,4937,2,4,73,79
1762,CHITTOOR,Pulicherla,ERRAPAPIREDDI GARIPALLE,77,2,342,421,24,0,115,139,144,1519,0,9647,11166,6129,6,0,57,63
1763,CHITTOOR,Pulicherla,GADDAMVARIPALLE,51,50,411,512,5,6,73,84,67,454,317,5179,5950,3056,2,1,28,31
1764,CHITTOOR,Pulicherla,KALLURU,135,14,551,700,78,1,25,104,86,7210,60,2001,9271,5185,45,0,11,56
1765,CHITTOOR,Pulicherla,KAMMAPALLE,51,0,454,505,10,0,71,81,60,954,0,3380,4334,2381,6,0,2,8
1766,CHITTOOR,Pulicherla,KAVETIGARI PALLE,171,27,754,952,20,0,103,123,105,872,0,6761,7633,4309,2,0,32,34
1767,CHITTOOR,Pulicherla,MANGALAMPETA,8,1,431,440,0,0,26,26,5,0,0,1542,1542,243,0,0,3,3
1768,CHITTOOR,Pulicherla,MATHUKUVARI PALLE,35,0,243,278,12,0,89,101,80,319,0,4494,4813,2136,0,0,11,11
1769,CHITTOOR,Pulicherla,NANNUUORI VARI PALLE,98,1,297,396,27,0,78,105,86,906,0,3411,4317,1899,1,0,6,7
1770,CHITTOOR,Pulicherla,PALEM,57,19,228,304,33,5,69,107,98,2905,360,6346,9611,5909,20,3,47,70
1771,CHITTOOR,Pulicherla,PASAM VARI PALLE,128,19,221,368,68,0,67,135,124,2788,0,3079,5867,2983,4,0,11,15
1772,CHITTOOR,Pulicherla,PATHA PETA,8,8,148,164,3,2,102,107,80,209,126,9657,9992,4914,1,1,78,80
1773,CHITTOOR,Pulicherla,PULICHERLA,170,9,242,421,64,6,55,125,113,4402,337,2662,7401,4843,16,1,5,22
1774,CHITTOOR,Pulicherla,RAJULA PALLE,111,0,29,140,46,0,14,60,47,2993,0,1051,4044,1858,4,0,1,5
1775,CHITTOOR,Pulicherla,RAMIREDDIGARIPALLE,124,0,270,394,22,0,114,136,110,689,0,8154,8843,3842,1,0,44,45
1776,CHITTOOR,Pulicherla,RAYAVARI PALLE,263,21,362,646,75,8,95,178,143,5966,150,7636,13752,6170,32,0,49,81
1777,CHITTOOR,Pulicherla,REDDIVARI PALLE,12,8,274,294,8,0,167,175,143,818,0,14278,15096,6940,6,0,83,89
1778,CHITTOOR,Pulicherla,RENUMAKULA PALLE,89,0,150,239,33,0,45,78,53,1224,0,645,1869,840,0,0,0,0
1779,CHITTOOR,Pulicherla,VENKATADASARA PALLE,55,13,455,523,20,1,80,101,84,1258,24,5984,7266,3050,7,0,29,36
1780,CHITTOOR,Pulicherla,YELLANKIVARIPALLE,7,3,425,435,3,1,141,145,106,328,128,12186,12642,5453,2,1,70,73
1781,CHITTOOR,Punganur,ARADIGUNTA,72,32,508,612,32,21,178,231,181,1639,1220,11230,14089,9569,7,3,49,59
1782,CHITTOOR,Punganur,BANDLAPALLE,98,24,323,445,4,4,99,107,100,241,78,5610,5929,3876,0,0,23,23
1783,CHITTOOR,Punganur,BHEEMAGANIPALLE,72,7,700,779,19,0,88,107,97,512,0,4496,5008,3230,0,0,19,19
1784,CHITTOOR,Punganur,BODEVARIPALLE,138,16,487,641,67,2,154,223,206,3119,21,5280,8420,4027,12,0,8,20
1785,CHITTOOR,Punganur,CHADALLA,70,0,337,407,24,0,56,80,78,1168,0,2403,3571,2418,5,0,8,13
1786,CHITTOOR,Punganur,CHANDRAMAKULAPALLE,163,21,548,732,63,2,177,242,256,2385,114,7265,9764,5343,5,1,15,21
1787,CHITTOOR,Punganur,EATHURU,105,1,338,444,8,0,33,41,42,200,0,1893,2093,1081,0,0,9,9
1788,CHITTOOR,Punganur,ETAVAKILI,100,0,282,382,51,0,66,117,91,2856,0,2982,5838,3941,12,0,8,20
1789,CHITTOOR,Punganur,GUDISABANDA,182,3,312,497,15,0,3,18,17,486,0,82,568,268,2,0,0,2
1790,CHITTOOR,Punganur,KUMARANATHAM,126,2,296,424,12,0,7,19,18,146,0,116,262,130,0,0,0,0
1791,CHITTOOR,Punganur,MAGANDLAPALLE,90,0,355,445,47,0,83,130,108,2397,0,3877,6274,4189,9,0,9,18
1792,CHITTOOR,Punganur,MANGALAM,142,1,489,632,40,0,124,164,139,1385,0,6762,8147,5808,0,0,9,9
1793,CHITTOOR,Punganur,MELUMDODDI,44,0,224,268,25,0,74,99,92,1548,0,3693,5241,3681,8,0,17,25
1794,CHITTOOR,Punganur,MITTACHINTHAVARIPALLE,48,119,286,453,20,17,133,170,162,1077,252,7532,8861,6131,2,0,21,23
1795,CHITTOOR,Punganur,MOUDUGULAPALLE,68,30,301,399,20,10,97,127,123,1045,420,3877,5342,3141,1,2,6,9
1796,CHITTOOR,Punganur,NEKKONDI,158,5,418,581,45,1,111,157,142,3149,30,5388,8567,4815,18,0,21,39
1797,CHITTOOR,Punganur,NETHIGUTLAPALLE,98,47,380,525,18,1,50,69,65,506,12,1965,2483,1201,0,0,5,5
1798,CHITTOOR,Punganur,PALEMPALLE,49,81,375,505,1,10,85,96,95,47,484,4171,4702,3354,0,1,19,20
1799,CHITTOOR,Punganur,RAGANIPALLE,133,0,406,539,26,0,95,121,114,947,0,4063,5010,3227,2,0,5,7
1800,CHITTOOR,Punganur,SINGIRIKUNTA,155,37,204,396,53,0,77,130,128,2072,0,3321,5393,3612,5,0,8,13
1801,CHITTOOR,Punganur,SUGALIMITTA,3,328,50,381,1,100,34,135,92,105,5292,1001,6398,3210,1,16,1,18
1802,CHITTOOR,Punganur,VANAMALADINNE,309,51,522,882,64,4,77,145,127,3592,208,3579,7379,4098,20,0,12,32
1803,CHITTOOR,Puthalapattu,AKANAMBATTU,140,0,116,256,30,0,29,59,43,1230,0,1118,2348,895,6,0,2,8
1804,CHITTOOR,Puthalapattu,AYYAPPAGARIPALLE,103,48,323,474,42,20,130,192,133,2670,1539,8725,12934,4996,10,11,46,67
1805,CHITTOOR,Puthalapattu,BAITAPALLE,238,1,286,525,101,1,116,218,206,6291,72,7930,14293,7293,31,0,42,73
1806,CHITTOOR,Puthalapattu,CHITIPIRALLA,190,10,273,473,67,1,66,134,96,4075,54,4979,9108,3899,20,0,21,41
1807,CHITTOOR,Puthalapattu,ERRACHERUVUPALLE,108,32,87,227,49,0,43,92,94,3811,0,3084,6895,4796,14,0,13,27
1808,CHITTOOR,Puthalapattu,GANDLAPALLE,40,3,196,239,25,0,102,127,77,1174,0,7188,8362,3368,3,0,32,35
1809,CHITTOOR,Puthalapattu,GODUGUCHINTA,173,0,256,429,54,0,107,161,106,2266,0,6767,9033,3400,3,0,28,31
1810,CHITTOOR,Puthalapattu,KAMMAGUTTAPALLE,57,1,134,192,13,0,40,53,45,796,0,2826,3622,1721,6,0,14,20
1811,CHITTOOR,Puthalapattu,M.BANDAPALLE,5,0,556,561,2,0,83,85,69,90,0,6214,6304,4185,0,0,26,26
1812,CHITTOOR,Puthalapattu,MUTHIREVULA,99,1,249,349,22,0,13,35,33,796,0,1010,1806,1051,1,0,6,7
1813,CHITTOOR,Puthalapattu,ODDEPALLE,108,12,202,322,14,8,65,87,69,1131,224,4064,5419,2398,7,0,7,14
1814,CHITTOOR,Puthalapattu,P.KOTHAKOTA,297,13,925,1235,23,0,127,150,113,1135,0,8314,9449,4977,4,0,31,35
1815,CHITTOOR,Puthalapattu,PALAKURU,93,1,234,328,14,1,43,58,48,523,96,3506,4125,1632,1,0,20,21
1816,CHITTOOR,Puthalapattu,PANTAPALLE,82,1,325,408,26,0,38,64,39,406,0,2289,2695,1056,0,0,14,14
1817,CHITTOOR,Puthalapattu,PATURU,88,9,292,389,7,0,56,63,40,128,0,3752,3880,1380,0,0,17,17
1818,CHITTOOR,Puthalapattu,PETA AGRAHARAM,46,1,180,227,19,0,75,94,86,1532,0,9013,10545,5214,8,0,60,68
1819,CHITTOOR,Puthalapattu,POLAVARAM,24,69,209,302,4,7,10,21,13,161,519,270,950,426,0,3,0,3
1820,CHITTOOR,Puthalapattu,POTUKANUMA,155,0,256,411,60,0,97,157,145,3659,0,6980,10639,5226,15,0,36,51
1821,CHITTOOR,Puthalapattu,PUTHALAPATTU,464,38,711,1213,81,4,95,180,128,6489,351,6530,13370,5767,43,3,39,85
1822,CHITTOOR,Puthalapattu,THALUPULAPALLE,46,61,373,480,11,2,99,112,98,510,191,7129,7830,3567,1,1,34,36
1823,CHITTOOR,Puthalapattu,THENEPALLE,73,113,312,498,10,21,77,108,72,548,1206,6911,8665,2263,3,3,45,51
1824,CHITTOOR,Puthalapattu,THIMMIREDDIPALLE,77,0,94,171,44,0,46,90,81,3569,0,3981,7550,4148,17,0,25,42
1825,CHITTOOR,Puthalapattu,VAVILTHOTA,330,31,944,1305,97,9,138,244,200,8113,390,6491,14994,8030,47,1,26,74
1826,CHITTOOR,Puthalapattu,VENUTHANAPALLEE,181,3,221,405,57,0,26,83,59,3149,0,2081,5230,2398,6,0,13,19
1827,CHITTOOR,Puthalapattu,VEPANAPALLE,72,0,264,336,9,0,99,108,85,560,0,6395,6955,3356,3,0,36,39
1828,CHITTOOR,Puttur,GOPALAKRISHNA PURAM,63,222,1,286,40,90,0,130,113,1441,1810,0,3251,2163,5,3,0,8
1829,CHITTOOR,Puttur,K.BOMMARAJU PURAM,309,47,280,636,103,1,90,194,181,5738,28,5433,11199,10260,19,0,11,30
1830,CHITTOOR,Puttur,KANAKAM PALEM,22,0,56,78,0,0,0,0,0,0,0,0,0,0,0,0,0,0
1831,CHITTOOR,Puttur,KRISHNA SAMUDRAM,335,1,0,336,233,1,0,234,219,13251,21,0,13272,10376,49,0,0,49
1832,CHITTOOR,Puttur,NESANUR,26,42,403,471,0,4,33,37,31,0,12,910,922,600,0,0,3,3
1833,CHITTOOR,Puttur,PARAMESWARA MANGALAM,228,0,156,384,34,0,67,101,89,1249,0,2692,3941,2721,1,0,3,4
1834,CHITTOOR,Puttur,RAMAKRISHNA PURAM,72,67,157,296,1,0,0,1,1,48,0,0,48,24,0,0,0,0
1835,CHITTOOR,Puttur,RAMASAMUDRAM,130,29,118,277,12,8,40,60,51,364,348,728,1440,923,0,1,0,1
1836,CHITTOOR,Puttur,SIRUGURAJUPALEM,35,3,143,181,7,0,50,57,47,93,0,2158,2251,1359,0,0,2,2
1837,CHITTOOR,Puttur,TADUKU,396,128,305,829,80,0,17,97,88,3928,0,400,4328,3222,8,0,1,9
1838,CHITTOOR,Puttur,THORUR,79,0,173,252,0,0,22,22,18,0,0,517,517,266,0,0,0,0
1839,CHITTOOR,Puttur,TIRUMALAKUPPAM,222,53,151,426,45,10,48,103,95,744,653,2619,4016,2801,0,1,10,11
1840,CHITTOOR,Puttur,UTTARAPU KANDRIGA,218,0,77,295,101,0,21,122,101,4441,0,468,4909,3152,12,0,3,15
1841,CHITTOOR,Puttur,VEPAGUNTA,344,2,53,399,72,0,2,74,68,1625,0,12,1637,1445,1,0,0,1
1842,CHITTOOR,Rama Kuppam,BAIPPAREDLAPALLE,28,1,184,213,15,0,75,90,87,866,0,3782,4648,2473,3,0,16,19
1843,CHITTOOR,Rama Kuppam,BALLA,324,26,424,774,77,1,17,95,98,3480,126,846,4452,2448,9,1,5,15
1844,CHITTOOR,Rama Kuppam,BANDARLAPALLE,477,90,908,1475,167,24,285,476,467,8544,2027,16543,27114,13010,20,12,57,89
1845,CHITTOOR,Rama Kuppam,CHELDIGANIPALLE,42,4,137,183,0,0,17,17,24,0,0,446,446,245,0,0,0,0
1846,CHITTOOR,Rama Kuppam,GORIVIMAKULAPALLE,194,1,616,811,43,0,178,221,212,1692,0,5729,7421,4217,4,0,10,14
1847,CHITTOOR,Rama Kuppam,KENCHANABALLA,265,7,625,897,80,0,83,163,176,3187,0,2669,5856,3309,4,0,5,9
1848,CHITTOOR,Rama Kuppam,KONGANAPALLE,181,7,362,550,43,0,87,130,95,1140,0,4132,5272,2388,0,0,13,13
1849,CHITTOOR,Rama Kuppam,MANENDRAM,100,12,459,571,38,0,152,190,179,782,0,4852,5634,2941,0,0,3,3
1850,CHITTOOR,Rama Kuppam,MUDDANAPALLE,41,158,484,683,18,42,240,300,269,1212,1426,9549,12187,6018,4,0,9,13
1851,CHITTOOR,Rama Kuppam,PANDYALAMDUGU,118,279,448,845,64,139,204,407,382,5103,9457,13900,28460,14607,22,49,52,123
1852,CHITTOOR,Rama Kuppam,PEDDUR,177,180,556,913,65,62,157,284,277,2409,2790,6323,11522,6428,8,3,9,20
1853,CHITTOOR,Rama Kuppam,RAJUPETA,68,60,109,237,46,16,42,104,113,3575,704,2576,6855,3699,20,0,11,31
1854,CHITTOOR,Rama Kuppam,RAMAKUPPAM,399,34,1011,1444,152,11,377,540,487,11627,950,32427,45004,24574,62,7,197,266
1855,CHITTOOR,Rama Kuppam,SINGASAMUDRAM,326,2,226,554,94,0,65,159,143,2870,0,2420,5290,2730,0,0,6,6
1856,CHITTOOR,Rama Kuppam,UNISIGANIPALLE,78,11,647,736,19,1,194,214,165,1194,51,11585,12830,6820,5,0,39,44
1857,CHITTOOR,Rama Kuppam,VEERANAMALA,73,718,642,1433,13,198,140,351,366,320,5357,4297,9974,6423,0,1,2,3
1858,CHITTOOR,Rama Kuppam,VIJALAPURAM,61,4,618,683,4,0,106,110,85,102,0,3689,3791,1823,0,0,6,6
1859,CHITTOOR,Ramachandrapuram,ANUPALLE,69,42,893,1004,7,0,118,125,113,217,0,5155,5372,3050,0,0,6,6
1860,CHITTOOR,Ramachandrapuram,CHITATHUR KALE PALLE,121,4,435,560,72,1,264,337,295,4149,38,14305,18492,11537,12,0,25,37
1861,CHITTOOR,Ramachandrapuram,CHUTTAGUNTA RAMAPURAM,149,56,296,501,37,0,15,52,39,1517,0,300,1817,1166,5,0,0,5
1862,CHITTOOR,Ramachandrapuram,GANESWARA PURAM,140,36,154,330,37,0,39,76,63,925,0,2104,3029,1749,0,0,9,9
1863,CHITTOOR,Ramachandrapuram,GANGIREDDI PALLE,80,0,212,292,18,0,65,83,73,1058,0,4322,5380,3449,3,0,24,27
1864,CHITTOOR,Ramachandrapuram,K.K. VENKATA PURAM,42,2,130,174,10,0,40,50,40,640,0,2688,3328,2020,2,0,12,14
1865,CHITTOOR,Ramachandrapuram,KAMMAKANDRIGA,144,5,312,461,16,0,27,43,39,419,0,1727,2146,1802,0,0,9,9
1866,CHITTOOR,Ramachandrapuram,KAMMAPALLI,246,59,127,432,95,15,18,128,107,6532,1533,574,8639,5704,26,12,0,38
1867,CHITTOOR,Ramachandrapuram,KOTHAKANDRIGA,102,32,272,406,25,4,116,145,132,1856,66,9798,11720,7918,10,0,71,81
1868,CHITTOOR,Ramachandrapuram,KOTHAVEPA KUPPAM,43,16,286,345,30,11,176,217,221,3025,999,15075,19099,10016,21,6,88,115
1869,CHITTOOR,Ramachandrapuram,KUPPAMBADURU,123,23,258,404,64,10,104,178,163,3369,375,6915,10659,8159,10,1,32,43
1870,CHITTOOR,Ramachandrapuram,MITTA KANDRIGA,103,1,308,412,63,0,117,180,168,6284,0,8692,14976,9160,46,0,51,97
1871,CHITTOOR,Ramachandrapuram,N.R.KAMMAPALLE,156,4,263,423,110,0,141,251,246,9242,0,9340,18582,10963,47,0,29,76
1872,CHITTOOR,Ramachandrapuram,NADAVALURU,96,0,245,341,17,0,103,120,95,488,0,11617,12105,6710,0,0,87,87
1873,CHITTOOR,Ramachandrapuram,NENNURU,20,19,215,254,5,0,134,139,118,530,0,12308,12838,10060,4,0,83,87
1874,CHITTOOR,Ramachandrapuram,NETHA KUPPAM,203,26,293,522,94,6,151,251,236,6926,636,13702,21264,11498,43,5,97,145
1875,CHITTOOR,Ramachandrapuram,P.VENKATESWAR PURAM,28,35,381,444,12,1,162,175,152,980,45,10731,11756,7928,4,0,41,45
1876,CHITTOOR,Ramachandrapuram,PATHAKANDALAVARI PALLI,122,0,9,131,51,0,2,53,48,4095,0,40,4135,3659,23,0,0,23
1877,CHITTOOR,Ramachandrapuram,PULLAMANAIDU KANDRIGA,4,38,157,199,3,36,109,148,138,352,4561,11367,16280,7645,3,31,76,110
1878,CHITTOOR,Ramachandrapuram,RAVILLAVARI PALLI,96,0,29,125,12,0,4,16,13,351,0,74,425,309,0,0,0,0
1879,CHITTOOR,Ramachandrapuram,RAYAL CHERUVU,12,8,309,329,4,1,153,158,136,247,100,8620,8967,6833,1,1,36,38
1880,CHITTOOR,Ramachandrapuram,SORAKAYALA PALEM,33,1,176,210,10,0,16,26,21,221,0,300,521,333,0,0,0,0
1881,CHITTOOR,Ramachandrapuram,VENKATRAMA PURAM,51,0,97,148,0,0,34,34,32,0,0,2041,2041,1751,0,0,5,5
1882,CHITTOOR,Ramasamudram,ARIKALA,114,6,756,876,52,0,338,390,276,3066,0,15411,18477,8309,15,0,40,55
1883,CHITTOOR,Ramasamudram,CHEMBAKUR,232,7,489,728,94,0,43,137,64,7126,0,1745,8871,2652,39,0,4,43
1884,CHITTOOR,Ramasamudram,CHOKKANDLAPALLE,150,2,429,581,29,0,98,127,116,1346,0,3315,4661,2248,4,0,2,6
1885,CHITTOOR,Ramasamudram,ELAKAPALLE,81,0,152,233,33,0,36,69,41,2296,0,1938,4234,1231,15,0,6,21
1886,CHITTOOR,Ramasamudram,ELAVANELLORU,73,0,317,390,11,0,102,113,96,398,0,5263,5661,2136,2,0,15,17
1887,CHITTOOR,Ramasamudram,KAMMAVARIPALLE,3,1,248,252,0,0,30,30,27,0,0,864,864,435,0,0,1,1
1888,CHITTOOR,Ramasamudram,KAPPLLE,123,0,479,602,59,0,65,124,102,3164,0,1878,5042,2761,13,0,4,17
1889,CHITTOOR,Ramasamudram,KUDURUCHEEMANAPALLE,71,0,393,464,17,0,119,136,118,858,0,6305,7163,4727,1,0,15,16
1890,CHITTOOR,Ramasamudram,KURIJALA,83,2,234,319,39,0,104,143,112,2134,0,6692,8826,5219,11,0,29,40
1891,CHITTOOR,Ramasamudram,MALENTHAM,153,32,486,671,51,4,109,164,139,2103,222,4694,7019,4165,2,1,10,13
1892,CHITTOOR,Ramasamudram,MINIKI,119,0,138,257,55,0,46,101,81,2439,0,2118,4557,2541,6,0,5,11
1893,CHITTOOR,Ramasamudram,MOOGAVADI,151,18,521,690,25,0,73,98,80,736,0,3785,4521,2919,3,0,10,13
1894,CHITTOOR,Ramasamudram,NARIGANIPALLE,42,1,261,304,27,0,96,123,111,1407,0,3668,5075,2503,5,0,8,13
1895,CHITTOOR,Ramasamudram,PEDDAKURAPALLE,140,30,509,679,34,8,126,168,136,1805,603,7210,9618,5662,4,3,26,33
1896,CHITTOOR,Ramasamudram,R.NADIMPALLE,129,0,606,735,69,0,161,230,182,5720,0,12786,18506,9127,32,0,79,111
1897,CHITTOOR,Ramasamudram,RAGIMAKULAPALLE,71,1,237,309,12,0,77,89,85,492,0,4576,5068,3667,0,0,10,10
1898,CHITTOOR,Ramasamudram,RAMASUMUDRAM,342,5,574,921,52,0,61,113,96,3088,0,2977,6065,4234,8,0,7,15
1899,CHITTOOR,Ramasamudram,VOOLAPADU,87,0,471,558,4,0,99,103,101,139,0,4412,4551,1980,1,0,7,8
1900,CHITTOOR,Renigunta,ATHURU,165,13,274,452,66,3,140,209,181,5559,336,12832,18727,13893,26,3,78,107
1901,CHITTOOR,Renigunta,ELAMANDYAM,244,19,580,843,14,0,154,168,148,329,0,12783,13112,10049,2,0,66,68
1902,CHITTOOR,Renigunta,GAJULAMANDYAM,162,18,228,408,1,1,10,12,7,11,11,108,130,75,0,0,0,0
1903,CHITTOOR,Renigunta,GURAVARAJUPALLE,65,49,150,264,0,0,0,0,0,0,0,0,0,0,0,0,0,0
1904,CHITTOOR,Renigunta,GUTHIVARIPALLE,126,3,274,403,13,0,5,18,19,123,0,48,171,160,0,0,0,0
1905,CHITTOOR,Renigunta,JEEPALEM,133,4,328,465,34,0,169,203,181,2092,0,16759,18851,12694,7,0,118,125
1906,CHITTOOR,Renigunta,KARAKAMBADI,371,302,918,1591,39,0,15,54,54,1600,0,279,1879,1070,3,0,0,3
1907,CHITTOOR,Renigunta,KOTRMANGALAM,35,0,21,56,20,0,0,20,20,550,0,0,550,515,0,0,0,0
1908,CHITTOOR,Renigunta,KRISHNAPURAM,158,40,304,502,71,1,94,166,146,1906,18,5782,7706,5814,0,0,8,8
1909,CHITTOOR,Renigunta,MAMANDUR,28,43,199,270,0,0,0,0,0,0,0,0,0,0,0,0,0,0
1910,CHITTOOR,Renigunta,R.MALLAVARAM,112,47,338,497,27,5,129,161,135,2066,271,10998,13335,8580,8,1,43,52
1911,CHITTOOR,Renigunta,RENIGUNTA,838,41,1176,2055,67,1,44,112,96,4296,79,2889,7264,5453,14,0,3,17
1912,CHITTOOR,Renigunta,S.U.PURAM,105,30,58,193,10,17,15,42,40,115,581,330,1026,613,0,0,0,0
1913,CHITTOOR,Renigunta,SURAPPAKASAM,5,4,459,468,0,3,176,179,162,0,225,12980,13205,11167,0,1,54,55
1914,CHITTOOR,Renigunta,THANDLAMANAGALAM,138,4,153,295,82,0,57,139,125,6341,0,4276,10617,9474,32,0,20,52
1915,CHITTOOR,Renigunta,THUKIVAKAM,322,11,448,781,74,2,73,149,141,4338,561,6882,11781,9870,11,1,33,45
1916,CHITTOOR,Renigunta,VEDULLACHERUVU,101,88,67,256,14,0,24,38,34,177,0,2424,2601,1613,0,0,16,16
1917,CHITTOOR,Renigunta,VENKATAPURAM,241,109,443,793,0,0,0,0,0,0,0,0,0,0,0,0,0,0
1918,CHITTOOR,Renigunta,VIPPAMANI PATTEDA,45,16,181,242,20,2,116,138,106,1372,129,8700,10201,7747,5,1,46,52
1919,CHITTOOR,Rompicherla,BANDAKINDAPALLE,72,3,328,403,37,1,130,168,152,1792,48,7705,9545,4640,7,0,25,32
1920,CHITTOOR,Rompicherla,BODIPATIVARI PALLE,40,16,291,347,14,4,130,148,132,993,362,8481,9836,5098,6,2,37,45
1921,CHITTOOR,Rompicherla,BOMMAIAHGARI PALLE,237,9,717,963,84,2,129,215,172,5236,60,6537,11833,5349,20,0,17,37
1922,CHITTOOR,Rompicherla,CH.CH.REDDY GARI PALLE,56,0,426,482,24,0,229,253,225,1601,0,17529,19130,9201,7,0,96,103
1923,CHITTOOR,Rompicherla,CHICHILIVANI PALLE,127,12,607,746,54,7,226,287,238,3392,412,16558,20362,9653,11,0,75,86
1924,CHITTOOR,Rompicherla,GANUGACHINTHA,165,32,678,875,106,25,292,423,360,9081,2105,22638,33824,15313,60,15,110,185
1925,CHITTOOR,Rompicherla,MOTUMALLELA,127,23,831,981,42,5,367,414,353,2905,66,21985,24956,11227,15,0,104,119
1926,CHITTOOR,Rompicherla,PEDDAGOTTI GALLU,103,37,323,463,75,15,221,311,256,5464,1323,17335,24122,11564,29,7,96,132
1927,CHITTOOR,Rompicherla,PEDDAMALLELA,136,16,665,817,68,4,277,349,300,4767,92,15945,20804,9712,22,0,71,93
1928,CHITTOOR,Rompicherla,ROMPICHERLA,33,2,1199,1234,8,0,133,141,144,224,0,5919,6143,2984,0,0,20,20
1929,CHITTOOR,Santhi Puram,30 SONNEGANIPALLE,113,8,351,472,56,5,148,209,179,2998,349,9249,12596,6343,15,1,43,59
1930,CHITTOOR,Santhi Puram,64 PEDDURU,50,0,420,470,23,0,116,139,141,1151,0,8207,9358,7396,3,0,42,45
1931,CHITTOOR,Santhi Puram,ABAKALADODDI,200,1,415,616,104,0,212,316,345,7622,0,16076,23698,14723,37,0,92,129
1932,CHITTOOR,Santhi Puram,ANIKERA,101,3,236,340,15,1,65,81,69,831,94,3806,4731,3240,1,0,11,12
1933,CHITTOOR,Santhi Puram,C.BANDAPALLE,26,2,334,362,3,0,19,22,21,106,0,550,656,523,0,0,0,0
1934,CHITTOOR,Santhi Puram,CHENGUBALLA,67,5,470,542,17,1,148,166,152,487,118,7600,8205,4670,2,1,22,25
1935,CHITTOOR,Santhi Puram,CHINNARADODDI,56,2,351,409,33,1,177,211,213,2207,39,14321,16567,11216,13,0,71,84
1936,CHITTOOR,Santhi Puram,DANDIKUPPAM,160,13,375,548,27,1,34,62,53,1188,80,1910,3178,1449,4,0,9,13
1937,CHITTOOR,Santhi Puram,GUNJARLAPALLE,41,53,226,320,1,1,2,4,3,82,82,89,253,112,0,0,0,0
1938,CHITTOOR,Santhi Puram,KADAPALLE,14,3,652,669,9,0,286,295,262,822,0,27795,28617,18154,6,0,242,248
1939,CHITTOOR,Santhi Puram,KANAMAKULAPALLE,132,8,698,838,67,1,238,306,300,3664,27,13624,17315,12499,9,0,35,44
1940,CHITTOOR,Santhi Puram,KARLAGATTA,41,0,636,677,2,0,232,234,166,124,0,19957,20081,10554,1,0,126,127
1941,CHITTOOR,Santhi Puram,KOLAMADUGU,96,1,566,663,54,0,180,234,232,3507,0,12758,16265,10383,19,0,65,84
1942,CHITTOOR,Santhi Puram,KONERUKUPPAM,23,1,221,245,11,1,98,110,88,671,108,6609,7388,4592,3,1,34,38
1943,CHITTOOR,Santhi Puram,MATTAM,121,0,293,414,55,0,108,163,177,2969,0,5092,8061,4748,9,0,11,20
1944,CHITTOOR,Santhi Puram,MORASANIPALLE,34,2,312,348,18,1,201,220,188,1186,12,13978,15176,10604,5,0,70,75
1945,CHITTOOR,Santhi Puram,MULLURUKRISHNAPURAM,26,0,304,330,14,0,129,143,121,1080,0,9060,10140,7162,7,0,44,51
1946,CHITTOOR,Santhi Puram,NADIMPALLE,6,1,319,326,2,1,180,183,144,135,97,11220,11452,7974,0,0,25,25
1947,CHITTOOR,Santhi Puram,PEDDURU,26,0,177,203,19,0,76,95,77,1279,0,4906,6185,4055,5,0,17,22
1948,CHITTOOR,Santhi Puram,RALLABODUGURU,28,0,338,366,10,0,170,180,155,789,0,14034,14823,8886,0,0,71,71
1949,CHITTOOR,Santhi Puram,REGADADINNA PALLE,29,0,345,374,18,0,125,143,129,1210,0,7128,8338,5641,5,0,26,31
1950,CHITTOOR,Santhi Puram,SIVARAMAPURAM,115,43,595,753,33,13,142,188,147,1174,324,8048,9546,5147,2,0,24,26
1951,CHITTOOR,Santhi Puram,THUMMISI,6,0,201,207,0,0,72,72,66,0,0,5119,5119,3147,0,0,28,28
1952,CHITTOOR,Satyavedu,ALIVELUMANGAMMAPURAM,62,1,153,216,45,0,128,173,178,1501,0,5101,6602,4587,0,0,2,2
1953,CHITTOOR,Satyavedu,ALLAPPAGUNTA,12,2,172,186,2,1,139,142,134,160,6,9344,9510,6162,0,0,29,29
1954,CHITTOOR,Satyavedu,AMBAKAIN,150,18,178,346,76,7,87,170,160,3098,412,4344,7854,5854,2,2,12,16
1955,CHITTOOR,Satyavedu,AROOR,115,14,98,227,35,0,48,83,73,172,0,328,500,325,0,0,0,0
1956,CHITTOOR,Satyavedu,CHERIVI,147,38,223,408,115,26,137,278,276,5387,1297,6385,13069,7020,7,2,10,19
1957,CHITTOOR,Satyavedu,CHINNAEETIVAKAM,103,18,106,227,81,5,74,160,149,5722,380,4303,10405,6638,26,3,12,41
1958,CHITTOOR,Satyavedu,DASAKUPPAM,271,76,221,568,122,28,105,255,252,3475,1142,4303,8920,7149,2,1,1,4
1959,CHITTOOR,Satyavedu,IRUGULAM,246,24,166,436,185,0,89,274,275,8147,0,4766,12913,8736,10,0,6,16
1960,CHITTOOR,Satyavedu,JADERI,21,0,112,133,11,0,74,85,81,188,0,1950,2138,1721,0,0,0,0
1961,CHITTOOR,Satyavedu,KADIRVEDU,232,0,122,354,177,0,93,270,317,4856,0,2617,7473,4838,1,0,0,1
1962,CHITTOOR,Satyavedu,KALAMANAIDUPET,129,24,33,186,14,0,0,14,13,21,0,0,21,14,0,0,0,0
1963,CHITTOOR,Satyavedu,KHANNAVARAM,152,1,271,424,92,0,190,282,305,6211,0,11203,17414,13339,24,0,19,43
1964,CHITTOOR,Satyavedu,KOLLADAM,117,44,86,247,92,31,48,171,166,6467,922,2865,10254,6770,24,1,6,31
1965,CHITTOOR,Satyavedu,KOTHAMARIKUPPAM,62,53,198,313,33,16,132,181,202,1205,616,3905,5726,4240,0,4,2,6
1966,CHITTOOR,Satyavedu,MADAMAMBEDU,173,1,286,460,114,0,134,248,220,7141,0,6421,13562,10051,23,0,10,33
1967,CHITTOOR,Satyavedu,MADANANJERI,76,0,128,204,52,0,100,152,163,2484,0,7327,9811,7408,3,0,30,33
1968,CHITTOOR,Satyavedu,MALLAVARIPALEM (EAST),298,25,44,367,127,11,6,144,130,3353,104,62,3519,2215,1,0,0,1
1969,CHITTOOR,Satyavedu,MALLAVARIPALEM (WEST),0,18,73,91,0,0,37,37,31,0,0,319,319,257,0,0,0,0
1970,CHITTOOR,Satyavedu,NARASARAJU AGRAHARAM,1,20,116,137,0,0,58,58,54,0,0,766,766,495,0,0,0,0
1971,CHITTOOR,Satyavedu,P.V.PURAM,201,101,214,516,133,34,115,282,287,7230,1260,4418,12908,7946,9,2,2,13
1972,CHITTOOR,Satyavedu,PEDDAEETIVAKAM,242,40,214,496,173,22,144,339,347,4835,965,3526,9326,5806,0,1,1,2
1973,CHITTOOR,Satyavedu,PEDUKUPPAM,4,0,309,313,1,0,167,168,166,43,0,5875,5918,5240,0,0,8,8
1974,CHITTOOR,Satyavedu,RAJAGOPALAPURAM,123,41,171,335,55,25,110,190,189,2644,1580,2212,6436,4281,7,8,3,18
1975,CHITTOOR,Satyavedu,REPALLIWADA,108,16,139,263,58,7,87,152,157,1482,538,4185,6205,3727,0,2,11,13
1976,CHITTOOR,Satyavedu,SATYAVEEDU,650,40,263,953,233,10,68,311,305,7214,522,2942,10678,9164,5,0,7,12
1977,CHITTOOR,Satyavedu,SIRUNAMBUDURU,320,3,20,343,262,0,14,276,278,16390,0,824,17214,10460,28,0,2,30
1978,CHITTOOR,Satyavedu,VANELLURU,158,5,175,338,121,1,107,229,238,7695,32,4350,12077,8006,30,0,9,39
1979,CHITTOOR,Satyavedu,VENKATARAJULA KHANDRIGA,48,1,111,160,30,0,64,94,87,1641,0,2823,4464,3509,1,0,1,2
1980,CHITTOOR,Sodam,AMMAGARIPALLE,144,35,347,526,42,1,73,116,100,2472,6,4283,6761,3186,12,0,19,31
1981,CHITTOOR,Sodam,BOORAGAMANDA,58,71,942,1071,12,5,126,143,119,210,72,3959,4241,1931,0,0,8,8
1982,CHITTOOR,Sodam,CHERUKUVARIPALLE,74,18,409,501,38,2,173,213,191,1861,88,11784,13733,6820,5,0,44,49
1983,CHITTOOR,Sodam,CHINTAMAKULAPALLE,111,3,187,301,5,0,21,26,21,228,0,1270,1498,634,0,0,6,6
1984,CHITTOOR,Sodam,CHINTHALAVARIPALLE,80,9,315,404,17,0,52,69,60,270,0,1798,2068,923,0,0,2,2
1985,CHITTOOR,Sodam,GONGIVARIPALLE,74,1,322,397,40,0,158,198,181,2948,0,13830,16778,8121,19,0,86,105
1986,CHITTOOR,Sodam,JOGIVARIPALLE,107,9,406,522,63,1,142,206,210,3908,48,8005,11961,6354,14,0,31,45
1987,CHITTOOR,Sodam,KHAMBAMVARIPALLE,88,1,599,688,43,0,253,296,267,3262,0,18016,21278,10339,14,0,93,107
1988,CHITTOOR,Sodam,NADIGADDA,87,5,342,434,43,2,190,235,230,3045,30,14423,17498,9182,10,0,80,90
1989,CHITTOOR,Sodam,PALAMANDA,144,20,287,451,53,8,43,104,96,3275,326,2405,6006,3003,14,2,6,22
1990,CHITTOOR,Sodam,REDDIVARIPALLE,48,2,251,301,20,1,103,124,120,1543,11,6448,8002,4197,4,0,31,35
1991,CHITTOOR,Sodam,SODAM,164,41,830,1035,16,1,49,66,47,376,60,1666,2102,1037,0,0,5,5
1992,CHITTOOR,Sodam,THATIGUNTAPALEM,90,1,330,421,37,0,96,133,133,2198,0,5998,8196,4047,5,0,24,29
1993,CHITTOOR,Sodam,THIMMANAYANAPALLE,53,2,528,583,16,0,106,122,91,528,0,4600,5128,2434,1,0,11,12
1994,CHITTOOR,Sodam,VOOTUPALLE,47,0,359,406,13,0,54,67,52,505,0,2870,3375,1526,2,0,10,12
1995,CHITTOOR,Sodam,YARRATHIVARIPALLE,75,12,444,531,34,0,107,141,130,2137,0,7391,9528,4805,11,0,37,48
1996,CHITTOOR,Somala,ANNEMMAGARI PALLE,106,79,567,752,13,4,137,154,127,563,128,4975,5666,2218,0,0,3,3
1997,CHITTOOR,Somala,AVULAPALLE,92,40,751,883,9,0,141,150,134,841,0,10584,11425,4775,3,0,50,53
1998,CHITTOOR,Somala,IRIKIPENTA,124,19,429,572,14,0,89,103,81,665,0,3417,4082,1695,0,0,9,9
1999,CHITTOOR,Somala,KAMIREDDIVARIPALLE,80,0,166,246,42,0,45,87,73,2588,0,3814,6402,2975,7,0,15,22
2000,CHITTOOR,Somala,KANDURU,167,2,365,534,7,0,4,11,10,372,0,258,630,354,1,0,2,3
2001,CHITTOOR,Somala,NANJAMPETA,28,50,542,620,12,19,184,215,180,937,1307,13232,15476,6944,6,5,65,76
2002,CHITTOOR,Somala,NELLIMANDA,130,13,596,739,39,0,146,185,163,1386,0,7758,9144,4083,1,0,18,19
2003,CHITTOOR,Somala,PEDDAUPPARA PALLE,105,16,756,877,34,2,175,211,164,1772,171,9476,11419,4419,5,1,21,27
2004,CHITTOOR,Somala,PODALAKUNTLA PALLE,15,6,465,486,5,3,181,189,157,94,90,9211,9395,4264,0,0,38,38
2005,CHITTOOR,Somala,S.NADIMPALLE,98,29,275,402,44,17,105,166,139,3227,950,7022,11199,5414,12,1,31,44
2006,CHITTOOR,Somala,SOMALA,150,5,739,894,41,0,114,155,162,2885,0,7463,10348,5330,16,0,31,47
2007,CHITTOOR,Somala,THAMMINAYANIPALLE,65,4,275,344,10,0,13,23,18,307,0,813,1120,539,1,0,5,6
2008,CHITTOOR,Somala,UPPARAPALLE,97,126,548,771,20,23,97,140,116,353,757,6062,7172,3262,1,2,28,31
2009,CHITTOOR,Somala,VALLIGATLA,114,4,480,598,38,1,50,89,66,2542,120,3303,5965,2449,8,1,14,23
2010,CHITTOOR,Srikalahasti,AKKURTHY,163,43,247,453,114,30,171,315,264,2411,1118,5320,8849,5091,1,0,0,1
2011,CHITTOOR,Srikalahasti,AMMAPLEM,140,7,69,216,86,0,30,116,104,1609,0,337,1946,1263,0,0,0,0
2012,CHITTOOR,Srikalahasti,ARAVAKOTHURU,24,0,206,230,0,0,1,1,1,0,0,8,8,2,0,0,0,0
2013,CHITTOOR,Srikalahasti,B.V.PURAM,96,77,244,417,48,3,153,204,173,589,120,2987,3696,2101,0,0,1,1
2014,CHITTOOR,Srikalahasti,BOKKASAM PALEM,0,10,131,141,0,2,82,84,61,0,17,933,950,529,0,0,0,0
2015,CHITTOOR,Srikalahasti,BRAHMANAPALLE,31,5,223,259,13,0,124,137,118,1149,0,2788,3937,1770,8,0,7,15
2016,CHITTOOR,Srikalahasti,CHELLAPALEM,97,5,185,287,25,2,76,103,81,574,18,645,1237,653,0,0,0,0
2017,CHITTOOR,Srikalahasti,CHERLOPALLE,114,0,32,146,51,0,0,51,41,1649,0,0,1649,1154,1,0,0,1
2018,CHITTOOR,Srikalahasti,CHUKKALANIDIGALLU,116,47,20,183,70,0,0,70,53,1093,0,0,1093,537,0,0,0,0
2019,CHITTOOR,Srikalahasti,EGUVAEEDHI,164,23,278,465,68,8,138,214,196,602,48,1376,2026,1468,0,0,0,0
2020,CHITTOOR,Srikalahasti,EMPEDU,91,69,123,283,57,9,76,142,138,3318,84,1654,5056,2668,16,0,1,17
2021,CHITTOOR,Srikalahasti,ERRAGUDIPADU,92,0,38,130,73,0,15,88,83,786,0,136,922,612,0,0,0,0
2022,CHITTOOR,Srikalahasti,GANGALAPUDI,60,2,150,212,32,0,88,120,118,766,0,2220,2986,1907,0,0,0,0
2023,CHITTOOR,Srikalahasti,GOVINARAOPALLE,191,0,101,292,112,0,76,188,172,5736,0,4656,10392,5305,10,0,10,20
2024,CHITTOOR,Srikalahasti,GUNTAKINDAPALLE,82,1,89,172,61,0,52,113,103,2543,0,1807,4350,2585,2,0,0,2
2025,CHITTOOR,Srikalahasti,INAGALURU,22,25,150,197,18,6,121,145,136,1117,66,7320,8503,5559,5,0,22,27
2026,CHITTOOR,Srikalahasti,JAGGARAJUPALLE,220,0,4,224,151,0,1,152,142,6683,0,6,6689,5087,2,0,0,2
2027,CHITTOOR,Srikalahasti,KALAVAGUNTA,53,71,180,304,4,32,4,40,49,232,2590,23,2845,1418,0,10,0,10
2028,CHITTOOR,Srikalahasti,KAMMAKOTHUR,145,2,161,308,47,0,38,85,67,899,0,892,1791,828,0,0,0,0
2029,CHITTOOR,Srikalahasti,KAPUGUNNERI,84,8,117,209,3,0,55,58,32,45,0,1036,1081,339,0,0,0,0
2030,CHITTOOR,Srikalahasti,KODANDARAMAPURAM,2,0,157,159,0,0,70,70,47,0,0,1188,1188,661,0,0,0,0
2031,CHITTOOR,Srikalahasti,KUNTIPUDI,42,53,191,286,24,26,128,178,146,560,590,3684,4834,2471,0,0,1,1
2032,CHITTOOR,Srikalahasti,MADDILEDU,32,2,88,122,23,0,36,59,65,609,0,651,1260,845,0,0,0,0
2033,CHITTOOR,Srikalahasti,MANGALAPURI,168,29,141,338,107,0,82,189,177,3713,0,1225,4938,4071,1,0,0,1
2034,CHITTOOR,Srikalahasti,MANNAVARAM,95,18,180,293,70,10,93,173,155,4393,208,1558,6159,3042,22,0,2,24
2035,CHITTOOR,Srikalahasti,MELACHUR,3,156,3,162,0,27,0,27,16,0,479,0,479,184,0,0,0,0
2036,CHITTOOR,Srikalahasti,MUCHIVOLU,154,11,318,483,122,5,239,366,341,7190,117,8413,15720,8907,16,0,9,25
2037,CHITTOOR,Srikalahasti,NARAYANAPURAM,87,21,358,466,36,0,130,166,138,2160,0,5296,7456,5987,9,0,20,29
2038,CHITTOOR,Srikalahasti,OBULAYYAPALLE,129,98,275,502,71,24,72,167,153,1942,504,1673,4119,2117,1,1,1,3
2039,CHITTOOR,Srikalahasti,PATHAGUNTA,85,21,124,230,56,0,29,85,86,2739,0,1177,3916,2124,1,0,1,2
2040,CHITTOOR,Srikalahasti,POLI,203,65,274,542,79,11,161,251,202,1577,246,2908,4731,2243,6,0,4,10
2041,CHITTOOR,Srikalahasti,PULLAREDI KHANDRIGA,124,26,38,188,52,0,0,52,44,574,0,0,574,383,0,0,0,0
2042,CHITTOOR,Srikalahasti,RACHAGUNNERI,49,12,53,114,0,0,0,0,0,0,0,0,0,0,0,0,0,0
2043,CHITTOOR,Srikalahasti,RAMALINGA PURAM,71,3,88,162,44,1,49,94,67,3334,108,2243,5685,3214,17,1,4,22
2044,CHITTOOR,Srikalahasti,RAMAPURAM,150,115,65,330,51,27,39,117,102,2205,842,1309,4356,2245,0,0,0,0
2045,CHITTOOR,Srikalahasti,SUBBANAIDU KHANDRIGA,108,8,99,215,0,0,0,0,0,0,0,0,0,0,0,0,0,0
2046,CHITTOOR,Srikalahasti,SURUVARIPALLE,23,8,77,108,16,6,41,63,58,822,275,1059,2156,1159,1,0,1,2
2047,CHITTOOR,Srikalahasti,T.M.V.KANDRIGA,49,38,164,251,0,0,0,0,0,0,0,0,0,0,0,0,0,0
2048,CHITTOOR,Srikalahasti,THONDAMANDU,109,0,109,218,53,0,52,105,97,1222,0,684,1906,1338,0,0,0,0
2049,CHITTOOR,Srikalahasti,UDAMALAPADU,263,3,134,400,152,1,68,221,195,6381,102,4867,11350,6497,14,1,15,30
2050,CHITTOOR,Srikalahasti,URANDURU,139,59,213,411,80,0,82,162,155,2415,0,2136,4551,2860,1,0,1,2
2051,CHITTOOR,Srikalahasti,VAGAVEDU,133,97,306,536,64,0,206,270,255,1150,0,6397,7547,4766,0,0,4,4
2052,CHITTOOR,Srikalahasti,VEDAM,94,54,471,619,38,27,279,344,317,1057,718,7329,9104,5845,2,0,3,5
2053,CHITTOOR,Srikalahasti,VELAMPADU,101,16,91,208,92,12,75,179,150,5985,690,5730,12405,6287,20,3,26,49
2054,CHITTOOR,Srikalahasti,VELAVEDU,147,25,299,471,52,2,139,193,179,2275,47,3513,5835,3015,3,0,4,7
2055,CHITTOOR,Srikalahasti,YARLAPUDI,124,24,161,309,96,15,120,231,203,2542,730,2437,5709,2966,2,4,2,8
2056,CHITTOOR,Srirangarajapuram,AMBARAMAHARAJAPURAM,249,5,185,439,56,0,22,78,61,1197,0,1574,2771,1276,1,0,5,6
2057,CHITTOOR,Srirangarajapuram,CHILLAMAKULAPALLE,7,0,135,142,0,0,55,55,54,0,0,6505,6505,3097,0,0,39,39
2058,CHITTOOR,Srirangarajapuram,EGUVA KAMMAKANDRIGA,101,20,174,295,59,7,83,149,123,3407,186,6086,9679,3865,14,0,31,45
2059,CHITTOOR,Srirangarajapuram,GIDDAMAKARAJAPURAM,4,62,259,325,0,31,77,108,93,0,495,2647,3142,1727,0,0,2,2
2060,CHITTOOR,Srirangarajapuram,KATIKAPALLE,299,34,279,612,150,22,52,224,201,11774,1448,3933,17155,9362,71,6,17,94
2061,CHITTOOR,Srirangarajapuram,KOTHAPALLE,301,9,386,696,87,3,75,165,152,8128,299,5451,13878,7273,52,2,32,86
2062,CHITTOOR,Srirangarajapuram,KSHEERASAMUDRAM,126,0,84,210,4,0,37,41,33,114,0,2718,2832,1431,0,0,9,9
2063,CHITTOOR,Srirangarajapuram,MANGUNTA,133,3,236,372,31,0,84,115,102,1812,0,6222,8034,3778,11,0,33,44
2064,CHITTOOR,Srirangarajapuram,MARRIPALLE DK,143,0,27,170,77,0,10,87,104,5254,0,452,5706,3313,28,0,1,29
2065,CHITTOOR,Srirangarajapuram,MEDAWADA,142,30,106,278,95,22,41,158,128,7124,2105,2893,12122,5958,34,14,16,64
2066,CHITTOOR,Srirangarajapuram,MUDDIKUPPAM,312,10,265,587,0,1,10,11,7,0,66,534,600,198,0,0,2,2
2067,CHITTOOR,Srirangarajapuram,N.R.PURAM,107,3,162,272,50,3,69,122,126,4977,155,5194,10326,6576,26,0,22,48
2068,CHITTOOR,Srirangarajapuram,NELAVOY,65,3,207,275,2,0,21,23,20,75,0,590,665,360,0,0,0,0
2069,CHITTOOR,Srirangarajapuram,PADMAPURAM,95,10,186,291,42,3,86,131,123,1258,124,5121,6503,3299,3,0,26,29
2070,CHITTOOR,Srirangarajapuram,PILLARIKUPPAM,184,43,257,484,28,0,12,40,29,2378,0,836,3214,1499,8,0,4,12
2071,CHITTOOR,Srirangarajapuram,PULLUR,82,40,306,428,19,0,92,111,85,615,0,1882,2497,1014,1,0,1,2
2072,CHITTOOR,Srirangarajapuram,S.R.PURAM,470,19,302,791,107,1,124,232,207,4276,96,4863,9235,6232,14,0,9,23
2073,CHITTOOR,Srirangarajapuram,SETTIVANATHAM,23,10,187,220,9,4,69,82,72,883,443,4554,5880,3476,6,2,23,31
2074,CHITTOOR,Srirangarajapuram,THAYYURU,273,3,141,417,120,0,15,135,126,6273,0,786,7059,3623,22,0,2,24
2075,CHITTOOR,Srirangarajapuram,UDAMALAKURTHI,179,0,106,285,0,0,0,0,0,0,0,0,0,0,0,0,0,0
2076,CHITTOOR,Srirangarajapuram,VENKATAPURAM,308,0,56,364,61,0,2,63,64,2969,0,110,3079,1460,7,0,1,8
2077,CHITTOOR,Srirangarajapuram,VENUGOPALAPURAM,72,7,402,481,21,1,132,154,130,581,132,10116,10829,6020,0,1,47,48
2078,CHITTOOR,Srirangarajapuram,VILASAVARAHAPURAM,167,0,306,473,51,0,94,145,111,4196,0,7022,11218,5362,27,0,42,69
2079,CHITTOOR,Thamballapalle,BALREDDIGARIPALLE,52,4,443,499,13,1,123,137,131,740,78,8171,8989,5052,2,0,39,41
2080,CHITTOOR,Thamballapalle,DIGUVAPALEM,19,7,161,187,1,0,21,22,21,5,0,590,595,297,0,0,0,0
2081,CHITTOOR,Thamballapalle,EDDULUVARIPALLE,44,1,269,314,10,0,34,44,28,305,0,1001,1306,589,0,0,1,1
2082,CHITTOOR,Thamballapalle,ERRASANIPALLE,4,11,228,243,3,5,112,120,113,189,363,7455,8007,5245,0,2,22,24
2083,CHITTOOR,Thamballapalle,GANGIREDDIPALLE,12,123,227,362,5,61,89,155,138,171,3179,4294,7644,3789,0,6,13,19
2084,CHITTOOR,Thamballapalle,GOPIDINNE,155,187,681,1023,48,36,256,340,267,1712,1072,13629,16413,8596,4,0,36,40
2085,CHITTOOR,Thamballapalle,GUNDLAPALLE,53,33,554,640,26,12,312,350,356,1283,607,17825,19715,10718,2,2,44,48
2086,CHITTOOR,Thamballapalle,KANNEMADUGU,46,2,380,428,18,1,75,94,78,538,16,3437,3991,2616,0,0,8,8
2087,CHITTOOR,Thamballapalle,KOSUVARIPALLE,74,27,802,903,4,6,186,196,158,34,346,7213,7593,3580,0,0,13,13
2088,CHITTOOR,Thamballapalle,KOTAKONDA,26,131,559,716,0,34,107,141,117,0,1872,5895,7767,3987,0,7,22,29
2089,CHITTOOR,Thamballapalle,KOTALA,50,57,495,602,5,10,202,217,191,90,700,12097,12887,6633,0,1,39,40
2090,CHITTOOR,Thamballapalle,KUKKARAJUPALLE,4,0,291,295,0,0,64,64,45,0,0,3089,3089,1133,0,0,8,8
2091,CHITTOOR,Thamballapalle,MARRIMAKULAPALLE,8,3,230,241,0,0,94,94,76,0,0,4955,4955,2845,0,0,16,16
2092,CHITTOOR,Thamballapalle,PANCHALAMARRI,53,4,179,236,33,1,117,151,137,2550,5,5634,8189,3928,9,0,14,23
2093,CHITTOOR,Thamballapalle,R.N.THANDA,80,140,305,525,36,82,139,257,237,1698,4817,8286,14801,7651,5,15,34,54
2094,CHITTOOR,Thamballapalle,REDDIKOTA,58,14,389,461,1,1,61,63,40,126,102,4298,4526,1554,1,1,23,25
2095,CHITTOOR,Thamballapalle,RENIMAKULAPALLE,80,7,438,525,41,1,103,145,115,1412,62,5452,6926,3352,5,0,23,28
2096,CHITTOOR,Thamballapalle,THAMBALLAPALLE,82,124,1532,1738,6,39,328,373,341,323,1118,12476,13917,7582,1,0,14,15
2097,CHITTOOR,Thamballapalle,ZUNJURUPENTA,9,4,288,301,0,2,90,92,83,0,19,3744,3763,1847,0,0,6,6
2098,CHITTOOR,Thavanampalle,ARAGONDA,360,2,329,691,25,0,11,36,28,842,0,617,1459,640,3,0,4,7
2099,CHITTOOR,Thavanampalle,ARAGONDA GOLLAPALLE,40,2,161,203,1,0,12,13,14,20,0,1229,1249,594,0,0,9,9
2100,CHITTOOR,Thavanampalle,CHERLOPALLE,219,15,135,369,113,1,49,163,136,5421,12,3498,8931,4648,17,0,14,31
2101,CHITTOOR,Thavanampalle,DIGUVA MAGHAM,134,0,64,198,17,0,6,23,18,396,0,558,954,591,0,0,4,4
2102,CHITTOOR,Thavanampalle,DIGUVA THADAKARA,219,2,103,324,62,1,23,86,71,4107,24,1998,6129,3632,16,0,15,31
2103,CHITTOOR,Thavanampalle,DIGUVAMODULAPALLE,128,0,370,498,25,0,121,146,138,1557,0,8988,10545,5915,6,0,51,57
2104,CHITTOOR,Thavanampalle,E.MAREDUPALLE,158,1,121,280,45,0,22,67,56,3053,0,1324,4377,2202,21,0,5,26
2105,CHITTOOR,Thavanampalle,EACHANERI,185,44,142,371,47,6,24,77,58,1448,501,1534,3483,2024,3,2,8,13
2106,CHITTOOR,Thavanampalle,EGUVA THADAKARA,12,65,161,238,0,0,5,5,3,0,0,222,222,126,0,0,0,0
2107,CHITTOOR,Thavanampalle,EGUVA THAVANAMPALLE,122,8,192,322,39,0,85,124,112,1728,0,7975,9703,4731,4,0,52,56
2108,CHITTOOR,Thavanampalle,GOVINDAREDDIPALLE,109,3,433,545,67,0,179,246,204,6867,0,16639,23506,12136,56,0,119,175
2109,CHITTOOR,Thavanampalle,GURUKAVARIPALLE-G.PALLE,179,41,230,450,22,0,3,25,24,512,0,99,611,314,0,0,0,0
2110,CHITTOOR,Thavanampalle,JONNAGURUKULA,139,7,95,241,17,2,17,36,30,1109,204,1756,3069,1587,3,1,10,14
2111,CHITTOOR,Thavanampalle,KARAKAMPALLE,146,0,109,255,18,0,27,45,24,681,0,1215,1896,620,3,0,4,7
2112,CHITTOOR,Thavanampalle,KATTAKINDAPALLE,57,27,127,211,12,0,19,31,17,562,0,862,1424,658,2,0,1,3
2113,CHITTOOR,Thavanampalle,KONDRAJUKALVA,172,39,186,397,16,1,30,47,39,385,30,2415,2830,1232,0,0,16,16
2114,CHITTOOR,Thavanampalle,MADHAVARAM,99,72,224,395,45,24,113,182,173,3845,1280,6900,12025,6557,25,4,28,57
2115,CHITTOOR,Thavanampalle,MALLAKUNTA,155,38,329,522,7,0,28,35,35,150,0,1017,1167,618,0,0,1,1
2116,CHITTOOR,Thavanampalle,MATHYAM,208,37,234,479,33,0,65,98,73,1403,0,4597,6000,2898,6,0,32,38
2117,CHITTOOR,Thavanampalle,MUTHUKUR,66,0,206,272,43,0,73,116,82,1832,0,4533,6365,3013,3,0,21,24
2118,CHITTOOR,Thavanampalle,MYNOGUNDLAPALLE,104,15,190,309,27,0,42,69,46,2050,0,3569,5619,2744,10,0,23,33
2119,CHITTOOR,Thavanampalle,NALISETTIPALLE,29,1,234,264,1,0,8,9,7,108,0,866,974,537,1,0,8,9
2120,CHITTOOR,Thavanampalle,PALLECHERUVU,63,0,151,214,34,0,51,85,74,1225,0,3283,4508,2495,4,0,10,14
2121,CHITTOOR,Thavanampalle,PATNAM,284,32,257,573,65,0,49,114,95,4928,0,2266,7194,4434,20,0,4,24
2122,CHITTOOR,Thavanampalle,PUNYA SAMUDRAM,230,13,161,404,53,0,44,97,74,4352,0,3938,8290,4209,29,0,29,58
2123,CHITTOOR,Thavanampalle,SARAKALLU,138,42,260,440,40,2,36,78,58,2745,54,2049,4848,2385,13,0,11,24
2124,CHITTOOR,Thavanampalle,THAVANAMPALLE,43,23,324,390,1,0,44,45,43,84,0,2984,3068,2096,0,0,8,8
2125,CHITTOOR,Thavanampalle,THAVANAMPALLE PUTTUR,82,3,198,283,53,0,97,150,115,4722,0,8369,13091,7775,36,0,58,94
2126,CHITTOOR,Thavanampalle,THELLAGUNDLAPALLE,91,6,157,254,17,1,39,57,40,752,18,2147,2917,1269,2,0,6,8
2127,CHITTOOR,Thavanampalle,THODALTHORA,145,1,107,253,81,0,25,106,98,6568,0,2068,8636,4553,40,0,13,53
2128,CHITTOOR,Thavanampalle,UTHARA BRAHMANAPALLE,47,0,194,241,0,0,4,4,3,0,0,450,450,174,0,0,3,3
2129,CHITTOOR,Thavanampalle,VENGAMPALLE,126,24,227,377,41,2,41,84,42,1924,30,1471,3425,1204,4,0,2,6
2130,CHITTOOR,Thottambedu,BASAVAIAH PALEM,68,71,295,434,36,14,168,218,230,187,266,5040,5493,4947,0,0,1,1
2131,CHITTOOR,Thottambedu,BONUPALLE,132,57,271,460,93,0,1,94,91,8347,0,54,8401,5450,43,0,0,43
2132,CHITTOOR,Thottambedu,CHINNASINGAMALA,154,64,166,384,91,0,36,127,98,2237,0,973,3210,1717,1,0,0,1
2133,CHITTOOR,Thottambedu,CHITTATHUR,160,7,309,476,19,0,82,101,58,745,0,1344,2089,964,3,0,0,3
2134,CHITTOOR,Thottambedu,CHIYYAVARAM,128,19,577,724,39,16,460,515,572,882,189,25017,26088,13704,1,0,84,85
2135,CHITTOOR,Thottambedu,CHODAVARAM,112,45,240,397,68,6,138,212,208,3693,66,9203,12962,6336,22,0,41,63
2136,CHITTOOR,Thottambedu,GUNDELIGUNTA,118,20,247,385,99,0,135,234,215,5334,0,4724,10058,6353,16,0,10,26
2137,CHITTOOR,Thottambedu,ILAGANURU,126,34,103,263,50,0,6,56,45,492,0,35,527,353,0,0,0,0
2138,CHITTOOR,Thottambedu,KANCHANAPALLE,79,48,49,176,60,29,22,111,87,2505,891,609,4005,2025,2,1,0,3
2139,CHITTOOR,Thottambedu,KARAKALLU,196,4,91,291,66,1,39,106,64,1811,8,1260,3079,1048,1,0,0,1
2140,CHITTOOR,Thottambedu,KASARAM,290,72,397,759,155,53,209,417,360,7978,2558,11160,21696,10808,22,1,33,56
2141,CHITTOOR,Thottambedu,KONATHANERI,276,28,166,470,96,11,20,127,109,3687,108,366,4161,2353,3,0,0,3
2142,CHITTOOR,Thottambedu,KOTHA KANDRIGA,1,14,263,278,0,0,91,91,91,0,0,699,699,618,0,0,0,0
2143,CHITTOOR,Thottambedu,LINGAMANAIDUPALLE,159,39,71,269,123,0,3,126,123,4320,0,58,4378,2360,3,0,0,3
2144,CHITTOOR,Thottambedu,PEDDA KANNALI,202,136,186,524,138,0,44,182,171,4143,0,849,4992,3276,0,0,0,0
2145,CHITTOOR,Thottambedu,PEDDAKANAPARTHI,326,7,214,547,114,0,3,117,109,2017,0,46,2063,1388,0,0,0,0
2146,CHITTOOR,Thottambedu,PENNALAPADU,134,34,131,299,0,0,1,1,1,0,0,40,40,17,0,0,0,0
2147,CHITTOOR,Thottambedu,PILLAMEDU,188,39,179,406,136,6,94,236,208,11365,176,3573,15114,7598,65,0,7,72
2148,CHITTOOR,Thottambedu,POYYA,177,62,207,446,125,0,14,139,129,1654,0,149,1803,971,0,0,0,0
2149,CHITTOOR,Thottambedu,PUDI,137,39,137,313,0,1,4,5,4,0,6,39,45,21,0,0,0,0
2150,CHITTOOR,Thottambedu,ROUTHUSURAMALA,140,37,64,241,99,17,24,140,117,5918,256,747,6921,3308,23,0,0,23
2151,CHITTOOR,Thottambedu,SAMBAIAHPALEM,41,0,301,342,0,0,0,0,0,0,0,0,0,0,0,0,0,0
2152,CHITTOOR,Thottambedu,SHESHAMA NAIDUKANDRIGA,88,50,36,174,50,32,8,90,75,1580,758,114,2452,1424,2,0,0,2
2153,CHITTOOR,Thottambedu,SIVANADHAPALEM,94,61,170,325,73,0,23,96,93,4880,0,1116,5996,3741,18,0,2,20
2154,CHITTOOR,Thottambedu,THANGELLAPALEM,202,100,158,460,102,3,0,105,118,2494,47,0,2541,1565,2,0,0,2
2155,CHITTOOR,Thottambedu,THATIPARTHI,149,0,178,327,114,0,4,118,98,7222,0,180,7402,3683,39,0,0,39
2156,CHITTOOR,Thottambedu,THOTTAMBEDU,221,146,351,718,1,6,2,9,9,60,36,40,136,72,0,0,0,0
2157,CHITTOOR,Tirupati Rural,AVILALA,284,95,529,908,7,0,1,8,7,110,0,5,115,100,0,0,0,0
2158,CHITTOOR,Tirupati Rural,BRAHMANAPATTU,117,2,260,379,6,0,128,134,130,144,0,7039,7183,6566,0,0,11,11
2159,CHITTOOR,Tirupati Rural,CHERLOPALLE,52,9,148,209,5,0,21,26,22,87,0,924,1011,741,0,0,2,2
2160,CHITTOOR,Tirupati Rural,CHIGURUWADA,174,3,60,237,81,0,1,82,77,5853,0,90,5943,5268,16,0,0,16
2161,CHITTOOR,Tirupati Rural,DURGASAMUDRAM,195,31,317,543,80,1,48,129,131,2308,20,1010,3338,2621,0,0,0,0
2162,CHITTOOR,Tirupati Rural,GOLLAPALLE,67,15,77,159,32,0,2,34,31,2235,0,46,2281,1803,5,0,0,5
2163,CHITTOOR,Tirupati Rural,KOTHUR,18,0,112,130,5,0,34,39,31,84,0,1507,1591,776,0,0,3,3
2164,CHITTOOR,Tirupati Rural,KUNTRAPAKAM,78,14,231,323,2,0,1,3,1,36,0,20,56,18,0,0,0,0
2165,CHITTOOR,Tirupati Rural,KUPUCHANDRAPETA,62,73,89,224,5,0,2,7,2,47,0,25,72,23,0,0,0,0
2166,CHITTOOR,Tirupati Rural,MALLAM GUNTA,191,91,9,291,60,33,1,94,87,2397,1476,33,3906,2947,0,0,0,0
2167,CHITTOOR,Tirupati Rural,MALLAVARAM,158,10,220,388,68,0,3,71,56,4404,0,35,4439,3460,21,0,0,21
2168,CHITTOOR,Tirupati Rural,MUNDLAPUDI,68,0,265,333,20,0,64,84,81,356,0,1420,1776,1716,0,0,0,0
2169,CHITTOOR,Tirupati Rural,PADI @ PADIPETA,58,0,92,150,34,0,39,73,74,1932,0,2202,4134,4046,0,0,0,0
2170,CHITTOOR,Tirupati Rural,PADMAVATHIPURAM,68,5,169,242,0,0,0,0,0,0,0,0,0,0,0,0,0,0
2171,CHITTOOR,Tirupati Rural,PAIDIPALLE,103,10,192,305,28,1,82,111,98,1798,67,4482,6347,4835,3,0,3,6
2172,CHITTOOR,Tirupati Rural,PANAKAM,63,1,94,158,34,0,8,42,38,1420,0,109,1529,1205,1,0,0,1
2173,CHITTOOR,Tirupati Rural,PATHAKALVA,11,28,232,271,3,1,84,88,89,192,78,5577,5847,5791,0,0,1,1
2174,CHITTOOR,Tirupati Rural,PATHUR,16,2,187,205,3,0,114,117,109,18,0,6373,6391,5631,0,0,3,3
2175,CHITTOOR,Tirupati Rural,PERUMALPALLE,159,97,317,573,97,1,52,150,124,6328,68,2357,8753,6965,35,0,10,45
2176,CHITTOOR,Tirupati Rural,PERUR,78,17,323,418,0,0,0,0,0,0,0,0,0,0,0,0,0,0
2177,CHITTOOR,Tirupati Rural,PUDIPATLA,133,3,160,296,66,1,37,104,88,4715,17,2190,6922,4779,28,0,9,37
2178,CHITTOOR,Tirupati Rural,RAMANUJAPALLE,31,6,55,92,15,0,34,49,50,306,0,2411,2717,2671,0,0,15,15
2179,CHITTOOR,Tirupati Rural,SAINAGAR,278,35,467,780,31,3,25,59,54,998,92,606,1696,1547,0,0,0,0
2180,CHITTOOR,Tirupati Rural,THANAPALLE,60,4,57,121,0,0,0,0,0,0,0,0,0,0,0,0,0,0
2181,CHITTOOR,Tirupati Rural,THUMMALAGUNTA,134,3,61,198,0,0,0,0,0,0,0,0,0,0,0,0,0,0
2182,CHITTOOR,Tirupati Rural,TIRUCHANUR,107,55,307,469,2,0,37,39,38,10,0,1692,1702,1655,0,0,0,0
2183,CHITTOOR,Tirupati Rural,VEDANTHAPURAM,54,23,158,235,0,0,0,0,0,0,0,0,0,0,0,0,0,0
2184,CHITTOOR,Tirupati Rural,VEMUR,95,8,202,305,27,0,18,45,40,1073,0,511,1584,1371,2,0,0,2
2185,CHITTOOR,Tirupati Urban,M.R.PALLE,180,1,62,243,0,0,0,0,0,0,0,0,0,0,0,0,0,0
2186,CHITTOOR,Tirupati Urban,RAJEEV NAGAR,35,19,216,270,0,0,0,0,0,0,0,0,0,0,0,0,0,0
2187,CHITTOOR,Tirupati Urban,SETTIPALLI,364,255,865,1484,11,6,17,34,37,1002,600,1301,2903,2723,8,5,7,20
2188,CHITTOOR,Tirupati Urban,THIMMANAIDUPALEM,208,100,498,806,0,0,0,0,0,0,0,0,0,0,0,0,0,0
2189,CHITTOOR,Vadamalapeta,A.M.PURAM,60,61,95,216,22,21,16,59,57,916,921,1154,2991,2520,5,2,7,14
2190,CHITTOOR,Vadamalapeta,APPALAYAGUNTA,97,31,265,393,55,1,103,159,145,4998,115,7507,12620,9893,36,1,32,69
2191,CHITTOOR,Vadamalapeta,BALINAIDU KANDRIGA,165,38,385,588,57,7,175,239,228,2580,538,8664,11782,8062,6,4,22,32
2192,CHITTOOR,Vadamalapeta,CHINTHAKALVA,10,29,76,115,0,0,31,31,29,0,0,1753,1753,1539,0,0,7,7
2193,CHITTOOR,Vadamalapeta,KADIRIMANGALAM,104,0,90,194,74,0,40,114,116,6120,0,3171,9291,8060,28,0,16,44
2194,CHITTOOR,Vadamalapeta,KALLURU,56,13,148,217,36,9,85,130,117,2839,652,6544,10035,8247,19,4,50,73
2195,CHITTOOR,Vadamalapeta,KAYAM,90,79,185,354,33,0,72,105,89,2645,0,5148,7793,5772,18,0,36,54
2196,CHITTOOR,Vadamalapeta,LAKSHMAMMAKANDRIGA,49,43,232,324,27,24,141,192,164,1710,1657,10753,14120,9643,6,10,72,88
2197,CHITTOOR,Vadamalapeta,NARAYANAPURAM,60,32,162,254,20,7,83,110,95,599,210,5076,5885,4705,0,1,12,13
2198,CHITTOOR,Vadamalapeta,O.B.R.KANDRIGA,117,49,203,369,61,1,77,139,127,3176,43,5488,8707,6518,18,0,26,44
2199,CHITTOOR,Vadamalapeta,PADIREDU,133,76,203,412,62,3,122,187,175,4201,86,6612,10899,7879,18,0,10,28
2200,CHITTOOR,Vadamalapeta,PATHIPUTHUR,164,3,249,416,90,1,110,201,177,7910,109,7670,15689,12237,51,1,34,86
2201,CHITTOOR,Vadamalapeta,PUDI,170,15,252,437,63,1,64,128,122,2377,5,3064,5446,4477,3,0,2,5
2202,CHITTOOR,Vadamalapeta,S.V.PURAM,195,36,342,573,76,5,148,229,228,3718,293,6351,10362,7577,8,2,15,25
2203,CHITTOOR,Vadamalapeta,SEETHARAMA PURAM,68,14,181,263,46,0,109,155,154,2975,0,6074,9049,5934,7,0,14,21
2204,CHITTOOR,Vadamalapeta,SRI BOMMARAJU PURAM,300,135,334,769,96,6,101,203,193,4452,59,4726,9237,7891,5,0,7,12
2205,CHITTOOR,Vadamalapeta,T.C AGRAHARAM,22,8,308,338,2,3,145,150,135,47,53,5979,6079,4746,0,0,14,14
2206,CHITTOOR,Vadamalapeta,THIRUMANDYAM,254,26,254,534,25,1,115,141,131,1710,21,6638,8369,6732,4,0,37,41
2207,CHITTOOR,Vadamalapeta,VADAMALA,104,10,232,346,14,0,73,87,78,1054,0,4354,5408,3835,2,0,10,12
2208,CHITTOOR,Vadamalapeta,VADAMALA PET,168,127,425,720,37,35,55,127,127,2471,2171,3384,8026,6744,17,10,13,40
2209,CHITTOOR,Varadaiahpalem,AMBUR,94,48,66,208,66,13,36,115,110,4389,546,954,5889,3608,19,0,0,19
2210,CHITTOOR,Varadaiahpalem,ARUDURU,77,47,74,198,0,3,8,11,12,0,24,245,269,162,0,0,0,0
2211,CHITTOOR,Varadaiahpalem,AYYAVARI PALEM,37,10,125,172,21,1,105,127,129,755,45,2957,3757,2159,1,0,4,5
2212,CHITTOOR,Varadaiahpalem,BATHALAVALLAM,624,104,232,960,183,12,9,204,226,6074,131,87,6292,5130,6,0,0,6
2213,CHITTOOR,Varadaiahpalem,C.L.N.PALLE,238,18,117,373,41,1,1,43,43,540,20,20,580,506,0,0,0,0
2214,CHITTOOR,Varadaiahpalem,CHILAMATHUR,233,30,122,385,182,23,79,284,291,8001,1284,3853,13138,8539,7,5,3,15
2215,CHITTOOR,Varadaiahpalem,CHINNA PANDURU,38,121,217,376,24,32,75,131,124,1295,1879,2965,6139,3770,4,8,1,13
2216,CHITTOOR,Varadaiahpalem,I.NAGAR COLONY,56,75,241,372,0,0,3,3,5,0,0,52,52,42,0,0,0,0
2217,CHITTOOR,Varadaiahpalem,KADURU,257,43,94,394,133,1,3,137,152,4272,38,79,4389,3881,0,0,0,0
2218,CHITTOOR,Varadaiahpalem,KALATHURU,138,72,221,431,61,0,108,169,159,3064,0,4117,7181,4002,1,0,5,6
2219,CHITTOOR,Varadaiahpalem,KAMBAKAM,219,135,169,523,68,0,51,119,119,3151,0,2395,5546,4240,6,0,6,12
2220,CHITTOOR,Varadaiahpalem,KANCHERLA PALEM,136,38,118,292,54,0,13,67,58,1817,0,201,2018,1466,0,0,0,0
2221,CHITTOOR,Varadaiahpalem,KAREPAKAM,123,102,104,329,68,1,27,96,99,4152,35,1481,5668,5132,6,0,2,8
2222,CHITTOOR,Varadaiahpalem,KUDINJALAM,1,64,78,143,0,0,0,0,0,0,0,0,0,0,0,0,0,0
2223,CHITTOOR,Varadaiahpalem,KUVVAKOLLI,158,1,144,303,93,0,106,199,183,2890,0,5037,7927,5272,3,0,9,12
2224,CHITTOOR,Varadaiahpalem,MARADA WADA,86,41,35,162,57,0,23,80,77,3630,0,1075,4705,3492,12,0,3,15
2225,CHITTOOR,Varadaiahpalem,MAVILLAPADU,57,0,51,108,31,0,13,44,33,455,0,78,533,284,0,0,0,0
2226,CHITTOOR,Varadaiahpalem,MUTTIRI MITTA,419,44,416,879,89,4,91,184,177,4698,89,4018,8805,6559,10,0,2,12
2227,CHITTOOR,Varadaiahpalem,NELLATUR,87,1,172,260,52,0,99,151,145,4448,0,6040,10488,8160,24,0,15,39
2228,CHITTOOR,Varadaiahpalem,PANDURU,347,77,337,761,151,15,122,288,299,2107,255,4130,6492,3788,0,0,7,7
2229,CHITTOOR,Varadaiahpalem,PULIVELLAM,132,12,37,181,87,0,5,92,109,4000,0,139,4139,3612,4,0,0,4
2230,CHITTOOR,Varadaiahpalem,RACHERLA,246,12,77,335,107,0,7,114,113,6212,0,95,6307,4401,20,0,0,20
2231,CHITTOOR,Varadaiahpalem,SANTHAVELLORE,442,170,263,875,61,0,21,82,74,2026,0,184,2210,1446,1,0,0,1
2232,CHITTOOR,Varadaiahpalem,THONDAMBATTU,221,106,221,548,3,2,61,66,67,120,18,1674,1812,1040,0,0,0,0
2233,CHITTOOR,Varadaiahpalem,VARADAIAHPALEM,270,98,198,566,88,0,47,135,136,2209,0,3136,5345,5152,0,0,3,3
2234,CHITTOOR,Varadaiahpalem,YANADI VETTU,83,7,84,174,29,2,22,53,54,340,32,424,796,606,0,0,0,0
2235,CHITTOOR,Vayalpad,AYYAVARI PALLE,79,0,176,255,42,0,75,117,104,3410,0,6495,9905,5143,22,0,41,63
2236,CHITTOOR,Vayalpad,BUDIDAVEDU,56,0,180,236,42,0,114,156,148,3752,0,8626,12378,6336,23,0,40,63
2237,CHITTOOR,Vayalpad,CHINTALAVARI PALLE,71,5,324,400,41,0,168,209,196,2099,0,11255,13354,6733,7,0,48,55
2238,CHITTOOR,Vayalpad,CHINTAPARTHI,539,23,1122,1684,86,0,106,192,170,5442,0,2900,8342,4778,21,0,4,25
2239,CHITTOOR,Vayalpad,G.BOYANA PALLE,154,31,548,733,68,3,62,133,105,4358,250,2114,6722,3039,14,1,8,23
2240,CHITTOOR,Vayalpad,JARRAVARI PALLE,129,12,502,643,63,8,177,248,219,5079,344,5938,11361,5804,29,0,4,33
2241,CHITTOOR,Vayalpad,KURAPARTHI,258,12,176,446,71,1,24,96,88,3060,28,415,3503,2118,11,0,0,11
2242,CHITTOOR,Vayalpad,MADHAVARAM PALLE,6,1,83,90,1,0,10,11,10,50,0,770,820,374,0,0,3,3
2243,CHITTOOR,Vayalpad,MANCHURU,158,4,440,602,65,0,53,118,101,3932,0,2996,6928,3472,18,0,11,29
2244,CHITTOOR,Vayalpad,MUGALAMARRI,142,3,166,311,80,1,24,105,95,5625,6,1713,7344,4299,30,0,9,39
2245,CHITTOOR,Vayalpad,MUREVENDLA PALLE,134,0,286,420,50,0,28,78,76,1812,0,1274,3086,1717,4,0,5,9
2246,CHITTOOR,Vayalpad,NAGARIMADUGU,174,25,331,530,123,8,208,339,289,12229,479,20138,32846,15599,89,1,134,224
2247,CHITTOOR,Vayalpad,T.SAKIREVUPALLE,79,6,229,314,24,0,66,90,76,1724,0,4412,6136,3349,9,0,21,30
2248,CHITTOOR,Vayalpad,THATIGUNTA PALLE,132,3,246,381,44,1,32,77,61,1738,2,1013,2753,1372,4,0,3,7
2249,CHITTOOR,Vayalpad,VAYALPAD,400,19,1490,1909,43,1,217,261,215,2603,9,15380,17992,9505,13,0,81,94
2250,CHITTOOR,Vayalpad,VITTALAM,98,0,154,252,64,0,25,89,74,5116,0,759,5875,3673,22,0,1,23
2251,CHITTOOR,Veduru Kuppam,AGGICHENUPALLE,197,2,127,326,127,1,53,181,157,8850,6,3185,12041,6597,52,0,16,68
2252,CHITTOOR,Veduru Kuppam,ALLAMADURU,4,12,340,356,1,0,30,31,31,29,0,982,1011,849,0,0,0,0
2253,CHITTOOR,Veduru Kuppam,BOMMAIAH PALLE,412,20,471,903,194,0,50,244,207,10346,0,1604,11950,7330,29,0,1,30
2254,CHITTOOR,Veduru Kuppam,BRAHMANAPALLE,53,32,284,369,30,0,84,114,102,2030,0,3555,5585,3648,12,0,8,20
2255,CHITTOOR,Veduru Kuppam,DEVARAGUDIPALLE,184,5,70,259,123,4,49,176,153,9659,254,2368,12281,8150,62,1,8,71
2256,CHITTOOR,Veduru Kuppam,DIGUVAPALLALU,118,9,148,275,17,3,37,57,55,342,132,1193,1667,948,0,0,0,0
2257,CHITTOOR,Veduru Kuppam,GANTAVARIPALLE,12,45,309,366,0,6,6,12,6,0,114,157,271,174,0,0,0,0
2258,CHITTOOR,Veduru Kuppam,GODUGUCHINTHA,6,2,252,260,2,1,185,188,177,189,54,11605,11848,6629,1,0,42,43
2259,CHITTOOR,Veduru Kuppam,INAMKOTHURU,40,6,249,295,11,3,107,121,115,288,90,6937,7315,4525,0,0,29,29
2260,CHITTOOR,Veduru Kuppam,JAKKIDONA,126,25,341,492,24,0,8,32,33,695,0,88,783,490,1,0,0,1
2261,CHITTOOR,Veduru Kuppam,KOMARAGUNTA,95,13,275,383,1,2,49,52,48,106,198,2220,2524,1396,1,1,0,2
2262,CHITTOOR,Veduru Kuppam,KURIVIKUPPAM,115,5,170,290,76,0,58,134,122,5412,0,3545,8957,5150,23,0,13,36
2263,CHITTOOR,Veduru Kuppam,MAMBEDU,335,28,713,1076,89,12,245,346,310,3340,1283,12407,17030,10037,11,9,45,65
2264,CHITTOOR,Veduru Kuppam,MAREPALLE,68,6,110,184,54,1,43,98,97,5235,76,1821,7132,4580,33,0,2,35
2265,CHITTOOR,Veduru Kuppam,MONDIVENGANAPALLE,59,0,259,318,15,0,70,85,67,914,0,2194,3108,1773,4,0,0,4
2266,CHITTOOR,Veduru Kuppam,NALLAVENGANAPALLE,368,19,534,921,181,1,106,288,268,11161,90,6517,17768,10586,40,0,35,75
2267,CHITTOOR,Veduru Kuppam,PACHIKAPALLAM,291,20,450,761,20,10,128,158,150,503,768,4875,6146,3593,0,4,5,9
2268,CHITTOOR,Veduru Kuppam,PATHAGUNTA,157,11,487,655,92,0,217,309,268,6685,0,13878,20563,12465,27,0,42,69
2269,CHITTOOR,Veduru Kuppam,PERUMALLAPALLE,34,0,210,244,21,0,132,153,148,1282,0,10103,11385,6095,5,0,55,60
2270,CHITTOOR,Veduru Kuppam,SANTHABAYALU,74,13,140,227,0,0,47,47,40,0,0,1690,1690,1073,0,0,2,2
2271,CHITTOOR,Veduru Kuppam,T.K.M.PURAM,2,7,244,253,0,3,80,83,73,0,55,2898,2953,1557,0,0,9,9
2272,CHITTOOR,Veduru Kuppam,THIPPINAIDUPALLE,167,0,112,279,74,0,25,99,83,3115,0,573,3688,2882,1,0,0,1
2273,CHITTOOR,Veduru Kuppam,TIRUMALAIAHPALLE,311,46,746,1103,169,5,177,351,317,6789,62,9474,16325,9469,17,0,39,56
2274,CHITTOOR,Veduru Kuppam,VEDURUKUPPAM,174,25,252,451,70,21,84,175,158,4395,1348,5504,11247,6660,17,6,26,49
2275,CHITTOOR,Veduru Kuppam,YANAMALAMANDA,145,31,93,269,69,14,7,90,82,2249,397,409,3055,1513,2,0,3,5
2276,CHITTOOR,Venkatagiri Kota,BAIRUPALLE,65,6,380,451,28,0,101,129,120,1537,0,5702,7239,4024,2,0,19,21
2277,CHITTOOR,Venkatagiri Kota,BODIGUTTAPALLE,79,4,468,551,46,4,204,254,284,2655,238,12726,15619,9604,10,1,49,60
2278,CHITTOOR,Venkatagiri Kota,BOYA CHINNAGANNPALLE,63,30,402,495,24,14,162,200,169,1130,318,10057,11505,6622,2,1,53,56
2279,CHITTOOR,Venkatagiri Kota,CHINTAMAKULAPALLE,100,24,369,493,32,3,97,132,116,2467,342,4831,7640,3782,13,3,14,30
2280,CHITTOOR,Venkatagiri Kota,GONUMAKULAPALLE,139,53,548,740,35,1,130,166,148,1474,12,5957,7443,4444,2,0,16,18
2281,CHITTOOR,Venkatagiri Kota,JOUNIPALLE,226,41,660,927,58,12,143,213,274,3575,1099,8793,13467,7657,16,7,40,63
2282,CHITTOOR,Venkatagiri Kota,KONGATAM,268,15,1669,1952,44,1,211,256,236,2251,47,13445,15743,8731,8,0,70,78
2283,CHITTOOR,Venkatagiri Kota,KRISHNAPURAM,176,38,767,981,51,2,146,199,204,3888,48,9769,13705,6420,20,0,52,72
2284,CHITTOOR,Venkatagiri Kota,KUMBARLAPALLE,112,9,402,523,5,0,71,76,72,211,0,3415,3626,1851,1,0,14,15
2285,CHITTOOR,Venkatagiri Kota,MUDARAMDODDI,456,77,1145,1678,142,12,171,325,288,6418,493,8227,15138,8256,18,1,32,51
2286,CHITTOOR,Venkatagiri Kota,NERNIPALLI,29,60,232,321,1,11,11,23,26,120,862,1030,2012,771,1,6,5,12
2287,CHITTOOR,Venkatagiri Kota,PAMUGANIPALLE,125,16,400,541,34,2,124,160,129,1597,224,9167,10988,5892,8,2,57,67
2288,CHITTOOR,Venkatagiri Kota,PEDDA BHARANIPALLE,101,2,333,436,15,0,50,65,57,226,0,2501,2727,1291,0,0,15,15
2289,CHITTOOR,Venkatagiri Kota,S.BANDAPALLE,148,36,368,552,42,0,70,112,120,1758,0,3225,4983,2729,5,0,12,17
2290,CHITTOOR,Venkatagiri Kota,THOTAKANUMA,78,73,546,697,24,13,132,169,158,2206,931,9374,12511,6450,11,3,51,65
2291,CHITTOOR,Venkatagiri Kota,V.KOTA,344,119,1534,1997,20,8,48,76,74,1668,552,2948,5168,2776,10,4,13,27
2292,CHITTOOR,Venkatagiri Kota,VOGU,55,18,187,260,28,14,138,180,187,1781,757,8707,11245,6578,10,4,32,46
2293,CHITTOOR,Venkatagiri Kota,YALAKALLU,177,57,509,743,59,8,189,256,257,2892,326,11662,14880,7669,7,0,42,49
2294,CHITTOOR,Vijaya Puram,ALAPAKAM,138,0,342,480,42,0,66,108,118,471,0,4883,5354,4459,0,0,13,13
2295,CHITTOOR,Vijaya Puram,BUCHIVANATHAM,167,1,320,488,114,0,154,268,316,8657,0,5549,14206,9710,30,0,4,34
2296,CHITTOOR,Vijaya Puram,GANGAMAMBAPURAM,69,24,106,199,0,0,71,71,57,0,0,1807,1807,1114,0,0,0,0
2297,CHITTOOR,Vijaya Puram,ILLATHURU,163,43,208,414,95,29,139,263,259,877,1233,5750,7860,5097,2,1,2,5
2298,CHITTOOR,Vijaya Puram,JAGANNADHAPURAM,6,77,192,275,3,46,138,187,189,101,3830,9907,13838,8639,0,25,42,67
2299,CHITTOOR,Vijaya Puram,K.V.PURAM,240,27,151,418,115,1,1,117,127,4178,12,2,4192,3517,2,0,0,2
2300,CHITTOOR,Vijaya Puram,KALIAMBAKAM,176,2,170,348,133,1,116,250,323,5985,11,5168,11164,8182,3,0,4,7
2301,CHITTOOR,Vijaya Puram,KALIKAPURAM,29,0,270,299,20,0,161,181,195,1191,0,8313,9504,7338,3,0,13,16
2302,CHITTOOR,Vijaya Puram,KOSALA NAGARAM,55,62,194,311,24,25,87,136,142,575,2792,1662,5029,3000,0,20,1,21
2303,CHITTOOR,Vijaya Puram,KSHURIKA PURAM,57,10,217,284,41,2,146,189,227,1623,45,5004,6672,4889,2,0,5,7
2304,CHITTOOR,Vijaya Puram,M.AGARUM,87,2,81,170,48,0,21,69,70,1792,0,904,2696,2051,1,0,0,1
2305,CHITTOOR,Vijaya Puram,MADHAVARAM,155,18,146,319,75,12,50,137,140,2878,135,2258,5271,3844,6,0,9,15
2306,CHITTOOR,Vijaya Puram,MAHARAJA PURAM,106,20,127,253,41,4,42,87,97,826,54,1010,1890,1298,0,0,0,0
2307,CHITTOOR,Vijaya Puram,MALLAREDDI KANDRIGA,60,68,118,246,41,51,99,191,216,2199,3657,6467,12323,7626,5,17,25,47
2308,CHITTOOR,Vijaya Puram,MANGALAM,1,10,124,135,0,3,77,80,74,0,66,5409,5475,3686,0,0,29,29
2309,CHITTOOR,Vijaya Puram,NARAPURAJU KANDRIGA,24,0,109,133,17,0,60,77,73,347,0,2540,2887,1766,0,0,10,10
2310,CHITTOOR,Vijaya Puram,PANNURU,346,57,276,679,263,42,180,485,513,9790,1316,2800,13906,8862,6,1,1,8
2311,CHITTOOR,Vijaya Puram,PATHA ARCOT,31,17,208,256,0,5,24,29,32,0,82,1382,1464,780,0,0,2,2
2312,CHITTOOR,Vijaya Puram,POTHULARAJU KANDRIGA,61,0,138,199,35,0,65,100,86,816,0,2165,2981,2187,0,0,1,1
2313,CHITTOOR,Vijaya Puram,SRIHARI PURAM,111,16,189,316,22,8,128,158,159,722,630,8791,10143,5842,2,4,33,39
2314,CHITTOOR,Vijaya Puram,VIJAYA PURAM,238,49,283,570,111,11,148,270,273,2505,1118,7978,11601,7374,2,7,24,33
2315,CHITTOOR,Vijaya Puram,ZAMBADA,116,14,129,259,68,7,67,142,158,1854,267,2274,4395,3163,1,0,8,9
2316,CHITTOOR,Yadamari,12.KAMMAPALLE,114,7,329,450,8,2,67,77,72,425,22,4643,5090,3075,1,0,24,25
2317,CHITTOOR,Yadamari,14.KANDIGA,58,1,210,269,24,0,44,68,57,2631,0,4388,7019,3973,21,0,28,49
2318,CHITTOOR,Yadamari,155 KAMMAPALLE,45,0,76,121,17,0,25,42,38,1644,0,2277,3921,2451,11,0,17,28
2319,CHITTOOR,Yadamari,184.GOLLAPALLE,104,0,151,255,15,0,18,33,25,1061,0,1551,2612,1159,6,0,9,15
2320,CHITTOOR,Yadamari,ATHIKARIPALLE,2,3,241,246,0,0,12,12,10,0,0,740,740,364,0,0,4,4
2321,CHITTOOR,Yadamari,BHOOMIREDDIPALLE,135,0,235,370,30,0,34,64,51,1466,0,925,2391,1232,8,0,0,8
2322,CHITTOOR,Yadamari,BODAGUTTAPALLE,238,37,135,410,36,0,10,46,31,3028,0,198,3226,1454,22,0,0,22
2323,CHITTOOR,Yadamari,BUDITHIREDDIPALLE,53,0,191,244,16,0,63,79,79,1172,0,4073,5245,3517,4,0,19,23
2324,CHITTOOR,Yadamari,DALAVAIPALLE,16,22,296,334,2,3,81,86,51,84,238,7739,8061,3909,0,2,59,61
2325,CHITTOOR,Yadamari,DASARAPALLE,142,2,193,337,39,1,32,72,48,3193,102,2693,5988,2330,28,1,23,52
2326,CHITTOOR,Yadamari,JANGALAPALLE,151,7,219,377,64,2,39,105,100,3741,210,2593,6544,4494,9,1,11,21
2327,CHITTOOR,Yadamari,KASIRALLA,97,0,314,411,11,0,69,80,70,609,0,4171,4780,2812,1,0,18,19
2328,CHITTOOR,Yadamari,KEENATAMPALLE,182,118,166,466,67,5,56,128,90,3629,102,4340,8071,3292,9,0,24,33
2329,CHITTOOR,Yadamari,KONAPALLE,329,23,168,520,89,0,20,109,99,6450,0,1705,8155,5080,35,0,9,44
2330,CHITTOOR,Yadamari,KOTALAM,203,0,289,492,50,0,37,87,61,3431,0,1838,5269,2953,21,0,6,27
2331,CHITTOOR,Yadamari,KRISHNAMPALLE,67,1,282,350,37,0,50,87,82,1979,0,4104,6083,2966,5,0,16,21
2332,CHITTOOR,Yadamari,KUKKALAPALLE,36,0,257,293,0,0,0,0,0,0,0,0,0,0,0,0,0,0
2333,CHITTOOR,Yadamari,MADHAVARAM,253,34,277,564,35,0,12,47,43,570,0,268,838,529,0,0,0,0
2334,CHITTOOR,Yadamari,MADIREDDIPALLE,119,50,322,491,42,13,75,130,115,3507,988,6088,10583,4856,21,7,39,67
2335,CHITTOOR,Yadamari,MORDHANAPALLE,30,10,368,408,5,0,50,55,48,100,0,2395,2495,1369,0,0,8,8
2336,CHITTOOR,Yadamari,OTEVARIPALLE,146,37,161,344,34,11,16,61,58,1624,612,690,2926,1527,4,1,0,5
2337,CHITTOOR,Yadamari,PATRAPALLE,218,42,132,392,0,0,4,4,3,0,0,102,102,30,0,0,0,0
2338,CHITTOOR,Yadamari,PERIYAMBADI,153,0,146,299,49,0,17,66,55,1914,0,738,2652,1976,9,0,2,11
2339,CHITTOOR,Yadamari,SIDDAREDDIPALLE,65,6,261,332,7,1,75,83,62,582,112,4792,5486,2896,2,1,15,18
2340,CHITTOOR,Yadamari,THELLARALLAPALLE,37,8,433,478,7,1,123,131,120,283,20,6638,6941,4580,0,0,20,20
2341,CHITTOOR,Yadamari,VARADARAJULAPALLE,246,4,233,483,20,0,40,60,47,1194,0,2187,3381,1475,7,0,11,18
2342,CHITTOOR,Yadamari,VARIGAPALLE,92,1,301,394,0,0,0,0,0,0,0,0,0,0,0,0,0,0
2343,CHITTOOR,Yadamari,YADAMARI,160,6,492,658,21,0,27,48,36,692,0,953,1645,857,1,0,3,4
2344,CHITTOOR,Yerpedu,AMANDURU,18,18,299,335,2,2,91,95,73,40,19,1446,1505,956,0,0,0,0
2345,CHITTOOR,Yerpedu,AMDURU,266,19,89,374,232,12,58,302,312,12112,409,973,13494,8763,44,0,0,44
2346,CHITTOOR,Yerpedu,ANJIMEDU,145,103,349,597,57,15,84,156,139,1217,670,4084,5971,4181,2,1,8,11
2347,CHITTOOR,Yerpedu,BANDARU PALLI,32,35,551,618,0,0,111,111,91,0,0,578,578,387,0,0,0,0
2348,CHITTOOR,Yerpedu,CHELLUR,162,0,197,359,1,0,20,21,17,4,0,184,188,130,0,0,0,0
2349,CHITTOOR,Yerpedu,CHENNAM PALLE,23,5,134,162,1,0,66,67,64,2,0,1763,1765,1353,0,0,0,0
2350,CHITTOOR,Yerpedu,CHINDEPALLE,140,43,62,245,76,1,21,98,92,1987,43,527,2557,1790,1,0,0,1
2351,CHITTOOR,Yerpedu,CHINTALAPALEM,106,55,193,354,29,3,128,160,146,432,150,6963,7545,4359,0,0,17,17
2352,CHITTOOR,Yerpedu,GOVINDAVARAM,15,65,116,196,0,15,8,23,17,0,501,149,650,267,0,0,0,0
2353,CHITTOOR,Yerpedu,GUDIMALLAM,58,6,130,194,42,1,79,122,121,3101,89,5359,8549,6809,13,0,27,40
2354,CHITTOOR,Yerpedu,GUNDALA KANDRIGA @K.C.K,52,88,183,323,5,6,55,66,57,70,31,962,1063,647,0,0,0,0
2355,CHITTOOR,Yerpedu,ISUKATHAGELI,45,11,304,360,22,0,74,96,98,525,0,1976,2501,2003,0,0,0,0
2356,CHITTOOR,Yerpedu,JANGALA PALLI,29,14,122,165,1,0,58,59,64,57,0,1705,1762,1308,0,0,2,2
2357,CHITTOOR,Yerpedu,KANDADU,175,205,508,888,101,32,188,321,349,4045,930,7543,12518,9206,10,0,12,22
2358,CHITTOOR,Yerpedu,KOBAKA,174,13,63,250,70,0,0,70,72,1955,0,0,1955,1608,0,0,0,0
2359,CHITTOOR,Yerpedu,KOTHA VEERA PURAM,52,3,138,193,1,3,83,87,92,20,40,3088,3148,2547,0,0,3,3
2360,CHITTOOR,Yerpedu,KUKKALAGUNTA,6,214,54,274,4,81,19,104,95,99,2788,550,3437,1883,0,2,1,3
2361,CHITTOOR,Yerpedu,MADHAVAMALA,93,19,102,214,46,3,27,76,76,809,18,597,1424,1052,0,0,1,1
2362,CHITTOOR,Yerpedu,MADIBAKA,62,77,277,416,22,0,38,60,62,483,0,959,1442,782,0,0,3,3
2363,CHITTOOR,Yerpedu,MAHANKALI DEVIPUTTUR,126,32,195,353,69,0,0,69,73,1454,0,0,1454,884,1,0,0,1
2364,CHITTOOR,Yerpedu,MANNASAMUDRAM,76,25,200,301,52,10,50,112,115,1628,389,658,2675,1900,0,0,0,0
2365,CHITTOOR,Yerpedu,MARRIMANDA,72,31,130,233,0,0,0,0,0,0,0,0,0,0,0,0,0,0
2366,CHITTOOR,Yerpedu,MERLAPAKA,205,9,222,436,34,1,55,90,80,1773,7,912,2692,2010,9,0,1,10
2367,CHITTOOR,Yerpedu,MODUGULAPALEM,100,16,176,292,5,0,5,10,5,87,0,30,117,56,0,0,0,0
2368,CHITTOOR,Yerpedu,MUNGALAPALEM,108,3,144,255,21,0,55,76,37,157,0,951,1108,451,0,0,0,0
2369,CHITTOOR,Yerpedu,MUSALIPEDU,120,221,244,585,46,85,118,249,236,505,4061,3409,7975,5778,0,11,3,14
2370,CHITTOOR,Yerpedu,NACHANERI,61,5,294,360,18,0,191,209,220,492,0,4733,5225,3926,0,0,3,3
2371,CHITTOOR,Yerpedu,PAGALI,41,16,198,255,15,0,129,144,142,772,0,6788,7560,3839,2,0,23,25
2372,CHITTOOR,Yerpedu,PALLAM,222,47,345,614,61,10,151,222,207,2840,259,5996,9095,6007,5,0,4,9
2373,CHITTOOR,Yerpedu,PANGURU,255,27,251,533,87,2,46,135,98,3885,10,865,4760,3346,9,0,0,9
2374,CHITTOOR,Yerpedu,PAPANAIDUPET,28,2,268,298,0,0,4,4,4,0,0,158,158,84,0,0,1,1
2375,CHITTOOR,Yerpedu,PATHAVEERA PURAM,23,17,297,337,13,0,156,169,171,281,0,9405,9686,9014,0,0,25,25
2376,CHITTOOR,Yerpedu,PENNAGADAM,73,32,81,186,55,23,0,78,76,4237,1416,0,5653,4207,22,8,0,30
2377,CHITTOOR,Yerpedu,PENUMALLAM,36,13,147,196,0,0,48,48,54,0,0,2157,2157,1970,0,0,1,1
2378,CHITTOOR,Yerpedu,RAJALA PALEM,84,37,121,242,61,7,92,160,166,1664,88,3979,5731,3737,1,0,3,4
2379,CHITTOOR,Yerpedu,RAVILLAVARI KANDRIGA,52,71,239,362,16,5,53,74,65,589,42,2737,3368,2541,0,0,4,4
2380,CHITTOOR,Yerpedu,SARASWATHI KANDRIGA,4,1,370,375,2,0,140,142,121,25,0,2638,2663,1658,0,0,0,0
2381,CHITTOOR,Yerpedu,SEETHARAMPETA,41,5,187,233,16,2,64,82,73,421,52,923,1396,999,0,0,0,0
2382,CHITTOOR,Yerpedu,VIKRUTHAMALA,134,14,334,482,60,7,106,173,154,926,114,2044,3084,2319,0,0,0,0
2383,CHITTOOR,Yerpedu,YERPEDU,96,7,178,281,4,0,3,7,7,8,0,33,41,32,0,0,0,0
2384,CHITTOOR,Yerravaripalem,BODEVANDLAPALLE,148,4,483,635,41,0,65,106,93,3003,0,3225,6228,2838,18,0,10,28
2385,CHITTOOR,Yerravaripalem,CHERUKUVARIPALLE,25,31,525,581,1,4,114,119,106,108,307,6608,7023,3282,1,2,32,35
2386,CHITTOOR,Yerravaripalem,CHINTHAGUNTA,118,45,515,678,67,22,229,318,204,5260,1600,17640,24500,9850,33,10,108,151
2387,CHITTOOR,Yerravaripalem,ELLAMANDA,261,120,914,1295,78,27,235,340,283,3977,1725,15750,21452,10195,15,8,74,97
2388,CHITTOOR,Yerravaripalem,KAMALAYYAGARIPALLE,84,7,530,621,42,0,145,187,166,2516,0,8819,11335,5728,11,0,24,35
2389,CHITTOOR,Yerravaripalem,KOTAKADAPALLI,30,106,454,590,0,4,99,103,88,0,180,4479,4659,2327,0,0,16,16
2390,CHITTOOR,Yerravaripalem,KURPARTHIVARIPALLE,98,15,431,544,44,4,139,187,151,2418,430,10012,12860,6587,12,3,49,64
2391,CHITTOOR,Yerravaripalem,NERABYLU,285,80,902,1267,91,5,107,203,168,3769,624,7820,12213,6076,14,3,39,56
2392,CHITTOOR,Yerravaripalem,UDAYAMANIKYAM,126,56,500,682,15,12,75,102,82,1472,888,5906,8266,3965,11,5,28,44
2393,CHITTOOR,Yerravaripalem,USTIKAYALAPENTA,145,41,627,813,45,13,105,163,114,1741,813,4905,7459,3405,5,4,14,23
2394,CHITTOOR,Yerravaripalem,V.R.AGRAHARAM,24,13,261,298,3,0,51,54,39,162,0,1318,1480,702,0,0,3,3
2395,CHITTOOR,Yerravaripalem,YERRAVARIPALEM,30,20,519,569,1,7,176,184,158,100,797,15054,15951,7748,1,6,96,103
2396,CUDDAPAH,Atlur,ATLUR,484,3,915,1402,184,0,285,469,504,12397,0,8808,21205,13109,33,0,7,40
2397,CUDDAPAH,Atlur,KAMALAKUR,46,5,531,582,12,0,343,355,409,624,0,12416,13040,9487,0,0,4,4
2398,CUDDAPAH,Atlur,KAMASAMUDRAM,115,6,315,436,66,2,186,254,270,4019,139,8575,12733,8837,10,1,11,22
2399,CUDDAPAH,Atlur,KONDUR,234,104,650,988,82,3,247,332,344,3503,59,10330,13892,9568,4,0,17,21
2400,CUDDAPAH,Atlur,KUMBAGIRI,1035,53,388,1476,369,12,145,526,539,18922,191,11304,30417,20359,56,0,48,104
2401,CUDDAPAH,Atlur,MADAPUR,208,1,715,924,63,0,275,338,319,1596,0,8642,10238,6644,0,0,5,5
2402,CUDDAPAH,Atlur,MANYAMVARIPALLI,201,1,312,514,181,1,258,440,449,15566,101,19774,35441,23666,71,1,78,150
2403,CUDDAPAH,Atlur,MUTHUKUR,220,1,483,704,135,1,308,444,471,6954,12,14732,21698,13821,12,0,29,41
2404,CUDDAPAH,Atlur,REDDYPALLI,71,3,304,378,67,0,215,282,299,5697,0,12122,17819,12051,29,0,14,43
2405,CUDDAPAH,Atlur,THAMBALLAGONDI,289,58,424,771,133,27,166,326,338,3893,696,7570,12159,8611,1,0,23,24
2406,CUDDAPAH,Atlur,VARIKUNTA,115,3,189,307,0,0,0,0,0,0,0,0,0,0,0,0,0,0
2407,CUDDAPAH,Atlur,VEMALUR,155,5,246,406,63,0,151,214,200,2066,0,8091,10157,5882,0,0,26,26
2408,CUDDAPAH,B Kodur,B.KODUR,533,58,1506,2097,228,30,1019,1277,1281,13792,2268,76640,92700,53847,37,10,276,323
2409,CUDDAPAH,B Kodur,ITHRAMPET,290,21,707,1018,148,8,384,540,538,8424,490,24148,33062,19286,23,1,52,76
2410,CUDDAPAH,B Kodur,MEKAVARIPALLI,353,24,720,1097,164,15,398,577,586,11540,1242,24286,37068,20719,44,5,59,108
2411,CUDDAPAH,B Kodur,MUNNELLI,536,20,1532,2088,159,0,570,729,776,9716,0,34105,43821,26188,27,0,79,106
2412,CUDDAPAH,B Kodur,PAPANAPALLI,1,0,138,139,0,0,114,114,104,0,0,8898,8898,5384,0,0,29,29
2413,CUDDAPAH,B Kodur,PAYALAKUNTA,8,0,471,479,2,0,395,397,397,58,0,27453,27511,15916,0,0,106,106
2414,CUDDAPAH,B Kodur,PEDULLAPALLI,83,0,248,331,46,0,151,197,197,2174,0,9426,11600,7025,7,0,22,29
2415,CUDDAPAH,B Kodur,PRABHALAVEEDU,61,10,417,488,44,3,285,332,347,3328,44,15150,18522,10638,15,0,39,54
2416,CUDDAPAH,B Kodur,THANGEDUPALLE,45,0,143,188,27,0,79,106,112,1679,0,5171,6850,5959,2,0,9,11
2417,CUDDAPAH,B Kodur,THUMMALAPALLE,142,0,321,463,112,0,252,364,390,7414,0,16127,23541,14990,22,0,55,77
2418,CUDDAPAH,Badvel,ANANTHARAJUPURAM,349,35,938,1322,137,18,446,601,578,8201,1505,26147,35853,23064,21,6,41,68
2419,CUDDAPAH,Badvel,BADVEL,483,38,1165,1686,0,0,0,0,0,0,0,0,0,0,0,0,0,0
2420,CUDDAPAH,Badvel,CHENNAMPALLE,456,21,741,1218,0,0,0,0,0,0,0,0,0,0,0,0,0,0
2421,CUDDAPAH,Badvel,CHINTALACHERUVU,203,1,803,1007,88,1,346,435,449,2795,97,19748,22640,17340,1,0,67,68
2422,CUDDAPAH,Badvel,ETHIRAJUPALLE,0,0,1,1,0,0,0,0,0,0,0,0,0,0,0,0,0,0
2423,CUDDAPAH,Badvel,GUNTHAPALLE,493,6,422,921,0,0,0,0,0,0,0,0,0,0,0,0,0,0
2424,CUDDAPAH,Badvel,KONASAMUDRAM,230,3,339,572,305,5,415,725,772,31737,591,43157,75485,46314,242,5,313,560
2425,CUDDAPAH,Badvel,KONGALAVEEDU,141,0,335,476,61,0,220,281,271,3379,0,9887,13266,9184,11,0,31,42
2426,CUDDAPAH,Badvel,PUTTAYAPALLI,96,7,489,592,42,0,241,283,310,3102,0,11896,14998,10218,13,0,21,34
2427,CUDDAPAH,Badvel,RAJUPALEM,81,20,452,553,39,2,273,314,314,1180,40,11027,12247,9135,0,0,13,13
2428,CUDDAPAH,Badvel,THIPPANAPALLI,132,3,378,513,68,3,229,300,336,4302,277,14995,19574,12323,13,2,42,57
2429,CUDDAPAH,Badvel,TIRUVENGALAPURAM,264,71,941,1276,108,7,467,582,612,6687,328,27759,34774,23086,20,0,51,71
2430,CUDDAPAH,Badvel,VANAMPULA,268,7,550,825,164,0,314,478,559,10191,0,24197,34388,20754,45,0,97,142
2431,CUDDAPAH,Badvel,VEERAPALLE,350,60,199,609,235,34,146,415,496,20366,3256,12926,36548,21067,95,21,79,195
2432,CUDDAPAH,Brahmamgarimattam,DIGUVA NELATUR,180,0,629,809,86,0,346,432,484,4773,0,20190,24963,17109,12,0,50,62
2433,CUDDAPAH,Brahmamgarimattam,DIRASAVANCHA,517,1,1259,1777,221,2,684,907,914,13105,101,36207,49413,33924,37,0,67,104
2434,CUDDAPAH,Brahmamgarimattam,GODLAVEEDU,193,8,328,529,128,1,214,343,363,9680,35,13010,22725,14844,34,0,20,54
2435,CUDDAPAH,Brahmamgarimattam,JANGAMRAJUPALLE,52,0,180,232,7,0,37,44,38,143,0,1601,1744,779,0,0,3,3
2436,CUDDAPAH,Brahmamgarimattam,MALLEPALLE,224,27,985,1236,122,9,624,755,778,8646,998,44257,53901,31422,44,5,180,229
2437,CUDDAPAH,Brahmamgarimattam,MUDUMALA,230,10,435,675,108,5,221,334,323,5833,247,12465,18545,11015,20,1,42,63
2438,CUDDAPAH,Brahmamgarimattam,PULUGURALLAPALLE,623,1,1116,1740,247,0,376,623,533,6707,0,15533,22240,12339,3,0,21,24
2439,CUDDAPAH,Brahmamgarimattam,REKALAKUNTA,372,61,740,1173,114,3,202,319,306,4919,206,12175,17300,12903,11,0,37,48
2440,CUDDAPAH,Brahmamgarimattam,SOMIREDDIPALLE,902,109,1625,2636,192,23,484,699,668,4595,1066,12837,18498,12055,0,1,2,3
2441,CUDDAPAH,Brahmamgarimattam,T.SOUDARAVARIPALLE,209,1,584,794,107,1,362,470,532,7191,25,22547,29763,19060,20,0,48,68
2442,CUDDAPAH,Brahmamgarimattam,TOTLAPALLI,235,2,373,610,142,0,237,379,420,9431,0,15280,24711,16314,35,0,37,72
2443,CUDDAPAH,Chakrayapet,ADDALAMARRI,18,0,219,237,0,0,11,11,9,0,0,156,156,69,0,0,0,0
2444,CUDDAPAH,Chakrayapet,CHAKRAYAPET,156,6,964,1126,78,0,429,507,491,3791,0,31230,35021,19056,12,0,92,104
2445,CUDDAPAH,Chakrayapet,CHILEKAMPALLE,385,3,855,1243,32,0,42,74,48,187,0,705,892,415,0,0,0,0
2446,CUDDAPAH,Chakrayapet,ERRABOMMANAPALLE,89,31,548,668,13,0,146,159,146,412,0,3014,3426,1717,0,0,0,0
2447,CUDDAPAH,Chakrayapet,GADDAMVARIPALLI,1,3,785,789,0,3,202,205,160,0,16,12194,12210,6339,0,0,52,52
2448,CUDDAPAH,Chakrayapet,GANDIKOVVUR,76,3,334,413,40,0,103,143,125,2281,0,7056,9337,4634,5,0,26,31
2449,CUDDAPAH,Chakrayapet,GANGARAPUVANDLAPALLI,4,2,495,501,0,0,210,210,191,0,0,11146,11146,5731,0,0,24,24
2450,CUDDAPAH,Chakrayapet,K.RAJUPALLE,59,5,274,338,34,3,166,203,185,1898,198,9803,11899,6463,2,0,11,13
2451,CUDDAPAH,Chakrayapet,K.YERRAGUDI,39,211,335,585,20,101,185,306,325,1244,7668,11655,20567,11039,2,35,30,67
2452,CUDDAPAH,Chakrayapet,KALLURUPALLI,44,147,479,670,10,0,156,166,147,483,0,8019,8502,4308,0,0,20,20
2453,CUDDAPAH,Chakrayapet,KUMARAKALVA,238,0,395,633,102,0,161,263,245,4599,0,3758,8357,4781,4,0,0,4
2454,CUDDAPAH,Chakrayapet,KUPPAM,80,116,1024,1220,0,33,457,490,476,0,1716,24162,25878,14880,0,2,11,13
2455,CUDDAPAH,Chakrayapet,MAHADEVAPALLE,165,0,365,530,68,0,177,245,227,2775,0,9875,12650,6541,1,0,12,13
2456,CUDDAPAH,Chakrayapet,MARELLAMADAKA,123,3,381,507,17,0,104,121,109,235,0,2814,3049,1678,0,0,1,1
2457,CUDDAPAH,Chakrayapet,NERSUPALLE,83,1,801,885,42,0,225,267,214,943,0,13832,14775,7993,1,0,64,65
2458,CUDDAPAH,Chakrayapet,SURABHI,202,9,1687,1898,91,1,420,512,470,6270,67,26661,32998,17745,14,0,47,61
2459,CUDDAPAH,Chapad,ALLADUPALLE,187,1,206,394,82,0,15,97,96,2193,0,407,2600,1837,1,0,0,1
2460,CUDDAPAH,Chapad,ANNAVARAM,56,0,378,434,37,0,193,230,238,1109,0,6805,7914,4719,0,0,3,3
2461,CUDDAPAH,Chapad,AYYAVARIPALLI,71,0,258,329,34,0,147,181,187,1407,0,6318,7725,4915,2,0,5,7
2462,CUDDAPAH,Chapad,BHADRIPALLE,133,20,309,462,13,11,213,237,234,176,581,5884,6641,4119,0,2,1,3
2463,CUDDAPAH,Chapad,CHAPAD,165,1,142,308,93,0,50,143,150,4153,0,2294,6447,4463,7,0,2,9
2464,CUDDAPAH,Chapad,CHINNAGURAVALUR,118,0,227,345,84,0,29,113,148,6487,0,1815,8302,4843,30,0,5,35
2465,CUDDAPAH,Chapad,CHIYYAPADU,260,19,587,866,129,1,234,364,385,5230,29,7612,12871,8798,4,0,7,11
2466,CUDDAPAH,Chapad,KHADERPALLI,3,3,336,342,1,2,142,145,130,11,46,3473,3530,2594,0,0,0,0
2467,CUDDAPAH,Chapad,KUTCHUPAPA,13,0,147,160,10,0,115,125,141,356,0,4375,4731,3691,0,0,1,1
2468,CUDDAPAH,Chapad,LAKSHMIPETA,70,8,496,574,32,5,259,296,300,1908,73,6675,8656,5415,2,0,0,2
2469,CUDDAPAH,Chapad,MADUR,236,8,360,604,91,0,161,252,261,1798,0,3868,5666,3249,0,0,2,2
2470,CUDDAPAH,Chapad,N.OBAYAPALLI,331,5,482,818,210,3,167,380,439,9173,130,3787,13090,7844,26,0,0,26
2471,CUDDAPAH,Chapad,NAGULAPALLI,1,15,219,235,1,9,135,145,146,104,330,6111,6545,5045,1,0,1,2
2472,CUDDAPAH,Chapad,PALLAVOLU,257,2,260,519,98,0,105,203,193,2863,0,3156,6019,4804,1,0,0,1
2473,CUDDAPAH,Chapad,PEDDAGURAVALUR,115,41,306,462,65,2,116,183,175,2655,40,4248,6943,4743,5,0,4,9
2474,CUDDAPAH,Chapad,RAJUVARIPETA,9,25,128,162,0,21,98,119,105,0,878,4941,5819,3436,0,0,2,2
2475,CUDDAPAH,Chapad,SEETHARAMPURAM,3,0,269,272,1,0,120,121,129,5,0,1276,1281,887,0,0,0,0
2476,CUDDAPAH,Chapad,SIDDAREDDIPALLE,78,3,230,311,59,3,141,203,210,2225,112,5103,7440,4430,4,0,5,9
2477,CUDDAPAH,Chapad,SOMAPURAM,190,0,389,579,111,0,224,335,348,2738,0,9620,12358,7338,1,0,16,17
2478,CUDDAPAH,Chapad,T.O.PALLI,36,5,243,284,26,0,171,197,209,809,0,8999,9808,5289,0,0,14,14
2479,CUDDAPAH,Chapad,VEDURUR,251,4,570,825,72,0,120,192,196,3130,0,2482,5612,4515,4,0,0,4
2480,CUDDAPAH,Chapad,VISWANATHAPURAM,30,0,324,354,12,0,153,165,158,812,0,8560,9372,6885,3,0,17,20
2481,CUDDAPAH,Chennur,BALASINGANA PALLE,201,175,354,730,75,21,117,213,207,4181,2522,6489,13192,8892,4,8,14,26
2482,CUDDAPAH,Chennur,BAYANA PALLE,142,11,990,1143,59,2,249,310,294,1267,78,2727,4072,2966,0,0,0,0
2483,CUDDAPAH,Chennur,CHENNUR,1050,117,2107,3274,62,11,274,347,342,1517,207,5296,7020,5492,0,0,1,1
2484,CUDDAPAH,Chennur,CHINAMACHUPALLE,192,15,289,496,1,0,0,1,1,70,0,0,70,18,0,0,0,0
2485,CUDDAPAH,Chennur,GURRAMPADU,329,4,416,749,196,0,151,347,336,6213,0,3888,10101,6657,1,0,0,1
2486,CUDDAPAH,Chennur,KOKKARAYA PALLE,88,1,206,295,65,0,135,200,228,1985,0,4366,6351,4164,0,0,0,0
2487,CUDDAPAH,Chennur,MUNDLAPALLE,99,0,188,287,76,0,118,194,196,3610,0,4038,7648,4564,3,0,1,4
2488,CUDDAPAH,Chennur,PALAMPALLI,151,3,11,165,89,2,0,91,87,2232,66,0,2298,1365,0,0,0,0
2489,CUDDAPAH,Chennur,PUTLAMPALLI,30,2,1,33,0,0,0,0,0,0,0,0,0,0,0,0,0,0
2490,CUDDAPAH,Chennur,RACHINNAYAPALLE,83,0,214,297,59,0,119,178,181,2577,0,3893,6470,4263,0,0,1,1
2491,CUDDAPAH,Chennur,RAMANA PALLE,254,6,645,905,77,1,158,236,254,1474,14,2573,4061,2704,0,0,0,0
2492,CUDDAPAH,Chennur,RAMARAJUPALLI,262,5,85,352,115,0,6,121,120,2799,0,155,2954,2593,0,0,0,0
2493,CUDDAPAH,Chennur,SIVALAPALLE,95,4,163,262,80,2,136,218,227,4383,10,7310,11703,7555,9,0,8,17
2494,CUDDAPAH,Chennur,UPPARAPALLE,166,5,342,513,148,6,303,457,505,5458,186,14004,19648,12806,0,0,11,11
2495,CUDDAPAH,Chinnamandem,BONAMALA,91,0,465,556,13,0,136,149,135,527,0,8238,8765,6947,2,0,29,31
2496,CUDDAPAH,Chinnamandem,C.POLIMERAPALLI,14,0,517,531,4,0,207,211,194,321,0,9743,10064,6729,2,0,19,21
2497,CUDDAPAH,Chinnamandem,CHINNA NARSU PALLI,42,7,452,501,15,1,200,216,197,467,24,11245,11736,7357,0,0,22,22
2498,CUDDAPAH,Chinnamandem,CHINNAMANDEM,159,6,919,1084,66,1,128,195,166,2013,12,8419,10444,7285,1,0,24,25
2499,CUDDAPAH,Chinnamandem,DEVAGUDIPALLI,204,2,670,876,61,0,172,233,211,3441,0,8915,12356,8144,11,0,20,31
2500,CUDDAPAH,Chinnamandem,DIGUVAGOTTIVEEDU,173,8,901,1082,71,3,313,387,285,4903,114,19107,24124,12135,14,0,37,51
2501,CUDDAPAH,Chinnamandem,KALIBANDA,144,2,482,628,52,0,132,184,168,3504,0,8022,11526,6754,18,0,26,44
2502,CUDDAPAH,Chinnamandem,KESAPURAM,164,0,904,1068,10,0,187,197,166,105,0,7474,7579,4449,0,0,9,9
2503,CUDDAPAH,Chinnamandem,KOTHAPALLI,91,35,1037,1163,32,4,78,114,95,1104,84,1429,2617,1994,1,0,0,1
2504,CUDDAPAH,Chinnamandem,MALLUR,131,50,828,1009,46,16,158,220,162,1197,800,9412,11409,6714,0,1,13,14
2505,CUDDAPAH,Chinnamandem,PARAMATIKONA,527,2,1857,2386,128,0,432,560,512,8433,0,28689,37122,25836,40,0,119,159
2506,CUDDAPAH,Chinnamandem,TSAKIBANDA,64,24,1261,1349,22,11,284,317,285,825,465,13025,14315,8816,0,2,21,23
2507,CUDDAPAH,Chinnamandem,VANDADI,110,31,554,695,39,4,163,206,166,2365,396,12251,15012,8052,8,3,53,64
2508,CUDDAPAH,Chintha Kommadinne,BUGGALAPALLE,306,17,531,854,70,0,11,81,74,885,0,430,1315,925,0,0,0,0
2509,CUDDAPAH,Chintha Kommadinne,BUSIREDDIPALLE,79,0,502,581,29,0,246,275,268,603,0,14127,14730,10857,0,0,35,35
2510,CUDDAPAH,Chintha Kommadinne,CHINTAKOMMADINNE,116,11,1181,1308,34,2,375,411,377,1060,40,16926,18026,14504,2,0,21,23
2511,CUDDAPAH,Chintha Kommadinne,IPPEPENTA,265,256,967,1488,41,30,161,232,209,789,1342,10007,12138,8965,0,8,40,48
2512,CUDDAPAH,Chintha Kommadinne,KAMMAVARIPALLE,70,0,367,437,40,0,173,213,199,2243,0,8707,10950,7370,5,0,28,33
2513,CUDDAPAH,Chintha Kommadinne,KOLUMULAPALLE,7,30,443,480,4,2,170,176,155,292,3,15271,15566,10797,2,0,104,106
2514,CUDDAPAH,Chintha Kommadinne,KOPPARTHI,226,3,887,1116,54,0,246,300,309,1044,0,12369,13413,10607,0,0,31,31
2515,CUDDAPAH,Chintha Kommadinne,KRISHNAPURAM,148,2,155,305,0,0,0,0,0,0,0,0,0,0,0,0,0,0
2516,CUDDAPAH,Chintha Kommadinne,MAMILLAPALLE,167,123,345,635,1,0,4,5,5,42,0,96,138,138,0,0,0,0
2517,CUDDAPAH,Chintha Kommadinne,PABBAPURAM,98,0,210,308,47,0,123,170,181,2022,0,8034,10056,8604,3,0,17,20
2518,CUDDAPAH,Chintha Kommadinne,PAPASAHEBPET,54,0,343,397,1,0,161,162,137,60,0,14950,15010,9279,0,0,103,103
2519,CUDDAPAH,Chintha Kommadinne,RASOOLPALLI,138,2,513,653,65,1,287,353,323,3075,75,17301,20451,14949,3,0,52,55
2520,CUDDAPAH,Chintha Kommadinne,THADIGOTLA,165,4,381,550,69,0,140,209,214,4803,0,10392,15195,10468,22,0,29,51
2521,CUDDAPAH,Chintha Kommadinne,UTUKUR,218,7,425,650,2,0,0,2,0,52,0,0,52,0,0,0,0,0
2522,CUDDAPAH,Chitvel,C.M.RACHAPALLI,121,133,220,474,65,15,28,108,85,2944,352,717,4013,2582,2,0,0,2
2523,CUDDAPAH,Chitvel,CHERLOPALLI,75,69,245,389,32,43,54,129,110,2505,2881,3155,8541,5009,19,15,12,46
2524,CUDDAPAH,Chitvel,CHITVEL,380,58,797,1235,132,0,91,223,208,4924,0,2519,7443,5591,9,0,2,11
2525,CUDDAPAH,Chitvel,Chitvel,20,5,565,590,0,0,0,0,0,0,0,0,0,0,0,0,0,0
2526,CUDDAPAH,Chitvel,DEVAMACHUPALLE,157,11,284,452,73,3,55,131,105,4805,134,2549,7488,4050,15,0,5,20
2527,CUDDAPAH,Chitvel,K.S.AGRAHARAM,238,1,417,656,63,0,96,159,141,3641,0,2259,5900,4132,11,0,0,11
2528,CUDDAPAH,Chitvel,K.V.R.R.PURAM,132,10,23,165,31,2,2,35,28,1679,30,28,1737,829,4,0,0,4
2529,CUDDAPAH,Chitvel,KAMPASAMUDRAM,174,47,291,512,78,14,81,173,158,3861,810,3895,8566,7006,9,0,5,14
2530,CUDDAPAH,Chitvel,MAHARAJAPURAM,24,121,180,325,13,2,46,61,59,312,40,773,1125,810,0,0,0,0
2531,CUDDAPAH,Chitvel,MALEMARPURAM,211,34,530,775,75,1,125,201,165,1380,18,6339,7737,4509,0,0,14,14
2532,CUDDAPAH,Chitvel,MARGOPALLI,17,48,223,288,9,1,63,73,74,692,98,3883,4673,3111,2,0,10,12
2533,CUDDAPAH,Chitvel,MYLAPALLE,368,76,547,991,114,6,130,250,195,4842,97,5699,10638,6763,13,0,4,17
2534,CUDDAPAH,Chitvel,NAGAVARAM,240,5,662,907,95,0,139,234,186,4316,0,7773,12089,8485,6,0,27,33
2535,CUDDAPAH,Chitvel,NAGIRIPADU,445,152,741,1338,67,4,42,113,85,2619,242,2872,5733,4049,6,0,7,13
2536,CUDDAPAH,Chitvel,NAKKALAPALLI,68,16,266,350,18,6,18,42,37,1457,48,389,1894,1058,6,0,0,6
2537,CUDDAPAH,Chitvel,NETHIVARIPALLI,44,54,115,213,3,3,0,6,6,48,18,0,66,48,0,0,0,0
2538,CUDDAPAH,Chitvel,POLLOPALLI,150,46,459,655,36,0,154,190,153,1423,0,6502,7925,4284,2,0,17,19
2539,CUDDAPAH,Chitvel,RAJUKUNTA,155,91,360,606,78,10,131,219,184,5130,571,5127,10828,6764,17,2,1,20
2540,CUDDAPAH,Chitvel,THIMMAIAHGARIPALLI,241,0,194,435,99,0,51,150,128,3933,0,1288,5221,2880,9,0,4,13
2541,CUDDAPAH,Chitvel,THIMMAIAHPALEM,64,45,368,477,3,0,40,43,31,121,0,3088,3209,1319,0,0,16,16
2542,CUDDAPAH,Chitvel,THUMMAKONDA,81,36,286,403,31,0,111,142,145,1920,0,6728,8648,7024,2,0,19,21
2543,CUDDAPAH,Duvvur,ANNAPUSASTRULAPALLE,18,0,303,321,0,0,131,131,125,0,0,4566,4566,2439,0,0,1,1
2544,CUDDAPAH,Duvvur,BAYANAPALLI,46,0,141,187,30,0,86,116,117,1231,0,4916,6147,3279,3,0,10,13
2545,CUDDAPAH,Duvvur,BHIMUNIPADU,237,2,181,420,124,0,100,224,224,7015,0,5291,12306,7641,18,0,9,27
2546,CUDDAPAH,Duvvur,BUKKAYAPALLI,90,0,278,368,31,0,133,164,174,510,0,5329,5839,3443,0,0,6,6
2547,CUDDAPAH,Duvvur,CHINNA SINGANAPALLE,249,0,593,842,47,0,62,109,100,1654,0,1684,3338,1777,3,0,0,3
2548,CUDDAPAH,Duvvur,CHINTAKUNTA,286,7,1143,1436,36,1,196,233,206,598,26,7665,8289,4174,0,0,14,14
2549,CUDDAPAH,Duvvur,DUVVUR,399,10,851,1260,117,5,296,418,402,6460,222,19114,25796,17782,22,1,59,82
2550,CUDDAPAH,Duvvur,GUDIPADU,233,3,884,1120,6,0,14,20,18,120,0,275,395,175,0,0,0,0
2551,CUDDAPAH,Duvvur,IDAMADAKA,63,0,251,314,35,0,33,68,70,1107,0,879,1986,1006,0,0,0,0
2552,CUDDAPAH,Duvvur,JILLELA,130,1,411,542,45,0,63,108,102,2191,0,2330,4521,2494,6,0,2,8
2553,CUDDAPAH,Duvvur,KANGUDUR,62,20,438,520,22,2,63,87,72,472,30,2064,2566,1205,1,0,6,7
2554,CUDDAPAH,Duvvur,KRISHNAMPALLI,115,7,569,691,38,4,89,131,124,1389,196,4987,6572,3516,2,0,15,17
2555,CUDDAPAH,Duvvur,MACHANAPALLE,144,1,204,349,92,0,90,182,183,2279,0,1375,3654,2216,1,0,0,1
2556,CUDDAPAH,Duvvur,MADIREPALLI,130,5,498,633,27,0,172,199,201,1444,0,6950,8394,4491,3,0,10,13
2557,CUDDAPAH,Duvvur,MOODINDLAPALLI,25,4,439,468,8,2,52,62,51,86,46,775,907,423,0,0,0,0
2558,CUDDAPAH,Duvvur,NARAYANAPALLI,54,1,236,291,11,0,71,82,78,174,0,1223,1397,761,0,0,0,0
2559,CUDDAPAH,Duvvur,NEELAPURAM,101,34,540,675,46,0,165,211,200,1411,0,5415,6826,3394,0,0,2,2
2560,CUDDAPAH,Duvvur,NELATURU,137,1,231,369,64,0,101,165,166,1913,0,5466,7379,4109,3,0,20,23
2561,CUDDAPAH,Duvvur,PEDDA JONNAVARAM,221,6,321,548,118,4,162,284,272,4688,66,4824,9578,5607,10,0,2,12
2562,CUDDAPAH,Duvvur,SALLABASAYAPALLE,142,3,261,406,38,0,80,118,114,845,0,1860,2705,1445,0,0,2,2
2563,CUDDAPAH,Duvvur,SANJEEVAREDDIPALLI,4,13,313,330,0,0,43,43,42,0,0,734,734,417,0,0,0,0
2564,CUDDAPAH,Duvvur,VENKUPALLE,104,31,419,554,67,7,186,260,253,3568,80,8758,12406,6780,7,0,14,21
2565,CUDDAPAH,Duvvur,YERRABALLI,40,0,419,459,29,0,221,250,270,1468,0,13636,15104,8278,2,0,40,42
2566,CUDDAPAH,Galiveedu,ARAVEEDU,318,44,1465,1827,80,19,298,397,336,1506,825,13350,15681,9451,0,2,35,37
2567,CUDDAPAH,Galiveedu,BOREDDYGARIPALLE,5,72,458,535,1,25,178,204,171,6,166,11620,11792,7566,0,0,49,49
2568,CUDDAPAH,Galiveedu,C.C.PALLI,143,28,945,1116,109,22,623,754,650,9141,1433,51572,62146,30891,52,4,269,325
2569,CUDDAPAH,Galiveedu,EGUVAGOTTIVEDU,49,23,582,654,19,10,282,311,261,456,80,17567,18103,9929,1,0,62,63
2570,CUDDAPAH,Galiveedu,GALIVEEDU,373,68,1980,2421,70,17,306,393,334,4118,297,14726,19141,13782,14,0,28,42
2571,CUDDAPAH,Galiveedu,GARUGUPALLI,55,12,624,691,34,0,173,207,174,1582,0,4311,5893,3360,3,0,0,3
2572,CUDDAPAH,Galiveedu,GOPANAPALLI,138,1,744,883,85,0,200,285,242,7939,0,10985,18924,10227,44,0,32,76
2573,CUDDAPAH,Galiveedu,GORANCHERUVU,89,37,1295,1421,34,15,411,460,424,2473,870,26610,29953,16781,11,1,65,77
2574,CUDDAPAH,Galiveedu,GUNDLACHERUVU,67,4,668,739,27,2,267,296,247,1356,69,15428,16853,9198,4,0,51,55
2575,CUDDAPAH,Galiveedu,KORLAKUNTA,71,0,931,1002,34,0,337,371,326,1087,0,22364,23451,12664,0,0,73,73
2576,CUDDAPAH,Galiveedu,NOOLIVEEDU,116,39,1697,1852,44,10,514,568,449,2151,831,37889,40871,23585,5,5,136,146
2577,CUDDAPAH,Galiveedu,PANDIKUNTA,70,233,347,650,39,102,133,274,214,2801,3987,9669,16457,8499,12,3,46,61
2578,CUDDAPAH,Galiveedu,PULI KUNTA,78,4,414,496,24,1,215,240,192,940,11,14093,15044,8232,2,0,47,49
2579,CUDDAPAH,Galiveedu,PYARAMPALLI,39,9,560,608,18,5,272,295,237,374,355,12723,13452,8014,0,2,9,11
2580,CUDDAPAH,Galiveedu,TALAMUDIPI,30,0,232,262,12,0,115,127,118,1014,0,9318,10332,5463,4,0,45,49
2581,CUDDAPAH,Galiveedu,THUMUKUNTA,50,83,981,1114,10,26,300,336,308,113,1149,17638,18900,9658,0,5,54,59
2582,CUDDAPAH,Galiveedu,VELIGALLU,64,133,378,575,32,85,114,231,202,1397,3893,5488,10778,5681,3,8,11,22
2583,CUDDAPAH,Gopavaram,BETHAYAPALLE,519,53,554,1126,233,30,231,494,520,19560,2676,17807,40043,26099,100,15,72,187
2584,CUDDAPAH,Gopavaram,BODDECHERLA,178,8,269,455,0,0,15,15,16,0,0,163,163,120,0,0,0,0
2585,CUDDAPAH,Gopavaram,BRAHMANAPALLE,133,1,418,552,107,0,348,455,470,9060,0,28480,37540,24798,44,0,125,169
2586,CUDDAPAH,Gopavaram,GOPAVARAMA,190,41,975,1206,90,11,633,734,769,6769,906,49511,57186,36946,30,2,195,227
2587,CUDDAPAH,Gopavaram,KALVAPALLE,188,12,856,1056,95,0,479,574,565,7902,0,39371,47273,31805,37,0,158,195
2588,CUDDAPAH,Gopavaram,MADAKALAVARIPALLE,1281,52,1257,2590,0,0,0,0,0,0,0,0,0,0,0,0,0,0
2589,CUDDAPAH,Gopavaram,RACHAYAPET,455,4,587,1046,220,2,304,526,488,15611,160,25508,41279,26475,64,1,132,197
2590,CUDDAPAH,Gopavaram,S.RAMAPURAM,468,1,245,714,211,0,166,377,382,14765,0,13142,27907,18582,62,0,45,107
2591,CUDDAPAH,Gopavaram,T.SANDRAPALLE,302,105,406,813,199,57,293,549,509,17438,4560,27493,49491,34244,119,29,201,349
2592,CUDDAPAH,Jammalamadugu,AMBHAVARAM,159,185,382,726,68,24,140,232,220,1898,349,4459,6706,5095,3,0,3,6
2593,CUDDAPAH,Jammalamadugu,DEVAGUDI,254,43,849,1146,54,14,173,241,238,1204,634,5181,7019,5869,1,2,13,16
2594,CUDDAPAH,Jammalamadugu,DHARMAPURAM,16,11,254,281,0,6,127,133,143,0,120,7336,7456,5868,0,0,21,21
2595,CUDDAPAH,Jammalamadugu,GANDIKOTA,47,2,384,433,15,0,211,226,234,309,0,5786,6095,4719,0,0,1,1
2596,CUDDAPAH,Jammalamadugu,GORIGANUR,309,9,495,813,126,1,146,273,278,2861,12,6487,9360,7817,0,0,8,8
2597,CUDDAPAH,Jammalamadugu,GUDEMCHERUVU,350,6,400,756,49,0,102,151,156,1918,0,2806,4724,4147,3,0,0,3
2598,CUDDAPAH,Jammalamadugu,MORAGUDI,223,4,536,763,77,0,93,170,166,4321,0,5227,9548,9017,0,0,3,3
2599,CUDDAPAH,Jammalamadugu,P.BOMMEPALLI,122,93,466,681,39,47,199,285,286,1596,1638,5776,9010,6414,3,2,0,5
2600,CUDDAPAH,Jammalamadugu,P.SUGUMANCHIPALLE,37,1,128,166,7,0,23,30,27,50,0,179,229,189,0,0,0,0
2601,CUDDAPAH,Jammalamadugu,PEDDANDLUR,121,106,620,847,55,49,253,357,366,2660,963,4652,8275,5972,3,0,0,3
2602,CUDDAPAH,Jammalamadugu,PONNATHOTA,329,18,480,827,2,3,142,147,146,27,40,2219,2286,1478,0,0,0,0
2603,CUDDAPAH,Jammalamadugu,S.UPPALAPADU,240,17,469,726,80,1,201,282,268,3986,20,14162,18168,12075,4,0,50,54
2604,CUDDAPAH,Jammalamadugu,SESHAREDDYPALLI,103,0,109,212,48,0,15,63,57,2567,0,495,3062,1853,6,0,0,6
2605,CUDDAPAH,Jammalamadugu,SUNNAPURALLAPALLE,268,66,461,795,112,18,171,301,323,4699,482,10024,15205,10272,7,0,27,34
2606,CUDDAPAH,Kalasapadu,CHENNUPALLE,56,0,450,506,4,0,221,225,203,29,0,5035,5064,2653,0,0,0,0
2607,CUDDAPAH,Kalasapadu,CHINTHALAPALLI,247,5,694,946,58,0,155,213,225,846,0,3033,3879,2607,0,0,0,0
2608,CUDDAPAH,Kalasapadu,E.RAMAPURAM,246,41,1239,1526,158,12,823,993,1130,12494,729,45804,59027,31445,51,3,95,149
2609,CUDDAPAH,Kalasapadu,EGUVA THANBALLAPALLE,319,7,709,1035,222,2,436,660,671,12237,68,12923,25228,15052,24,0,3,27
2610,CUDDAPAH,Kalasapadu,KALASAPADU,49,19,1054,1122,12,9,589,610,635,271,216,23790,24277,14694,0,0,22,22
2611,CUDDAPAH,Kalasapadu,LINGAREDDYPALLI,179,1,753,933,118,0,348,466,484,2863,0,8944,11807,6016,0,0,1,1
2612,CUDDAPAH,Kalasapadu,MAHANANDIPALLE,159,0,592,751,58,0,143,201,201,2087,0,2154,4241,2368,2,0,0,2
2613,CUDDAPAH,Kalasapadu,PENDLIMARRI,152,0,321,473,92,0,223,315,321,3092,0,9106,12198,6691,0,0,11,11
2614,CUDDAPAH,Kalasapadu,PIDUGUPALLE,245,1,399,645,159,0,265,424,484,9772,0,17735,27507,15582,22,0,52,74
2615,CUDDAPAH,Kalasapadu,PULLAREDDIPALLE,305,0,335,640,196,0,212,408,429,8104,0,13465,21569,14566,6,0,45,51
2616,CUDDAPAH,Kalasapadu,RAJUPALEM,148,3,546,697,90,3,361,454,516,5193,101,11721,17015,9594,13,0,0,13
2617,CUDDAPAH,Kalasapadu,SANKAVARM,73,7,284,364,55,1,196,252,270,3029,120,10701,13850,8885,8,1,25,34
2618,CUDDAPAH,Kalasapadu,THELLAPADU,257,19,629,905,205,14,467,686,800,11363,608,23855,35826,19517,22,0,29,51
2619,CUDDAPAH,Kamalapuram,CHADIPIRALLA,635,7,460,1102,179,1,132,312,311,6628,54,5381,12063,8515,3,0,2,5
2620,CUDDAPAH,Kamalapuram,CHINNACHEPALLE,160,30,635,825,47,18,198,263,234,1790,567,9087,11444,6523,2,1,21,24
2621,CUDDAPAH,Kamalapuram,DEVARAJU PALLE,251,1,539,791,74,0,55,129,134,2397,0,1065,3462,2090,2,0,0,2
2622,CUDDAPAH,Kamalapuram,GANGAVARAM,269,0,377,646,162,0,92,254,275,3825,0,731,4556,3273,0,0,0,0
2623,CUDDAPAH,Kamalapuram,GOPULA PURAM,69,0,298,367,33,0,131,164,181,1045,0,6990,8035,6046,0,0,11,11
2624,CUDDAPAH,Kamalapuram,JAMBAPURAM,74,0,453,527,39,0,275,314,327,2341,0,17573,19914,12003,6,0,32,38
2625,CUDDAPAH,Kamalapuram,KAMALAPURAM,1579,22,2185,3786,577,2,760,1339,1316,19732,82,25051,44865,35749,8,0,11,19
2626,CUDDAPAH,Kamalapuram,KOKATAM,187,2,1098,1287,86,0,409,495,479,2399,0,9218,11617,6518,1,0,0,1
2627,CUDDAPAH,Kamalapuram,KONDAYA PALLE,110,0,266,376,39,0,114,153,176,1979,0,5474,7453,5607,2,0,9,11
2628,CUDDAPAH,Kamalapuram,LETHAPALLE,85,1,349,435,41,0,125,166,188,3232,0,7280,10512,6442,13,0,20,33
2629,CUDDAPAH,Kamalapuram,NALLINGAYAPALLE,65,0,533,598,27,0,288,315,331,1199,0,21026,22225,15420,2,0,87,89
2630,CUDDAPAH,Kamalapuram,PACHIKALA PADU,6,0,77,83,6,0,52,58,55,406,0,4371,4777,3178,2,0,26,28
2631,CUDDAPAH,Kamalapuram,PANDILLAPALLE,110,13,291,414,55,8,146,209,216,2955,493,8929,12377,9536,6,1,20,27
2632,CUDDAPAH,Kamalapuram,PEDDACHAPALLE,237,3,513,753,117,2,119,238,255,6577,44,3845,10466,8316,13,0,1,14
2633,CUDDAPAH,Kamalapuram,PODADURTHI,117,1,512,630,42,0,155,197,196,1055,0,9590,10645,5477,1,0,31,32
2634,CUDDAPAH,Kamalapuram,RAJUPALEM,18,1,478,497,10,1,187,198,179,711,77,11400,12188,7464,2,0,26,28
2635,CUDDAPAH,Kamalapuram,SAMBATUR,141,0,348,489,87,0,119,206,184,4837,0,3238,8075,4406,3,0,0,3
2636,CUDDAPAH,Kamalapuram,YELLAREDDI PALLI,235,1,930,1166,66,0,250,316,377,4394,0,11441,15835,9254,13,0,27,40
2637,CUDDAPAH,Kamalapuram,YERRAGUDIPADU,169,1,507,677,92,0,248,340,368,3925,0,9639,13564,10599,2,0,0,2
2638,CUDDAPAH,Khajipet,APPANAPALLI,265,0,934,1199,167,0,473,640,688,8612,0,15636,24248,13184,23,0,20,43
2639,CUDDAPAH,Khajipet,B.KOTHAPALLI,45,5,565,615,26,0,377,403,426,1013,0,11164,12177,6994,0,0,0,0
2640,CUDDAPAH,Khajipet,BHUMAYAPALLE,310,26,1167,1503,59,1,321,381,375,1737,11,9035,10783,6136,0,0,0,0
2641,CUDDAPAH,Khajipet,CHEMULLAPALLE,336,1,344,681,152,0,163,315,319,4404,0,4380,8784,5715,0,0,0,0
2642,CUDDAPAH,Khajipet,CHENNAMUKKAPALLE,192,37,450,679,65,15,142,222,213,2311,620,6687,9618,5999,0,0,11,11
2643,CUDDAPAH,Khajipet,DUMPALAGATTU,133,0,352,485,29,0,167,196,196,755,0,9310,10065,6546,1,0,17,18
2644,CUDDAPAH,Khajipet,ETURU,183,0,198,381,63,0,101,164,171,2054,0,5186,7240,4463,0,0,14,14
2645,CUDDAPAH,Khajipet,KHAJIPET,675,51,1869,2595,50,3,482,535,516,1361,92,22701,24154,17165,1,0,32,33
2646,CUDDAPAH,Khajipet,KOMMALURU,32,0,203,235,21,0,105,126,106,879,0,2516,3395,1836,0,0,0,0
2647,CUDDAPAH,Khajipet,KOTHAPETA,72,9,454,535,33,2,243,278,284,1152,55,6512,7719,5479,1,0,4,5
2648,CUDDAPAH,Khajipet,KUNAVARIPALLE,146,3,301,450,67,1,200,268,329,2130,13,7908,10051,6160,2,0,2,4
2649,CUDDAPAH,Khajipet,MIDUTHUR,294,1,348,643,161,0,167,328,331,6742,0,5781,12523,7492,4,0,6,10
2650,CUDDAPAH,Khajipet,NAGASANIPALLE,101,67,290,458,0,0,6,6,5,0,0,120,120,50,0,0,0,0
2651,CUDDAPAH,Khajipet,PATHUR,124,0,559,683,66,0,238,304,343,2472,0,9836,12308,8237,3,0,21,24
2652,CUDDAPAH,Khajipet,PULLUR,20,3,494,517,1,0,33,34,30,20,0,525,545,307,0,0,0,0
2653,CUDDAPAH,Khajipet,PULLUR(H),463,51,954,1468,226,0,188,414,413,15065,0,9003,24068,15315,54,0,23,77
2654,CUDDAPAH,Khajipet,RAVULAPALLE,190,0,430,620,63,0,208,271,265,2671,0,7092,9763,6044,4,0,6,10
2655,CUDDAPAH,Khajipet,SANNAPALLI,4,0,167,171,0,0,91,91,88,0,0,5694,5694,3349,0,0,20,20
2656,CUDDAPAH,Khajipet,THAVVARIPALLE,54,18,343,415,43,15,289,347,382,2167,694,10763,13624,7410,2,1,0,3
2657,CUDDAPAH,Khajipet,THRIPURAVARAM,132,0,192,324,77,0,118,195,203,3605,0,4350,7955,4793,3,0,0,3
2658,CUDDAPAH,Khajipet,THUDUMULADINNE,208,0,439,647,129,0,263,392,403,5239,0,8038,13277,7766,10,0,2,12
2659,CUDDAPAH,Kodur,ANANTHARAJUPET,258,153,567,978,48,37,176,261,221,1902,972,7872,10746,6400,7,1,22,30
2660,CUDDAPAH,Kodur,BOJJAVARIPALLI,60,132,253,445,36,98,118,252,248,2988,5958,7789,16735,12509,8,0,18,26
2661,CUDDAPAH,Kodur,CHIYYAVARAM,163,161,470,794,31,5,99,135,119,941,155,4740,5836,4505,1,0,8,9
2662,CUDDAPAH,Kodur,GANGARAJUPODU,29,46,190,265,1,5,21,27,28,51,100,603,754,454,0,0,0,0
2663,CUDDAPAH,Kodur,K.BUDUGUNTAPALLI,398,131,341,870,144,42,86,272,269,7533,1070,2304,10907,7665,23,1,2,26
2664,CUDDAPAH,Kodur,KODUR,169,49,186,404,6,0,2,8,7,39,0,162,201,93,0,0,1,1
2665,CUDDAPAH,Kodur,KUKKALADODDI,14,124,31,169,0,5,1,6,5,0,94,20,114,60,0,0,0,0
2666,CUDDAPAH,Kodur,MADHAVARAMPODU,234,8,194,436,100,0,89,189,166,3543,0,2724,6267,4507,1,0,1,2
2667,CUDDAPAH,Kodur,MYSOORAVARIPALLI,101,5,167,273,2,0,1,3,2,41,0,17,58,21,0,0,0,0
2668,CUDDAPAH,Kodur,OBANAPALLE,586,109,400,1095,189,1,19,209,207,5433,26,326,5785,4000,1,0,0,1
2669,CUDDAPAH,Kodur,RAGHAVARAJUPURAM,188,15,244,447,10,0,112,122,91,489,0,6059,6548,3873,0,0,4,4
2670,CUDDAPAH,Kodur,REDDIVARIPALLI,211,169,285,665,105,18,37,160,144,4759,279,884,5922,4162,9,0,0,9
2671,CUDDAPAH,Kodur,S.KOTHAPALLI,50,0,201,251,13,0,80,93,96,551,0,3068,3619,3437,0,0,2,2
2672,CUDDAPAH,Kodur,SETTI GUNTA,216,166,365,747,10,0,4,14,13,116,0,80,196,117,0,0,0,0
2673,CUDDAPAH,Kodur,SURAPURAJUPALLI,10,57,86,153,0,9,5,14,11,0,175,62,237,119,0,0,0,0
2674,CUDDAPAH,Kodur,THIMMISETTIPALLI,95,4,149,248,60,0,94,154,151,4416,0,4453,8869,5127,15,0,4,19
2675,CUDDAPAH,Kodur,UPPARAPALLE,185,4,87,276,67,0,1,68,60,2070,0,6,2076,1095,0,0,0,0
2676,CUDDAPAH,Kodur,URLAGATTAPODU,286,40,287,613,12,3,130,145,133,208,24,5110,5342,4511,0,0,2,2
2677,CUDDAPAH,Kodur,V.P.R.KANDRIKA,212,135,318,665,68,37,82,187,183,4651,1018,2314,7983,4602,17,0,1,18
2678,CUDDAPAH,Kodur,VELLELAVARI KHANDRIKA,143,100,247,490,75,10,130,215,185,5357,112,9341,14810,8747,20,0,37,57
2679,CUDDAPAH,Kodur,VENKATAREDDIPALLI,144,82,132,358,16,40,0,56,54,216,1034,0,1250,687,0,1,0,1
2680,CUDDAPAH,Kondapuram,B.KOTTALAPALLE,8,0,443,451,0,0,100,100,89,0,0,1867,1867,1078,0,0,0,0
2681,CUDDAPAH,Kondapuram,BEDADURU,93,0,304,397,38,0,180,218,254,1641,0,8148,9789,6587,4,0,12,16
2682,CUDDAPAH,Kondapuram,BUKKAPATNAM,66,31,116,213,21,1,63,85,88,518,6,2765,3289,2734,0,0,1,1
2683,CUDDAPAH,Kondapuram,BURUJUPALLI,6,0,145,151,1,0,23,24,19,4,0,216,220,130,0,0,0,0
2684,CUDDAPAH,Kondapuram,CHAMALURU,77,2,224,303,37,0,54,91,93,1568,0,3079,4647,4213,1,0,4,5
2685,CUDDAPAH,Kondapuram,CHOWTAPALLI,87,49,414,550,14,3,86,103,109,204,12,932,1148,945,0,0,0,0
2686,CUDDAPAH,Kondapuram,DATHAPURAM,157,1,135,293,1,0,0,1,1,5,0,0,5,5,0,0,0,0
2687,CUDDAPAH,Kondapuram,DOBBUDU PALLE,43,0,677,720,6,0,123,129,131,62,0,8972,9034,6434,0,0,46,46
2688,CUDDAPAH,Kondapuram,ETURU,170,0,296,466,0,0,0,0,0,0,0,0,0,0,0,0,0,0
2689,CUDDAPAH,Kondapuram,K. BOMMEPALLI,50,3,166,219,2,0,22,24,21,8,0,134,142,81,0,0,0,0
2690,CUDDAPAH,Kondapuram,K. SUGUMANHIPALLI,135,11,229,375,45,1,44,90,82,1470,7,1900,3377,2715,0,0,3,3
2691,CUDDAPAH,Kondapuram,KODURU,200,0,427,627,20,0,35,55,59,207,0,525,732,496,0,0,0,0
2692,CUDDAPAH,Kondapuram,KONAVARIPALLI,1,0,131,132,0,0,38,38,33,0,0,440,440,244,0,0,0,0
2693,CUDDAPAH,Kondapuram,KONDAPURAM,375,28,822,1225,143,2,222,367,367,4760,32,5919,10711,8376,8,0,1,9
2694,CUDDAPAH,Kondapuram,LAVANURU,140,1,468,609,24,0,113,137,140,1768,0,8232,10000,8992,6,0,33,39
2695,CUDDAPAH,Kondapuram,MUCHUMARRI,77,6,143,226,0,0,0,0,0,0,0,0,0,0,0,0,0,0
2696,CUDDAPAH,Kondapuram,NEDARAPETA,0,1,144,145,0,0,83,83,78,0,0,4885,4885,3745,0,0,13,13
2697,CUDDAPAH,Kondapuram,OBANNAPETA,127,18,516,661,55,0,139,194,187,1964,0,6114,8078,5002,1,0,3,4
2698,CUDDAPAH,Kondapuram,P.ANANTHAPURAM,22,8,181,211,18,7,78,103,102,1062,536,4996,6594,3623,2,2,29,33
2699,CUDDAPAH,Kondapuram,POTTIPADU,70,19,347,436,31,0,93,124,118,641,0,4109,4750,3186,1,0,15,16
2700,CUDDAPAH,Kondapuram,RAMIREDDIPALLI,1,0,132,133,0,0,0,0,0,0,0,0,0,0,0,0,0,0
2701,CUDDAPAH,Kondapuram,REGADDIPALLY,40,1,432,473,0,0,10,10,3,0,0,186,186,50,0,0,0,0
2702,CUDDAPAH,Kondapuram,S.TIMMAPURAM,155,7,251,413,77,2,71,150,140,5897,95,4832,10824,6508,28,0,19,47
2703,CUDDAPAH,Kondapuram,SANKEPALLI,27,6,317,350,2,3,98,103,102,40,33,4218,4291,3188,0,0,3,3
2704,CUDDAPAH,Kondapuram,THALLAPRODDATUR,195,0,822,1017,0,0,0,0,0,0,0,0,0,0,0,0,0,0
2705,CUDDAPAH,Kondapuram,VENKAIAH KALVA,101,5,334,440,21,2,24,47,40,209,15,390,614,340,0,0,0,0
2706,CUDDAPAH,Kondapuram,YENAMALACHINTALA,79,5,444,528,39,1,94,134,137,848,4,1736,2588,1715,0,0,0,0
2707,CUDDAPAH,Kondapuram,YERRAGUDI,119,0,224,343,69,0,89,158,155,3821,0,4719,8540,5422,7,0,7,14
2708,CUDDAPAH,Lakkireddipalle,ANANTHAPURAM,17,0,621,638,1,0,257,258,225,64,0,17629,17693,11779,0,0,58,58
2709,CUDDAPAH,Lakkireddipalle,B.YERRAGUDI,154,15,753,922,63,1,220,284,284,3144,36,12874,16054,9237,5,0,43,48
2710,CUDDAPAH,Lakkireddipalle,CHOWTAPALLI,133,3,390,526,54,0,153,207,189,2948,0,9263,12211,7449,4,0,20,24
2711,CUDDAPAH,Lakkireddipalle,DAPPEPALLE,149,4,1307,1460,38,0,425,463,391,2543,0,26311,28854,16933,10,0,70,80
2712,CUDDAPAH,Lakkireddipalle,DINNEPADU,151,2,831,984,71,0,201,272,234,3250,0,8938,12188,7497,8,0,22,30
2713,CUDDAPAH,Lakkireddipalle,KAKULAVARAM,38,1,260,299,25,0,143,168,142,920,0,11044,11964,6665,0,0,52,52
2714,CUDDAPAH,Lakkireddipalle,KASTHURIRAJUGARIPALLI,166,0,912,1078,98,0,289,387,348,7206,0,15099,22305,13419,23,0,25,48
2715,CUDDAPAH,Lakkireddipalle,KONAMPETA,17,0,848,865,0,0,280,280,239,0,0,17085,17085,10329,0,0,66,66
2716,CUDDAPAH,Lakkireddipalle,KURNUTHALA,26,3,990,1019,4,1,523,528,513,120,70,31849,32039,17441,0,0,81,81
2717,CUDDAPAH,Lakkireddipalle,LAKKIREDDIPALLI,490,24,2206,2720,105,1,325,431,368,4697,3,17248,21948,15049,4,0,27,31
2718,CUDDAPAH,Lakkireddipalle,MADDIREVULA,256,5,577,838,90,1,195,286,267,4962,41,10529,15532,9280,8,0,21,29
2719,CUDDAPAH,Lakkireddipalle,PALEM GOLLAPALLI,90,2,417,509,20,0,199,219,204,1645,0,13599,15244,7540,10,0,53,63
2720,CUDDAPAH,Lakkireddipalle,PANDILLAPALLI,101,3,1062,1166,33,0,603,636,564,1730,0,39021,40751,22681,5,0,92,97
2721,CUDDAPAH,Lingala,AKKULAGARI PALLE,14,5,334,353,4,1,104,109,99,276,122,7944,8342,6004,1,1,33,35
2722,CUDDAPAH,Lingala,AMBAKAPALLE,13,1,340,354,9,0,197,206,222,871,0,18414,19285,11582,5,0,104,109
2723,CUDDAPAH,Lingala,BONALA,153,0,897,1050,16,0,79,95,91,269,0,1820,2089,1428,0,0,0,0
2724,CUDDAPAH,Lingala,CHINNAKUDALA,51,4,471,526,24,2,176,202,203,605,53,14556,15214,12477,0,0,87,87
2725,CUDDAPAH,Lingala,DONDLAVAGU,59,4,415,478,37,2,143,182,172,2752,143,10018,12913,9842,12,1,54,67
2726,CUDDAPAH,Lingala,GUNAKANEPALLE,44,0,294,338,3,0,111,114,121,20,0,3361,3381,3102,0,0,0,0
2727,CUDDAPAH,Lingala,IPPATLA,116,1,360,477,42,1,114,157,144,2189,20,9030,11239,9194,8,0,44,52
2728,CUDDAPAH,Lingala,KAMASAMUDRAM,178,18,782,978,65,2,226,293,268,2731,32,13594,16357,10773,1,0,55,56
2729,CUDDAPAH,Lingala,KARNAPAPAYAPALLE,3,0,366,369,0,0,2,2,2,0,0,13,13,8,0,0,0,0
2730,CUDDAPAH,Lingala,KOMMANUTHLA,79,1,1295,1375,3,0,259,262,241,60,0,16371,16431,8341,0,0,83,83
2731,CUDDAPAH,Lingala,LINGALA,160,1,630,791,47,1,209,257,228,3168,92,17154,20414,13649,18,0,112,130
2732,CUDDAPAH,Lingala,LOPATNUTHALA,15,1,426,442,0,1,138,139,138,0,104,10022,10126,6499,0,1,39,40
2733,CUDDAPAH,Lingala,MURARICHINTALA,74,46,698,818,38,17,282,337,331,2392,1053,16642,20087,12150,7,4,66,77
2734,CUDDAPAH,Lingala,PARNAPALLI,211,2,937,1150,109,0,226,335,334,4878,0,14585,19463,15980,13,0,71,84
2735,CUDDAPAH,Lingala,PEDDAKUDALA,132,0,346,478,55,0,127,182,187,4557,0,12678,17235,15366,32,0,93,125
2736,CUDDAPAH,Lingala,VELIDANDLA,77,0,355,432,54,0,229,283,286,4327,0,17470,21797,13352,21,0,82,103
2737,CUDDAPAH,Muddanur,BONDALAKUNTA,89,4,443,536,58,0,218,276,304,4115,0,14603,18718,15742,14,0,31,45
2738,CUDDAPAH,Muddanur,CHINNADUDYALA,10,2,311,323,2,0,86,88,71,66,0,4518,4584,3004,0,0,12,12
2739,CUDDAPAH,Muddanur,CHINTAKUNTA,123,0,298,421,51,0,45,96,106,1158,0,628,1786,1193,0,0,0,0
2740,CUDDAPAH,Muddanur,DENAPALLE,71,3,535,609,47,2,311,360,377,2268,75,24872,27215,17629,7,0,114,121
2741,CUDDAPAH,Muddanur,K.THIMMAPURAM,72,21,402,495,25,4,136,165,178,535,198,5562,6295,5795,0,0,6,6
2742,CUDDAPAH,Muddanur,KOLAVALI,135,10,302,447,26,3,125,154,156,2151,141,8200,10492,7783,13,0,32,45
2743,CUDDAPAH,Muddanur,KORRAPADU,40,1,602,643,14,0,230,244,240,745,0,12662,13407,12506,2,0,28,30
2744,CUDDAPAH,Muddanur,MADANNAGARIPALLE,6,2,310,318,3,2,220,225,222,220,117,19926,20263,11641,1,0,117,118
2745,CUDDAPAH,Muddanur,MANGAPATNAM,54,1,322,377,19,1,140,160,152,298,27,8328,8653,7117,0,0,20,20
2746,CUDDAPAH,Muddanur,MUDDANUR,355,65,749,1169,78,1,271,350,344,4644,86,18787,23517,22947,19,0,64,83
2747,CUDDAPAH,Muddanur,NALLABALLE,93,0,293,386,37,0,97,134,140,1215,0,5734,6949,5323,0,0,13,13
2748,CUDDAPAH,Muddanur,OBULAPURAM,52,3,197,252,35,2,139,176,184,1470,61,8603,10134,6928,1,0,10,11
2749,CUDDAPAH,Muddanur,PENIKALA PADU,302,1,537,840,76,0,135,211,199,3038,0,7606,10644,9212,1,0,11,12
2750,CUDDAPAH,Muddanur,R.G.PALLE,1,0,323,324,0,0,141,141,131,0,0,11441,11441,7959,0,0,35,35
2751,CUDDAPAH,Muddanur,SETTIVARI PALLE,100,61,467,628,48,36,208,292,292,1611,1890,14230,17731,12895,1,2,42,45
2752,CUDDAPAH,Muddanur,UPPALUR,29,3,565,597,14,2,307,323,340,258,72,14421,14751,9357,0,0,35,35
2753,CUDDAPAH,Muddanur,VELPUCHERLA,91,2,470,563,33,0,201,234,230,2385,0,19148,21533,14623,13,0,128,141
2754,CUDDAPAH,Muddanur,YAMAVARAM,221,37,367,625,111,22,164,297,286,7955,1807,13260,23022,18503,36,7,69,112
2755,CUDDAPAH,Mylavaram,BESTHAVEMULA,109,7,519,635,77,1,277,355,368,3101,54,10332,13487,7907,2,0,2,4
2756,CUDDAPAH,Mylavaram,CHINNA KOMERLA,133,1,688,822,94,0,122,216,209,2206,0,6364,8570,5405,0,0,15,15
2757,CUDDAPAH,Mylavaram,DHODIUM,88,4,593,685,15,0,150,165,162,556,0,5681,6237,4391,0,0,4,4
2758,CUDDAPAH,Mylavaram,DOMMARA NANDYALA,91,0,488,579,31,0,84,115,111,213,0,804,1017,946,0,0,0,0
2759,CUDDAPAH,Mylavaram,KALLUTLA,69,4,412,485,33,0,180,213,217,1836,0,9957,11793,6776,2,0,20,22
2760,CUDDAPAH,Mylavaram,KARAMALAVANDLAPALLE,0,0,223,223,0,0,79,79,81,0,0,4825,4825,4537,0,0,5,5
2761,CUDDAPAH,Mylavaram,LINGAPURAM,35,93,71,199,26,69,34,129,135,1486,2667,1692,5845,5086,3,1,2,6
2762,CUDDAPAH,Mylavaram,MALAMEEDI KAMBALA DINNE,132,35,291,458,69,14,167,250,269,2205,182,6889,9276,6843,0,0,9,9
2763,CUDDAPAH,Mylavaram,MURAPANDI,154,52,257,463,112,41,148,301,335,4576,2735,6805,14116,9960,2,2,2,6
2764,CUDDAPAH,Mylavaram,MYLAVARAM,147,231,800,1178,5,12,203,220,220,114,99,8403,8616,8226,0,0,8,8
2765,CUDDAPAH,Mylavaram,NARJAMPALLI,3,26,264,293,0,17,172,189,196,0,423,7514,7937,6166,0,0,8,8
2766,CUDDAPAH,Mylavaram,NAWABPET,111,2,363,476,55,0,183,238,235,2653,0,8526,11179,10155,4,0,6,10
2767,CUDDAPAH,Mylavaram,PEDDAKOMERLA,88,1,444,533,53,0,161,214,203,1680,0,9685,11365,9084,2,0,29,31
2768,CUDDAPAH,Mylavaram,PONNAMPALLE,74,3,372,449,30,1,174,205,227,2089,105,7826,10020,5902,9,1,5,15
2769,CUDDAPAH,Mylavaram,RAMACHANDRAYAPALLI,129,29,313,471,70,2,136,208,208,2708,29,6248,8985,6947,5,0,7,12
2770,CUDDAPAH,Mylavaram,TALAMANCHIPATNAM,176,115,296,587,108,56,147,311,350,5005,2238,6909,14152,9893,9,4,11,24
2771,CUDDAPAH,Mylavaram,THORRI VEMULA,175,6,352,533,51,0,164,215,220,1340,0,5470,6810,4954,0,0,3,3
2772,CUDDAPAH,Mylavaram,VADDIRALA,250,23,740,1013,136,5,402,543,583,6592,407,17261,24260,16954,4,1,11,16
2773,CUDDAPAH,Mylavaram,VEPARALA,143,0,507,650,20,0,62,82,78,640,0,2818,3458,3345,0,0,1,1
2774,CUDDAPAH,Nandalur,ADAPUR,251,9,273,533,107,2,72,181,169,4963,85,2799,7847,5795,6,0,4,10
2775,CUDDAPAH,Nandalur,CHAPALAVARIPALLI,0,0,112,112,0,0,0,0,0,0,0,0,0,0,0,0,0,0
2776,CUDDAPAH,Nandalur,EGUVARACHAPALLE,6,0,117,123,0,0,0,0,0,0,0,0,0,0,0,0,0,0
2777,CUDDAPAH,Nandalur,KONAPURAM,213,14,176,403,61,9,45,115,115,3640,303,2687,6630,3903,7,0,6,13
2778,CUDDAPAH,Nandalur,KUNDA NELLORE,20,0,93,113,12,0,75,87,81,933,0,7050,7983,5390,5,0,51,56
2779,CUDDAPAH,Nandalur,LEBAKA,83,2,332,417,60,0,199,259,251,4590,0,12969,17559,11825,20,0,45,65
2780,CUDDAPAH,Nandalur,NAGIREDDIPALLE,507,40,727,1274,72,1,85,158,133,3481,55,4222,7758,6274,7,0,10,17
2781,CUDDAPAH,Nandalur,NALLATHIMMAYAPALLI,117,6,312,435,58,1,64,123,101,4992,120,5194,10306,6994,29,1,34,64
2782,CUDDAPAH,Nandalur,NANDALUR,251,48,325,624,94,7,29,130,125,5198,68,703,5969,5493,4,0,0,4
2783,CUDDAPAH,Nandalur,NOOKINENIPALLI,61,3,201,265,45,0,92,137,108,2671,0,4417,7088,3446,13,0,12,25
2784,CUDDAPAH,Nandalur,PATUR,257,86,866,1209,47,3,98,148,116,1266,18,4684,5968,3944,1,0,4,5
2785,CUDDAPAH,Nandalur,POTHAPI,112,1,284,397,63,0,137,200,161,3134,0,6750,9884,5792,7,0,26,33
2786,CUDDAPAH,Nandalur,T.V.PURAM,2,3,128,133,0,1,46,47,42,0,67,2806,2873,1941,0,0,3,3
2787,CUDDAPAH,Nandalur,TANGUTURU,179,30,836,1045,58,6,251,315,265,3129,405,14829,18363,12248,7,1,32,40
2788,CUDDAPAH,Nandalur,YERRACHERUVUPALLE,306,52,833,1191,68,5,160,233,220,4696,261,9432,14389,12346,22,1,33,56
2789,CUDDAPAH,Obulavaripalle,B.KAMMAPALLI,67,17,213,297,19,0,45,64,50,1411,0,2097,3508,2418,6,0,4,10
2790,CUDDAPAH,Obulavaripalle,B.P.RACHAPALLI,38,47,170,255,10,0,8,18,11,86,0,404,490,134,0,0,1,1
2791,CUDDAPAH,Obulavaripalle,BALIREDDIPALLI,157,184,228,569,40,27,60,127,129,1499,569,3900,5968,4635,2,0,16,18
2792,CUDDAPAH,Obulavaripalle,BOMMAVARAM,53,0,274,327,20,0,94,114,105,704,0,6072,6776,6061,0,0,21,21
2793,CUDDAPAH,Obulavaripalle,BOTIMEEDAPALLE,190,61,274,525,74,3,54,131,102,3634,102,1657,5393,3346,5,0,1,6
2794,CUDDAPAH,Obulavaripalle,CHENNARAJUPODU,236,29,951,1216,57,6,253,316,264,3022,35,13305,16362,11589,6,0,30,36
2795,CUDDAPAH,Obulavaripalle,CHINNA ORAMPADU,793,23,388,1204,140,2,10,152,138,9225,96,123,9444,6110,29,0,0,29
2796,CUDDAPAH,Obulavaripalle,CHINNAMPALLI,333,53,413,799,82,8,41,131,116,5986,527,1578,8091,4096,23,0,1,24
2797,CUDDAPAH,Obulavaripalle,G.V.PURAM,198,24,410,632,59,0,58,117,107,1983,0,2444,4427,2893,5,0,6,11
2798,CUDDAPAH,Obulavaripalle,GADDALAREVUPALLI,86,46,88,220,36,6,13,55,45,3148,36,966,4150,2018,20,0,4,24
2799,CUDDAPAH,Obulavaripalle,GADELA,218,127,274,619,75,14,6,95,85,2801,814,147,3762,2588,0,4,0,4
2800,CUDDAPAH,Obulavaripalle,GOBBURUVARIPALLE,73,3,207,283,6,0,63,69,75,279,0,4532,4811,3174,1,0,21,22
2801,CUDDAPAH,Obulavaripalle,GOVINDAMPALLE,125,0,295,420,72,0,86,158,149,4532,0,3403,7935,5811,19,0,6,25
2802,CUDDAPAH,Obulavaripalle,KORLAKUNTA,272,6,549,827,77,0,148,225,172,4657,0,8619,13276,9553,6,0,11,17
2803,CUDDAPAH,Obulavaripalle,MANGALAMPALLI,103,27,65,195,44,6,9,59,37,1140,63,168,1371,724,0,0,0,0
2804,CUDDAPAH,Obulavaripalle,MANGAMPETA,238,2,293,533,10,0,20,30,30,152,0,308,460,316,0,0,0,0
2805,CUDDAPAH,Obulavaripalle,MUKKAVARIPALLE,198,58,394,650,98,5,0,103,97,7307,133,0,7440,4895,31,0,0,31
2806,CUDDAPAH,Obulavaripalle,OBULAVARIPALLI,571,4,680,1255,48,0,77,125,106,1397,0,4071,5468,4084,0,0,7,7
2807,CUDDAPAH,Obulavaripalle,PEDDA  ORAMPADU,899,52,795,1746,120,3,169,292,227,4352,86,7110,11548,6895,13,0,9,22
2808,CUDDAPAH,Obulavaripalle,RALLACHERUVUPALLE,127,0,119,246,64,0,52,116,86,5713,0,4159,9872,5579,41,0,30,71
2809,CUDDAPAH,Obulavaripalle,YELLAYAPALLE,127,29,251,407,50,0,87,137,109,3011,0,5305,8316,6119,13,0,12,25
2810,CUDDAPAH,Obulavaripalle,YERRAGUNTAKOTA,324,74,1092,1490,96,2,221,319,234,3273,18,7024,10315,6786,2,0,12,14
2811,CUDDAPAH,Peddamudium,BALAPANA GUDUR,68,0,121,189,22,0,33,55,59,635,0,1519,2154,1251,0,0,3,3
2812,CUDDAPAH,Peddamudium,BHEEMAGUNDAM,75,0,315,390,18,0,110,128,136,124,0,993,1117,772,0,0,0,0
2813,CUDDAPAH,Peddamudium,BHUTAMAPURAM,27,1,238,266,17,0,95,112,101,463,0,2583,3046,1740,0,0,0,0
2814,CUDDAPAH,Peddamudium,BODITIPPANAPADU,97,1,244,342,52,0,112,164,172,2895,0,5321,8216,5160,6,0,6,12
2815,CUDDAPAH,Peddamudium,CHINAMUDIUM,145,0,202,347,6,0,0,6,6,120,0,0,120,59,0,0,0,0
2816,CUDDAPAH,Peddamudium,CHINNAPASUPULA,22,0,202,224,12,0,69,81,80,320,0,3445,3765,2307,0,0,3,3
2817,CUDDAPAH,Peddamudium,DIGUVA KALVATALA,119,0,352,471,81,0,158,239,285,3167,0,7106,10273,7047,2,0,7,9
2818,CUDDAPAH,Peddamudium,GUNDLAKUNTA,106,0,283,389,53,0,105,158,163,1300,0,5017,6317,4027,0,0,2,2
2819,CUDDAPAH,Peddamudium,J. KOTHAPALLE,24,2,252,278,19,0,61,80,76,1029,0,3909,4938,3309,1,0,10,11
2820,CUDDAPAH,Peddamudium,J.KOTTALAPALLI,172,1,347,520,43,0,43,86,72,1246,0,986,2232,1264,1,0,0,1
2821,CUDDAPAH,Peddamudium,JANGALAPALLI,91,2,465,558,61,0,210,271,267,2230,0,7353,9583,5996,1,0,1,2
2822,CUDDAPAH,Peddamudium,KONDASUNKESULA,136,2,641,779,21,0,187,208,221,790,0,5300,6090,4232,1,0,3,4
2823,CUDDAPAH,Peddamudium,MEDIDINNE,45,10,170,225,23,0,41,64,65,745,0,2016,2761,1808,0,0,1,1
2824,CUDDAPAH,Peddamudium,N.KOTTALAPALLI,21,0,212,233,16,0,96,112,88,716,0,4685,5401,2952,1,0,2,3
2825,CUDDAPAH,Peddamudium,NEMALLADINNE,135,2,396,533,23,0,150,173,160,511,0,5224,5735,4045,0,0,3,3
2826,CUDDAPAH,Peddamudium,PALUR,154,20,511,685,45,0,44,89,82,1247,0,1011,2258,1379,0,0,0,0
2827,CUDDAPAH,Peddamudium,PAPAYAPALLI,101,0,203,304,61,0,52,113,127,2046,0,1868,3914,3551,0,0,0,0
2828,CUDDAPAH,Peddamudium,PEDDA PASUPALLE,379,0,1164,1543,149,0,394,543,536,2058,0,13608,15666,11186,2,0,4,6
2829,CUDDAPAH,Peddamudium,PEDDAMUDIUM,55,0,620,675,24,0,214,238,230,595,0,7133,7728,5557,0,0,3,3
2830,CUDDAPAH,Peddamudium,SUDDAPALLI,159,3,531,693,74,0,212,286,287,4284,0,8766,13050,8288,6,0,4,10
2831,CUDDAPAH,Peddamudium,ULAVAPALLI,82,0,163,245,41,0,73,114,96,1578,0,4434,6012,3531,2,0,9,11
2832,CUDDAPAH,Peddamudium,UPPALUR,21,0,55,76,8,0,6,14,15,395,0,296,691,391,1,0,0,1
2833,CUDDAPAH,Penagaluru,ANATHAMPALLI,147,1,348,496,64,0,92,156,116,4360,0,4985,9345,5115,17,0,16,33
2834,CUDDAPAH,Penagaluru,ITIMARPURAM,288,74,455,817,138,35,167,340,311,6931,2075,7919,16925,10375,11,5,16,32
2835,CUDDAPAH,Penagaluru,KAKARLAVARIPALLE,160,0,163,323,99,0,80,179,166,7490,0,3432,10922,6865,32,0,3,35
2836,CUDDAPAH,Penagaluru,KATTAVARIPALLE,182,147,425,754,108,48,143,299,277,7910,1905,9921,19736,12595,32,4,44,80
2837,CUDDAPAH,Penagaluru,KOMANTHARAJAPURAM,84,4,206,294,49,0,55,104,96,3541,0,2887,6428,4398,20,0,12,32
2838,CUDDAPAH,Penagaluru,KONDUR,552,187,1116,1855,304,59,387,750,699,14863,1533,23735,40131,24687,42,3,96,141
2839,CUDDAPAH,Penagaluru,KOTHURU,16,12,87,115,0,0,0,0,0,0,0,0,0,0,0,0,0,0
2840,CUDDAPAH,Penagaluru,MUDRAPALLE,94,24,231,349,52,14,106,172,172,4138,1012,7590,12740,7139,20,6,20,46
2841,CUDDAPAH,Penagaluru,NALLAPUREDDIPALLE,212,7,298,517,133,0,119,252,232,9366,0,7113,16479,10443,27,0,15,42
2842,CUDDAPAH,Penagaluru,NARASINGARAJUPURAM,123,3,139,265,78,2,87,167,157,4138,105,4593,8836,6031,9,0,8,17
2843,CUDDAPAH,Penagaluru,NARAYANA NELLORE,50,33,323,406,28,14,86,128,119,1420,786,5086,7292,5258,2,3,24,29
2844,CUDDAPAH,Penagaluru,OBILI,182,0,226,408,91,0,86,177,169,3350,0,5955,9305,6506,6,0,23,29
2845,CUDDAPAH,Penagaluru,PENAGALUR,385,41,513,939,143,1,34,178,132,6787,94,547,7428,4486,13,0,0,13
2846,CUDDAPAH,Penagaluru,PONDALUR,4,1,314,319,1,1,114,116,94,26,6,5705,5737,3938,0,0,13,13
2847,CUDDAPAH,Penagaluru,SIDDAVARAM,205,1,328,534,112,1,138,251,221,6600,17,7216,13833,8630,21,0,14,35
2848,CUDDAPAH,Penagaluru,SINGANAMALA,4,0,228,232,0,0,4,4,2,0,0,29,29,19,0,0,0,0
2849,CUDDAPAH,Penagaluru,SINGAREDDIPALLE,215,0,214,429,121,0,89,210,190,5611,0,3545,9156,7329,6,0,2,8
2850,CUDDAPAH,Pendlimarri,CHEEMALAPENTA,150,0,583,733,28,0,201,229,204,1181,0,7165,8346,4724,2,0,4,6
2851,CUDDAPAH,Pendlimarri,CHERLOPALLI,15,0,493,508,1,0,229,230,236,37,0,11547,11584,6592,0,0,17,17
2852,CUDDAPAH,Pendlimarri,ESUKAPALLE,4,0,472,476,2,0,261,263,246,24,0,8125,8149,6359,0,0,2,2
2853,CUDDAPAH,Pendlimarri,GANGANAPALLE,201,27,726,954,82,1,362,445,441,2154,20,16648,18822,13613,0,0,10,10
2854,CUDDAPAH,Pendlimarri,GANGIREDDY PALLE,174,4,532,710,82,0,151,233,219,2716,0,6295,9011,6075,3,0,17,20
2855,CUDDAPAH,Pendlimarri,GONDIPALLE,211,1,465,677,69,0,125,194,187,3667,0,7111,10778,5825,12,0,35,47
2856,CUDDAPAH,Pendlimarri,K.SANGATIPALLI,180,0,363,543,25,0,176,201,235,576,0,12616,13192,8218,0,0,52,52
2857,CUDDAPAH,Pendlimarri,KONDURU,258,9,559,826,132,0,174,306,310,7474,0,10234,17708,9228,21,0,34,55
2858,CUDDAPAH,Pendlimarri,KOTHA GIRIYAM PALLE,1,1,249,251,0,0,137,137,156,0,0,6155,6155,4199,0,0,13,13
2859,CUDDAPAH,Pendlimarri,MACHANUR,469,0,773,1242,16,0,220,236,239,173,0,12843,13016,7325,0,0,21,21
2860,CUDDAPAH,Pendlimarri,MOILLAKALAVA,135,54,514,703,36,0,106,142,123,1329,0,2578,3907,2632,3,0,1,4
2861,CUDDAPAH,Pendlimarri,NAGAYA PALLE,5,0,495,500,0,0,279,279,300,0,0,18288,18288,10537,0,0,65,65
2862,CUDDAPAH,Pendlimarri,NANDIMANDALAM,278,19,1144,1441,104,2,207,313,302,2290,40,7681,10011,5351,0,0,10,10
2863,CUDDAPAH,Pendlimarri,PENDLIMARRI,4,0,313,317,0,0,193,193,202,0,0,13500,13500,7440,0,0,58,58
2864,CUDDAPAH,Pendlimarri,RAMPATHADU,38,3,595,636,14,3,211,228,226,749,213,12057,13019,9261,3,1,33,37
2865,CUDDAPAH,Pendlimarri,SANGATIPALLE,170,2,500,672,104,0,305,409,453,6292,0,17860,24152,13942,13,0,38,51
2866,CUDDAPAH,Pendlimarri,THIPPIREDDIPALLE,123,0,351,474,48,0,133,181,179,1603,0,6000,7603,4437,1,0,5,6
2867,CUDDAPAH,Pendlimarri,TUMMALUR,123,0,354,477,57,0,157,214,187,2980,0,7017,9997,4870,3,0,11,14
2868,CUDDAPAH,Pendlimarri,VELLATUR,130,14,629,773,71,4,224,299,300,4643,170,11215,16028,9650,16,0,38,54
2869,CUDDAPAH,Porumamilla,AKKALREDDIPALLE,401,26,617,1044,260,21,473,754,712,13190,1984,30476,45650,25728,23,10,97,130
2870,CUDDAPAH,Porumamilla,CHALLAGIRIGELLA,214,3,659,876,118,0,423,541,500,5610,0,22594,28204,15584,9,0,35,44
2871,CUDDAPAH,Porumamilla,CHINAYERASALA,228,1,559,788,179,0,330,509,486,11551,0,16130,27681,15514,36,0,25,61
2872,CUDDAPAH,Porumamilla,DAMMANAPALLE,275,1,429,705,141,0,262,403,370,6599,0,16776,23375,13369,14,0,34,48
2873,CUDDAPAH,Porumamilla,GANUGAPENTA,224,25,741,990,124,15,439,578,559,6093,677,25805,32575,20940,6,0,44,50
2874,CUDDAPAH,Porumamilla,KAVALAKUNTLA,229,1,437,667,113,1,169,283,290,8056,26,9058,17140,9969,34,0,21,55
2875,CUDDAPAH,Porumamilla,KORRAPATUPALLE,124,1,313,438,81,0,206,287,283,5361,0,9114,14475,9279,23,0,6,29
2876,CUDDAPAH,Porumamilla,MUSALREDDIPALLE,86,0,277,363,48,0,85,133,113,2871,0,3926,6797,3752,6,0,4,10
2877,CUDDAPAH,Porumamilla,PORUMAMILLA,210,2,1724,1936,26,0,704,730,646,1945,0,44445,46390,36738,9,0,51,60
2878,CUDDAPAH,Porumamilla,PULLIVEEDU,271,4,529,804,160,2,281,443,481,9052,51,11765,20868,12748,20,0,18,38
2879,CUDDAPAH,Porumamilla,RAJASAHEBPETA,202,1,303,506,148,1,132,281,297,10700,116,10395,21211,11751,36,1,47,84
2880,CUDDAPAH,Porumamilla,RANGA SAMUDRAM,546,102,1034,1682,222,21,466,709,640,9718,328,25761,35807,21933,14,0,46,60
2881,CUDDAPAH,Porumamilla,SANCHARLA,81,34,575,690,58,19,389,466,501,4374,700,31688,36762,20040,22,0,143,165
2882,CUDDAPAH,Porumamilla,SIDDAVARAM,235,9,580,824,86,5,366,457,458,6850,353,24570,31773,19861,32,2,67,101
2883,CUDDAPAH,Porumamilla,TEKURPETA,159,0,418,577,66,0,214,280,251,5688,0,14745,20433,12004,25,0,39,64
2884,CUDDAPAH,Porumamilla,THIMMAREDDIPALLI,130,2,358,490,52,1,119,172,181,3093,71,6996,10160,6261,12,0,25,37
2885,CUDDAPAH,Porumamilla,VENKATARAMAPURAM,62,7,256,325,46,5,184,235,255,3760,251,12573,16584,10258,18,1,52,71
2886,CUDDAPAH,Proddutur,CHENNAMARAJU PALLE,198,0,401,599,67,0,281,348,386,1931,0,9594,11525,8815,0,0,5,5
2887,CUDDAPAH,Proddutur,CHOWDUR,101,0,388,489,48,0,186,234,257,1781,0,4531,6312,6005,0,0,0,0
2888,CUDDAPAH,Proddutur,CHOWTAPALLE,178,0,70,248,97,0,31,128,132,3748,0,1786,5534,5373,1,0,0,1
2889,CUDDAPAH,Proddutur,DORASANI PALLE,191,5,302,498,103,2,106,211,222,4663,26,4569,9258,8760,3,0,4,7
2890,CUDDAPAH,Proddutur,GOPAVARAM,505,117,2541,3163,78,0,239,317,323,3353,0,13906,17259,14539,4,0,18,22
2891,CUDDAPAH,Proddutur,KAKIRENIPALLE,1,0,206,207,1,0,108,109,110,54,0,6462,6516,6020,0,0,7,7
2892,CUDDAPAH,Proddutur,KALLUR,350,1,453,804,88,0,195,283,292,1611,0,5488,7099,6149,0,0,3,3
2893,CUDDAPAH,Proddutur,KAMANUR,259,32,383,674,138,1,198,337,333,6214,20,8137,14371,10542,11,0,2,13
2894,CUDDAPAH,Proddutur,KOTHAPALLE,476,33,943,1452,93,2,85,180,181,4790,40,910,5740,3803,11,0,0,11
2895,CUDDAPAH,Proddutur,NANGANURPALLE,107,4,329,440,52,0,182,234,253,2191,0,7228,9419,7722,2,0,5,7
2896,CUDDAPAH,Proddutur,PEDDASETTIPALLE,443,1,1014,1458,62,0,221,283,287,776,0,5594,6370,5987,0,0,1,1
2897,CUDDAPAH,Proddutur,Proddatur,57,0,15,72,0,0,0,0,0,0,0,0,0,0,0,0,0,0
2898,CUDDAPAH,Proddutur,SEETHAMPALLE,5,6,531,542,0,0,281,281,274,0,0,7511,7511,5011,0,0,1,1
2899,CUDDAPAH,Proddutur,SOMULAVARIPALLI,177,31,1741,1949,12,1,144,157,168,547,23,5874,6444,5910,1,0,9,10
2900,CUDDAPAH,Proddutur,THALLAMAPURAM,555,0,744,1299,246,0,356,602,602,9489,0,10880,20369,16465,15,0,3,18
2901,CUDDAPAH,Proddutur,UPPARAPALLE,187,4,459,650,120,0,160,280,295,4624,0,4023,8647,5542,0,0,0,0
2902,CUDDAPAH,Pulivendla,ATCHAVALLE,102,2,214,318,56,0,119,175,166,3605,0,9945,13550,8612,12,0,68,80
2903,CUDDAPAH,Pulivendla,E.KOTHAPALLI,9,48,912,969,1,11,324,336,327,103,834,18355,19292,15630,1,3,29,33
2904,CUDDAPAH,Pulivendla,KONAMPALLI,14,101,79,194,8,50,47,105,104,559,4427,4029,9015,6987,3,30,27,60
2905,CUDDAPAH,Pulivendla,PULIVENDALA,0,0,0,0,0,0,0,0,0,0,0,0,0,0,0,0,0,0
2906,CUDDAPAH,Pulivendla,RAGIMANUPALLE,97,7,492,596,47,0,137,184,172,2131,0,11819,13950,10360,4,0,68,72
2907,CUDDAPAH,Pulivendla,YERRABALLI,214,153,1252,1619,101,39,376,516,493,4122,641,10436,15199,11079,2,0,2,4
2908,CUDDAPAH,Pulivendla,YERRIPALLI,9,0,212,221,0,0,87,87,83,0,0,7602,7602,6055,0,0,45,45
2909,CUDDAPAH,Pullampeta,ANANTAIAH GARI PALLE,92,5,319,416,37,3,64,104,76,2827,245,3483,6555,3804,13,1,5,19
2910,CUDDAPAH,Pullampeta,ANANTHAMPALLI,162,0,132,294,59,0,7,66,60,2812,0,103,2915,2647,11,0,0,11
2911,CUDDAPAH,Pullampeta,ANANTHASAMUDRAM,586,122,545,1253,14,18,21,53,56,500,868,515,1883,1170,0,0,0,0
2912,CUDDAPAH,Pullampeta,APPAIAHRAJUPET,105,0,124,229,0,0,0,0,0,0,0,0,0,0,0,0,0,0
2913,CUDDAPAH,Pullampeta,BAVIKADAPALLI,194,143,571,908,82,34,122,238,200,7336,5668,8348,21352,11610,44,20,39,103
2914,CUDDAPAH,Pullampeta,DALAVAIPALLE,93,0,302,395,31,0,105,136,122,2250,0,8020,10270,7545,10,0,29,39
2915,CUDDAPAH,Pullampeta,DANDLOPALLE,76,0,125,201,47,0,61,108,68,3841,0,4025,7866,3845,18,0,8,26
2916,CUDDAPAH,Pullampeta,GARALAMADUGU,73,16,263,352,20,0,15,35,36,398,0,497,895,624,0,0,0,0
2917,CUDDAPAH,Pullampeta,JAGUVARIPALLI,367,8,257,632,166,0,25,191,158,12645,0,778,13423,7009,65,0,0,65
2918,CUDDAPAH,Pullampeta,KOMMANAVARIPALLI,170,11,226,407,91,0,56,147,114,3874,0,984,4858,3034,5,0,0,5
2919,CUDDAPAH,Pullampeta,KOTHAPETA,66,3,685,754,14,1,140,155,107,847,68,8072,8987,5579,2,0,10,12
2920,CUDDAPAH,Pullampeta,P.V.G.PALLI,266,1,309,576,110,0,53,163,140,4382,0,1088,5470,3417,5,0,0,5
2921,CUDDAPAH,Pullampeta,PULLAMPETA,145,1,147,293,31,0,28,59,58,2906,0,2532,5438,4489,17,0,13,30
2922,CUDDAPAH,Pullampeta,PUTHANAVARIPALLE,6,0,86,92,2,0,16,18,14,170,0,788,958,707,1,0,1,2
2923,CUDDAPAH,Pullampeta,RAMASAMUDRAM,74,0,214,288,23,0,51,74,62,559,0,2772,3331,2034,0,0,2,2
2924,CUDDAPAH,Pullampeta,RANGAMPALLE,141,25,324,490,53,1,121,175,147,3554,8,6806,10368,7114,16,0,29,45
2925,CUDDAPAH,Pullampeta,REDDIPALLE,136,0,196,332,55,0,42,97,79,2339,0,1940,4279,2827,5,0,6,11
2926,CUDDAPAH,Pullampeta,T.KAMMAPALLI,139,32,399,570,48,1,100,149,88,2057,92,6926,9075,4681,0,0,24,24
2927,CUDDAPAH,Pullampeta,THIPPAYAPALLE,178,6,279,463,51,0,55,106,58,3820,0,4691,8511,4019,8,0,13,21
2928,CUDDAPAH,Pullampeta,VATHALUR,369,18,1107,1494,91,0,150,241,185,2870,0,8175,11045,6189,2,0,22,24
2929,CUDDAPAH,Rajampet,AKEPADU,260,55,229,544,105,9,42,156,154,7371,231,2312,9914,5993,30,0,4,34
2930,CUDDAPAH,Rajampet,APPARAJUPET,282,37,99,418,124,20,10,154,140,8366,721,466,9553,6970,50,2,2,54
2931,CUDDAPAH,Rajampet,BRAHMANAPALLI,67,17,157,241,37,1,59,97,84,3089,68,4810,7967,5058,22,0,38,60
2932,CUDDAPAH,Rajampet,CHAVANAVARIPALLI,108,3,201,312,45,0,58,103,73,2695,0,4162,6857,2998,15,0,25,40
2933,CUDDAPAH,Rajampet,GUNDLUR,170,18,131,319,61,0,19,80,78,4875,0,1293,6168,4700,26,0,5,31
2934,CUDDAPAH,Rajampet,HASTAVARAM,219,36,375,630,18,16,56,90,80,238,289,1290,1817,1327,0,0,0,0
2935,CUDDAPAH,Rajampet,K.BOYANAPALLY,117,3,46,166,45,0,4,49,38,1273,0,80,1353,732,1,0,0,1
2936,CUDDAPAH,Rajampet,KOLLAVARIPALLI,198,11,252,461,109,0,118,227,209,6937,0,9030,15967,9745,34,0,49,83
2937,CUDDAPAH,Rajampet,KOTHAPALLE,80,2,163,245,48,0,37,85,68,3382,0,2086,5468,4177,20,0,10,30
2938,CUDDAPAH,Rajampet,KUCHIVARIPALLE,189,9,52,250,66,0,3,69,60,5404,0,190,5594,4369,30,0,1,31
2939,CUDDAPAH,Rajampet,MADANAGOPALAPURAM,134,45,167,346,33,15,44,92,86,2414,1362,2505,6281,4677,14,8,8,30
2940,CUDDAPAH,Rajampet,MANDAPALLE,199,3,294,496,49,0,43,92,64,3679,0,2331,6010,3323,19,0,4,23
2941,CUDDAPAH,Rajampet,MANDARAM,135,12,362,509,48,1,57,106,79,2731,25,3279,6035,3665,11,0,10,21
2942,CUDDAPAH,Rajampet,MITTAMEEDAPALLI,164,1,219,384,112,0,46,158,147,6425,0,3075,9500,6128,8,0,9,17
2943,CUDDAPAH,Rajampet,PEDDAKARAMPALLI,167,5,443,615,83,2,161,246,194,4275,88,7512,11875,8341,11,0,14,25
2944,CUDDAPAH,Rajampet,POLI,103,109,321,533,43,32,74,149,125,2592,1586,5227,9405,7284,17,5,26,48
2945,CUDDAPAH,Rajampet,PULAPATHURU,244,1,245,490,113,0,84,197,158,8773,0,6987,15760,9078,37,0,38,75
2946,CUDDAPAH,Rajampet,R.BUDUGUNTAPALLE,109,37,226,372,51,1,18,70,55,4874,39,920,5833,3474,30,0,4,34
2947,CUDDAPAH,Rajampet,RAJAMPETA,0,0,0,0,0,0,0,0,0,0,0,0,0,0,0,0,0,0
2948,CUDDAPAH,Rajampet,ROLLAMADUGU,42,10,128,180,30,5,59,94,76,2095,376,4614,7085,3588,11,3,25,39
2949,CUDDAPAH,Rajampet,SEETHARAMAPURAM,142,8,146,296,67,0,6,73,61,4881,0,197,5078,2897,34,0,0,34
2950,CUDDAPAH,Rajampet,SESHAMAMBAPURAM,87,1,229,317,30,0,61,91,71,2277,0,4457,6734,3956,9,0,26,35
2951,CUDDAPAH,Rajampet,TALLAPAKA,130,40,465,635,22,3,130,155,113,691,48,4952,5691,3111,0,0,6,6
2952,CUDDAPAH,Rajampet,TOGURPET,23,4,363,390,7,0,75,82,59,425,0,4541,4966,3186,2,0,19,21
2953,CUDDAPAH,Rajampet,UTUKUR,236,27,225,488,92,2,50,144,109,6578,20,2101,8699,5891,36,0,7,43
2954,CUDDAPAH,Rajampet,VARADAIAHGARIPALLI,149,6,291,446,19,0,17,36,30,756,0,275,1031,560,1,0,0,1
2955,CUDDAPAH,Raju Palem,ARKATAVEMULA,107,0,582,689,22,0,323,345,333,966,0,11947,12913,8230,1,0,8,9
2956,CUDDAPAH,Raju Palem,CHINNA SETTIPALLE,132,3,285,420,52,1,88,141,157,2821,20,5863,8704,5506,5,0,21,26
2957,CUDDAPAH,Raju Palem,ERUVAPALEM,237,5,475,717,131,0,125,256,254,3916,0,4092,8008,6092,1,0,0,1
2958,CUDDAPAH,Raju Palem,GADEGUDUR,178,0,356,534,91,0,128,219,218,3081,0,5228,8309,5720,4,0,10,14
2959,CUDDAPAH,Raju Palem,GOPAYAPALLE,133,4,250,387,72,0,77,149,141,2596,0,2966,5562,4246,3,0,2,5
2960,CUDDAPAH,Raju Palem,KORRAPADU,177,0,670,847,86,0,261,347,334,3419,0,12261,15680,12952,7,0,12,19
2961,CUDDAPAH,Raju Palem,KULUR,232,0,420,652,94,0,99,193,201,3464,0,2744,6208,3719,5,0,0,5
2962,CUDDAPAH,Raju Palem,KUMMARAPALLI,112,22,159,293,68,1,80,149,143,3187,31,3448,6666,5143,5,0,2,7
2963,CUDDAPAH,Raju Palem,PAIDALA,88,1,108,197,62,0,45,107,115,3917,0,3066,6983,5069,13,0,15,28
2964,CUDDAPAH,Raju Palem,PARLAPADU,249,0,240,489,141,0,50,191,188,8210,0,3559,11769,6952,30,0,17,47
2965,CUDDAPAH,Raju Palem,RAJUPALEM,242,7,385,634,123,1,174,298,286,5331,39,8070,13440,10700,3,0,8,11
2966,CUDDAPAH,Raju Palem,TANGATUR,452,37,731,1220,76,0,108,184,174,1749,0,2841,4590,2629,1,0,1,2
2967,CUDDAPAH,Raju Palem,VASUDEVAPURAM,95,5,295,395,46,0,4,50,49,1555,0,74,1629,932,0,0,0,0
2968,CUDDAPAH,Raju Palem,VELAVALI,216,1,472,689,46,1,94,141,138,1500,25,3367,4892,3289,0,0,2,2
2969,CUDDAPAH,Raju Palem,VENGALAYAPALLI,80,14,196,290,40,10,121,171,165,1895,875,9128,11898,7578,4,6,40,50
2970,CUDDAPAH,Ramapuram,BANDLAPALLE,186,20,494,700,107,1,155,263,228,6519,20,8852,15391,11353,25,0,29,54
2971,CUDDAPAH,Ramapuram,CHITLUR,270,29,812,1111,117,6,293,416,377,5023,187,11259,16469,9307,7,0,10,17
2972,CUDDAPAH,Ramapuram,GOPAGUDIPALLE,86,9,472,567,50,1,253,304,267,3516,34,16593,20143,10785,13,0,57,70
2973,CUDDAPAH,Ramapuram,GUVVALACHERUVU,3,33,317,353,0,5,92,97,94,0,51,7379,7430,5177,0,0,38,38
2974,CUDDAPAH,Ramapuram,HASANAPURAM,246,56,1030,1332,139,31,526,696,643,11229,1399,32559,45187,23927,57,2,112,171
2975,CUDDAPAH,Ramapuram,KALAPANAYUNICHERUVU,245,40,339,624,135,25,129,289,256,8164,1049,5484,14697,7992,34,3,13,50
2976,CUDDAPAH,Ramapuram,KASIREDDIGARIPALLE,107,130,481,718,63,70,207,340,324,3551,3494,14014,21059,13154,11,4,79,94
2977,CUDDAPAH,Ramapuram,KUMMARAPALLI,177,18,654,849,53,11,258,322,282,2414,734,16858,20006,12650,3,1,67,71
2978,CUDDAPAH,Ramapuram,NALLAGUTTAPALLE,123,37,987,1147,91,26,446,563,561,5366,1552,26620,33538,20790,15,5,68,88
2979,CUDDAPAH,Ramapuram,NEELAKANTHARAOPET,26,3,365,394,18,0,107,125,133,1126,0,6504,7630,4832,4,0,24,28
2980,CUDDAPAH,Ramapuram,RACHAPALLI,236,10,1071,1317,171,3,742,916,905,14055,233,51995,66283,35178,65,1,195,261
2981,CUDDAPAH,Ramapuram,SARASWATHIPALLE,121,0,322,443,94,0,195,289,284,6543,0,9220,15763,8765,25,0,7,32
2982,CUDDAPAH,Ramapuram,SUDDAMALA,186,12,787,985,113,3,377,493,450,8366,83,20549,28998,17002,43,0,75,118
2983,CUDDAPAH,Rayachoti,CHENNAMUKKAPALLE,159,17,487,663,21,4,156,181,167,483,36,10322,10841,8041,0,0,29,29
2984,CUDDAPAH,Rayachoti,D. ABBAVARAM,121,5,599,725,10,0,160,170,161,304,0,10330,10634,7854,1,0,33,34
2985,CUDDAPAH,Rayachoti,GORLAMUDIVEEDU,232,24,779,1035,100,13,237,350,326,6052,1337,16892,24281,15926,17,9,62,88
2986,CUDDAPAH,Rayachoti,KATIMAYAKUNTA,182,2,797,981,96,1,358,455,391,7245,39,27224,34508,19284,33,0,123,156
2987,CUDDAPAH,Rayachoti,MADHAVARAM,115,60,2134,2309,36,8,576,620,574,2029,213,34859,37101,21989,9,0,126,135
2988,CUDDAPAH,Rayachoti,PEMMADAPALLE,100,4,491,595,38,0,234,272,302,1933,0,14909,16842,14733,5,0,47,52
2989,CUDDAPAH,Rayachoti,SIBYALA,227,13,1420,1660,121,1,313,435,350,7521,89,15879,23489,13749,19,0,49,68
2990,CUDDAPAH,Rayachoti,VORIGAPAPIREDDIPALLI,135,12,388,535,68,5,179,252,218,4314,432,12806,17552,9330,20,2,64,86
2991,CUDDAPAH,Rayachoti,YENDAPALLI,207,9,819,1035,48,4,181,233,214,3802,117,11017,14936,9918,24,0,49,73
2992,CUDDAPAH,S Mydukur,ANNALURU,89,0,358,447,61,0,146,207,200,2612,0,3834,6446,3732,4,0,5,9
2993,CUDDAPAH,S Mydukur,AUDIREDDIPALLI,237,201,397,835,99,113,184,396,414,6246,7355,10168,23769,14431,24,23,21,68
2994,CUDDAPAH,S Mydukur,DAYANKHANPALLI,118,0,174,292,5,0,98,103,109,191,0,6872,7063,4329,0,0,21,21
2995,CUDDAPAH,S Mydukur,GANJIKUNTA,361,120,540,1021,63,83,143,289,280,2903,3261,4342,10506,5940,2,1,5,8
2996,CUDDAPAH,S Mydukur,JANGAMPALLI,6,0,21,27,0,0,0,0,0,0,0,0,0,0,0,0,0,0
2997,CUDDAPAH,S Mydukur,LINGALADINNE,59,3,398,460,0,0,0,0,0,0,0,0,0,0,0,0,0,0
2998,CUDDAPAH,S Mydukur,MITTAMANIPALLE,292,1,402,695,141,0,220,361,350,3403,0,9445,12848,6676,0,0,12,12
2999,CUDDAPAH,S Mydukur,MYDUKUR,865,61,1847,2773,3,0,1,4,1,11,0,6,17,6,0,0,0,0
3000,CUDDAPAH,S Mydukur,N.YERRABALLI,157,0,565,722,44,0,280,324,301,2016,0,20112,22128,10926,2,0,74,76
3001,CUDDAPAH,S Mydukur,NANDYALAMPETA,654,80,995,1729,109,1,209,319,322,3355,4,11950,15309,10213,4,0,48,52
3002,CUDDAPAH,S Mydukur,ONIPENTA,175,3,673,851,44,0,120,164,153,1654,0,2347,4001,2424,1,0,0,1
3003,CUDDAPAH,S Mydukur,PAPANNAPALLI,184,4,310,498,76,0,98,174,161,5833,0,6885,12718,8060,26,0,34,60
3004,CUDDAPAH,S Mydukur,SETTIVARIPALLE,192,0,328,520,0,0,0,0,0,0,0,0,0,0,0,0,0,0
3005,CUDDAPAH,S Mydukur,SIVAPURAM,140,0,270,410,62,0,89,151,128,4094,0,4188,8282,4197,9,0,12,21
3006,CUDDAPAH,S Mydukur,THIPPIREDDIPALLE,108,2,319,429,69,0,215,284,310,4007,0,13781,17788,9597,12,0,55,67
3007,CUDDAPAH,S Mydukur,TUVVAPALLI,312,106,449,867,128,35,135,298,311,5469,3508,10370,19347,10452,21,23,63,107
3008,CUDDAPAH,S Mydukur,VISWANATHAPURAM,165,21,533,719,52,17,152,221,198,2125,852,7434,10411,6416,1,0,9,10
3009,CUDDAPAH,S Mydukur,YELLAMPALLE,242,0,392,634,0,0,0,0,0,0,0,0,0,0,0,0,0,0
3010,CUDDAPAH,S.A.K.N. MANDAL,AKULANARAYANAPALLI,95,34,250,379,65,27,192,284,301,4696,2827,12663,20186,11882,15,16,28,59
3011,CUDDAPAH,S.A.K.N. MANDAL,AMAGAMPALLI,234,0,297,531,105,0,188,293,279,4667,0,9095,13762,8902,9,0,15,24
3012,CUDDAPAH,S.A.K.N. MANDAL,BALAYAPALLI,132,15,283,430,106,11,206,323,334,5572,362,11997,17931,9739,8,0,19,27
3013,CUDDAPAH,S.A.K.N. MANDAL,GANGANAPALLI,39,0,319,358,31,0,267,298,300,1873,0,17182,19055,11588,1,0,51,52
3014,CUDDAPAH,S.A.K.N. MANDAL,GONTUVARIPALLI,12,2,401,415,9,1,275,285,280,542,25,13258,13825,8215,2,0,19,21
3015,CUDDAPAH,S.A.K.N. MANDAL,ITUGULLAPADU,105,2,596,703,47,1,386,434,441,2583,72,22840,25495,16873,10,0,56,66
3016,CUDDAPAH,S.A.K.N. MANDAL,KATHERAGANDLA,329,26,640,995,169,6,423,598,623,4726,43,21556,26325,16154,1,0,32,33
3017,CUDDAPAH,S.A.K.N. MANDAL,KODIGUDLAPADU,61,6,405,472,46,5,347,398,398,3219,501,25997,29717,16970,10,3,98,111
3018,CUDDAPAH,S.A.K.N. MANDAL,KONDRAJUPALLI,107,20,459,586,69,14,288,371,367,4622,749,13854,19225,10455,12,0,42,54
3019,CUDDAPAH,S.A.K.N. MANDAL,NARASAPURAM,211,5,1109,1325,141,0,682,823,857,5145,0,26463,31608,17340,6,0,32,38
3020,CUDDAPAH,S.A.K.N. MANDAL,RAMPADU,92,3,463,558,60,0,267,327,325,3257,0,11178,14435,8507,6,0,18,24
3021,CUDDAPAH,S.A.K.N. MANDAL,SAVISETTIPALLE,149,1,276,426,103,0,103,206,217,5037,0,1823,6860,3684,7,0,1,8
3022,CUDDAPAH,S.A.K.N. MANDAL,UPPALUR,109,1,322,432,74,0,263,337,347,3684,0,14663,18347,11069,6,0,19,25
3023,CUDDAPAH,S.A.K.N. MANDAL,VADDEMANU,188,5,722,915,82,2,451,535,525,2612,89,25720,28421,17724,1,0,71,72
3024,CUDDAPAH,S.A.K.N. MANDAL,VARIKUNTLA,352,52,621,1025,131,26,340,497,489,3461,469,13664,17594,10406,2,0,11,13
3025,CUDDAPAH,Sambepalle,ADAVIKAMMAPALLE,166,19,516,701,60,11,216,287,223,2145,690,14240,17075,9611,2,2,51,55
3026,CUDDAPAH,Sambepalle,CHINNABIDIKI,224,459,369,1052,86,187,53,326,290,3773,12559,997,17329,8458,13,62,0,75
3027,CUDDAPAH,Sambepalle,DEVAPATLA,107,10,766,883,15,0,247,262,243,1098,0,19939,21037,11683,3,0,87,90
3028,CUDDAPAH,Sambepalle,DUDYALA,260,38,786,1084,91,30,200,321,272,4610,2112,11009,17731,9390,16,9,32,57
3029,CUDDAPAH,Sambepalle,GUNIKUNTLA,69,0,410,479,44,0,182,226,205,3861,0,15455,19316,11478,15,0,70,85
3030,CUDDAPAH,Sambepalle,GURIGINJAKUNTA,174,0,365,539,71,0,136,207,165,2846,0,9107,11953,6332,5,0,44,49
3031,CUDDAPAH,Sambepalle,GUTTAPALLI,103,6,383,492,32,4,115,151,141,2023,54,6932,9009,4491,11,0,29,40
3032,CUDDAPAH,Sambepalle,MOTAKATLA,4,34,514,552,0,4,167,171,147,0,92,8673,8765,4621,0,0,29,29
3033,CUDDAPAH,Sambepalle,NAGIREDDY PALLI,123,0,333,456,66,0,157,223,218,3498,0,7836,11334,6868,12,0,28,40
3034,CUDDAPAH,Sambepalle,NARAYANAREDDIGARIPALLE,122,2,1160,1284,46,1,180,227,222,4298,100,9121,13519,9421,29,1,23,53
3035,CUDDAPAH,Sambepalle,PRAKASH NAGAR COLONY,223,2,426,651,88,1,73,162,151,3605,18,2843,6466,3790,5,0,7,12
3036,CUDDAPAH,Sambepalle,REDDYVARI PALLI,116,61,423,600,18,1,73,92,88,611,12,3020,3643,2213,1,0,8,9
3037,CUDDAPAH,Sambepalle,ROUTHUKUNTA,64,1,651,716,23,0,139,162,127,1122,0,4778,5900,2869,4,0,10,14
3038,CUDDAPAH,Sambepalle,SAMBEPALLE,171,6,426,603,26,0,90,116,110,1044,0,6157,7201,5076,1,0,19,20
3039,CUDDAPAH,Sambepalle,SETTIPALLE,218,54,784,1056,92,13,175,280,256,5734,690,8333,14757,7757,25,0,32,57
3040,CUDDAPAH,Sambepalle,SOMAVARAM,40,7,435,482,29,1,93,123,109,1322,81,5200,6603,4083,0,0,16,16
3041,CUDDAPAH,Sidhout,BOGGIDIVARIPALLI,169,1,369,539,24,0,102,126,122,1539,0,7802,9341,6874,5,0,47,52
3042,CUDDAPAH,Sidhout,JANGALAPALLE,208,24,200,432,92,0,44,136,134,2620,0,1985,4605,2885,2,0,2,4
3043,CUDDAPAH,Sidhout,JYOTHI,209,47,205,461,57,1,28,86,74,1482,20,674,2176,1421,6,0,0,6
3044,CUDDAPAH,Sidhout,K.MADHAVARAM,14,0,194,208,1,0,14,15,12,90,0,710,800,333,0,0,2,2
3045,CUDDAPAH,Sidhout,KADAPAYAPALLE,135,0,182,317,74,0,118,192,193,5644,0,9738,15382,11372,24,0,59,83
3046,CUDDAPAH,Sidhout,LINGAMPALLE,30,26,189,245,8,7,86,101,97,786,437,6669,7892,5937,5,2,34,41
3047,CUDDAPAH,Sidhout,MACHUPALLE,162,4,375,541,40,0,125,165,167,2326,0,8138,10464,9513,14,0,33,47
3048,CUDDAPAH,Sidhout,MADHAVARAM,254,22,522,798,102,4,87,193,167,5695,242,5010,10947,8353,21,0,20,41
3049,CUDDAPAH,Sidhout,MULAPALLE,174,0,168,342,77,0,61,138,149,4546,0,6761,11307,8371,9,0,30,39
3050,CUDDAPAH,Sidhout,NEKANAPURAM,172,4,141,317,111,0,52,163,148,9825,0,4424,14249,9331,70,0,27,97
3051,CUDDAPAH,Sidhout,PEDDAPALLE,309,53,658,1020,96,1,193,290,257,5695,6,11665,17366,11718,20,0,38,58
3052,CUDDAPAH,Sidhout,PONNAVOLU,246,10,360,616,115,7,60,182,178,3165,227,855,4247,3172,5,0,0,5
3053,CUDDAPAH,Sidhout,S.RAJAMPETA,179,3,95,277,70,0,47,117,116,1899,0,807,2706,1840,2,0,1,3
3054,CUDDAPAH,Sidhout,SHAKARAJUPALLE,174,0,168,342,98,0,59,157,149,7254,0,4917,12171,6891,42,0,27,69
3055,CUDDAPAH,Sidhout,SIDHOUT,337,42,566,945,91,9,150,250,232,3068,96,6747,9911,7296,3,0,14,17
3056,CUDDAPAH,Sidhout,TOKKOLU,275,19,583,877,125,0,236,361,397,9429,0,6617,16046,13436,40,0,0,40
3057,CUDDAPAH,Sidhout,UPPARAPALLI,19,23,97,139,4,5,28,37,30,98,50,668,816,595,0,0,0,0
3058,CUDDAPAH,Sidhout,VONTITHATIPALLE,217,4,206,427,105,0,75,180,182,4552,0,1652,6204,4369,1,0,1,2
3059,CUDDAPAH,Simhadripuram,ANKALAMMAGUDUR,236,0,538,774,61,0,115,176,159,2019,0,4029,6048,4271,2,0,4,6
3060,CUDDAPAH,Simhadripuram,B.CHERLOPALLE,5,17,497,519,0,12,236,248,229,0,1149,18091,19240,10669,0,5,88,93
3061,CUDDAPAH,Simhadripuram,BALAPANUR,123,5,915,1043,0,1,185,186,162,0,5,2936,2941,1898,0,0,0,0
3062,CUDDAPAH,Simhadripuram,BIDINAMCHERLA,109,0,643,752,60,0,310,370,331,2800,0,21645,24445,15219,0,0,66,66
3063,CUDDAPAH,Simhadripuram,BUJJAYAPALLE,4,0,217,221,0,0,94,94,81,0,0,7670,7670,4294,0,0,48,48
3064,CUDDAPAH,Simhadripuram,CHAVVARI PALLE,3,0,198,201,0,0,48,48,42,0,0,2066,2066,1523,0,0,1,1
3065,CUDDAPAH,Simhadripuram,DUDDEKUNTA,54,2,266,322,33,1,166,200,220,1763,92,12155,14010,9293,7,0,52,59
3066,CUDDAPAH,Simhadripuram,GURJALA,130,6,717,853,54,1,259,314,270,2809,21,13567,16397,10620,4,0,34,38
3067,CUDDAPAH,Simhadripuram,HIMAKUNTLA,335,8,754,1097,144,2,100,246,251,6082,208,4568,10858,7617,14,1,19,34
3068,CUDDAPAH,Simhadripuram,K.N.G.PALLE,145,1,393,539,83,1,134,218,206,5452,10,9025,14487,10673,25,0,36,61
3069,CUDDAPAH,Simhadripuram,KAMBALLA,39,7,185,231,25,5,90,120,105,1782,425,7412,9619,6342,9,2,48,59
3070,CUDDAPAH,Simhadripuram,KASANUR,107,3,586,696,21,0,89,110,101,510,0,3835,4345,3077,0,0,5,5
3071,CUDDAPAH,Simhadripuram,LOMADA,103,0,497,600,31,0,198,229,232,1571,0,11692,13263,8217,3,0,48,51
3072,CUDDAPAH,Simhadripuram,NANDYALAMPALLE,2,2,214,218,0,0,98,98,93,0,0,6399,6399,4147,0,0,21,21
3073,CUDDAPAH,Simhadripuram,PYDIPALEM,56,20,295,371,24,0,84,108,105,577,0,3970,4547,3952,0,0,5,5
3074,CUDDAPAH,Simhadripuram,RAVULAKOLANU,60,3,435,498,34,1,176,211,199,1738,63,11156,12957,8173,3,0,24,27
3075,CUDDAPAH,Simhadripuram,SIMHADRIPURAM,260,21,1179,1460,78,1,215,294,275,4881,20,15060,19961,16538,24,0,82,106
3076,CUDDAPAH,Simhadripuram,SUNKESULA,36,1,216,253,27,1,79,107,98,2111,82,4849,7042,4571,9,0,23,32
3077,CUDDAPAH,Simhadripuram,THELIKE,85,0,397,482,38,0,98,136,133,2485,0,8082,10567,6552,9,0,39,48
3078,CUDDAPAH,Simhadripuram,Y.KOTHAPALLE,106,0,226,332,30,0,16,46,42,710,0,445,1155,868,1,0,0,1
3079,CUDDAPAH,T Sundupalle,BHAGAMPALLE,46,0,254,300,26,0,56,82,76,1749,0,3887,5636,2902,5,0,9,14
3080,CUDDAPAH,T Sundupalle,CHINNAGOLLAPALLE,42,5,671,718,29,1,126,156,143,759,13,3223,3995,2233,0,0,2,2
3081,CUDDAPAH,T Sundupalle,GUNDLA,9,20,61,90,0,9,17,26,14,0,269,394,663,169,0,0,0,0
3082,CUDDAPAH,T Sundupalle,GUNDLA PALLE,198,58,704,960,96,13,194,303,247,6700,408,8490,15598,8886,33,0,28,61
3083,CUDDAPAH,T Sundupalle,MACHIREDDIGARIPALLE,211,532,484,1227,67,229,171,467,404,4425,15272,15313,35010,20027,12,48,101,161
3084,CUDDAPAH,T Sundupalle,MADITHADU,387,307,1157,1851,103,101,247,451,419,5046,6217,12769,24032,13262,17,19,25,61
3085,CUDDAPAH,T Sundupalle,MUDAMPADU,160,165,958,1283,65,75,299,439,369,4451,2933,19387,26771,15471,16,7,66,89
3086,CUDDAPAH,T Sundupalle,PEDDINENIKALVA,197,62,1016,1275,36,16,239,291,233,871,1029,15003,16903,9541,0,2,30,32
3087,CUDDAPAH,T Sundupalle,POLIMERAPALLE,208,0,612,820,56,0,171,227,189,1849,0,10564,12413,7486,2,0,29,31
3088,CUDDAPAH,T Sundupalle,RAYAVARAM,198,4,1221,1423,57,1,397,455,420,4682,95,26317,31094,21240,15,0,82,97
3089,CUDDAPAH,T Sundupalle,REDDIVARIPALLE,142,14,711,867,53,4,235,292,194,3393,128,14354,17875,9299,13,0,37,50
3090,CUDDAPAH,T Sundupalle,SONTEMVARIPALLI,8,0,10,18,0,0,0,0,0,0,0,0,0,0,0,0,0,0
3091,CUDDAPAH,T Sundupalle,T.SUNDUPALLE,749,175,1960,2884,275,4,323,602,540,11171,93,14814,26078,17285,16,0,38,54
3092,CUDDAPAH,T Sundupalle,THIMMASAMUDRAM,173,11,852,1036,82,8,228,318,264,5509,444,15092,21045,10278,28,0,53,81
3093,CUDDAPAH,T Sundupalle,YERRAMNENIPALEM,138,24,297,459,72,14,124,210,174,4196,890,5182,10268,5342,14,3,9,26
3094,CUDDAPAH,Thandur,AGADUR,102,6,798,906,61,1,376,438,451,3322,20,25437,28779,18102,5,0,72,77
3095,CUDDAPAH,Thandur,BHADRAMPALLE,31,3,299,333,17,0,177,194,181,1310,0,13909,15219,8899,3,0,63,66
3096,CUDDAPAH,Thandur,BODEVARI PALLE,86,0,181,267,51,0,96,147,145,3814,0,7770,11584,7353,14,0,49,63
3097,CUDDAPAH,Thandur,BUCHUPALLE,22,3,282,307,9,1,228,238,239,412,99,16288,16799,9362,1,0,44,45
3098,CUDDAPAH,Thandur,GOTUR,111,4,457,572,51,3,200,254,259,3777,109,16447,20333,13715,14,0,82,96
3099,CUDDAPAH,Thandur,GUNDLAMADUGU,97,1,367,465,7,0,60,67,65,91,0,1904,1995,930,0,0,3,3
3100,CUDDAPAH,Thandur,INAGALUR,98,0,586,684,48,0,273,321,293,1275,0,6510,7785,5228,0,0,0,0
3101,CUDDAPAH,Thandur,MADUR,59,1,270,330,34,0,153,187,176,2121,0,12035,14156,8554,4,0,65,69
3102,CUDDAPAH,Thandur,MALLELA,69,17,666,752,42,2,239,283,264,2704,44,14548,17296,11290,3,0,40,43
3103,CUDDAPAH,Thandur,PALUR,73,0,349,422,44,0,123,167,159,3140,0,10038,13178,9107,10,0,44,54
3104,CUDDAPAH,Thandur,SANTHAKOVVUR,196,23,957,1176,95,7,464,566,568,4063,121,24911,29095,19910,2,0,45,47
3105,CUDDAPAH,Thandur,SYDAPURAM,47,5,392,444,7,1,132,140,124,653,106,10069,10828,8267,3,1,51,55
3106,CUDDAPAH,Thandur,THELLURU,64,0,267,331,37,0,115,152,133,2878,0,7688,10566,6971,7,0,37,44
3107,CUDDAPAH,Thandur,THONDUR,95,11,473,579,12,1,244,257,281,517,6,12877,13400,8814,0,0,21,21
3108,CUDDAPAH,Thandur,UDAVAGANDLA,109,4,345,458,39,0,107,146,135,2197,0,6419,8616,5759,5,0,20,25
3109,CUDDAPAH,Vallur,ADIINIMMAYAPALLI,68,1,328,397,31,0,197,228,237,1099,0,6118,7217,4622,0,0,3,3
3110,CUDDAPAH,Vallur,AMBAVARAM,105,0,199,304,83,0,161,244,245,6357,0,14272,20629,10982,27,0,83,110
3111,CUDDAPAH,Vallur,DIGUVA PALLE,34,1,602,637,17,0,271,288,283,1066,0,11350,12416,9030,6,0,12,18
3112,CUDDAPAH,Vallur,DUGGAYAPALLI,178,7,445,630,108,1,175,284,273,3952,20,5775,9747,6230,5,0,5,10
3113,CUDDAPAH,Vallur,GOTUR,193,1,319,513,95,0,116,211,201,2002,0,2492,4494,3647,0,0,0,0
3114,CUDDAPAH,Vallur,KOPPOLU,193,4,374,571,106,0,216,322,329,2934,0,8120,11054,6235,1,0,7,8
3115,CUDDAPAH,Vallur,KOTLURU,270,0,634,904,85,0,294,379,373,1788,0,3059,4847,2863,0,0,0,0
3116,CUDDAPAH,Vallur,KUMARUNI PALLE,73,2,89,164,53,1,64,118,118,1442,72,3213,4727,3224,0,0,4,4
3117,CUDDAPAH,Vallur,LEBAKA(PART),123,3,441,567,69,3,207,279,309,1329,133,7505,8967,5318,1,0,2,3
3118,CUDDAPAH,Vallur,PAIDIKALVA,159,0,870,1029,44,0,289,333,313,1623,0,8934,10557,6748,0,0,0,0
3119,CUDDAPAH,Vallur,PEDDAPUTHA,185,2,327,514,79,0,126,205,159,4729,0,4344,9073,4440,9,0,2,11
3120,CUDDAPAH,Vallur,T.GANGANAPALLE,168,4,283,455,93,4,116,213,200,4369,338,8974,13681,8963,13,2,39,54
3121,CUDDAPAH,Vallur,TAPPETLA,144,4,366,514,70,0,109,179,177,1091,0,1879,2970,2175,0,0,1,1
3122,CUDDAPAH,Vallur,VALLUR,485,15,861,1361,148,0,181,329,310,4660,0,4319,8979,6878,4,0,5,9
3123,CUDDAPAH,Veeraballe,DIGUVA RACHAPALLI,259,0,651,910,112,0,366,478,442,5222,0,23592,28814,16029,5,0,67,72
3124,CUDDAPAH,Veeraballe,GADIKOTA,386,49,597,1032,132,11,151,294,262,6118,449,6153,12720,7418,11,0,14,25
3125,CUDDAPAH,Veeraballe,GURRAPPAGARIPALLI,208,2,975,1185,119,1,546,666,641,7082,6,37147,44235,24094,23,0,140,163
3126,CUDDAPAH,Veeraballe,MATLI,58,44,1126,1228,0,7,172,179,163,0,294,8164,8458,4937,0,0,22,22
3127,CUDDAPAH,Veeraballe,ODIVEEDU,76,0,429,505,24,0,226,250,194,345,0,7900,8245,5041,0,0,9,9
3128,CUDDAPAH,Veeraballe,PEDDIVEEDU,258,0,1336,1594,97,0,333,430,342,4225,0,12760,16985,8538,7,0,17,24
3129,CUDDAPAH,Veeraballe,Sangamvandlapalli,68,0,883,951,0,0,0,0,0,0,0,0,0,0,0,0,0,0
3130,CUDDAPAH,Veeraballe,SANIPAYA,192,2,548,742,34,0,35,69,56,1060,0,1468,2528,1590,1,0,1,2
3131,CUDDAPAH,Veeraballe,SOMAVARAM,162,0,571,733,71,0,305,376,402,3347,0,11831,15178,8364,3,0,10,13
3132,CUDDAPAH,Veeraballe,THATIGUNTLAPALLI,260,159,613,1032,130,60,202,392,353,8013,1298,8172,17483,9652,21,0,18,39
3133,CUDDAPAH,Veeraballe,VEERABALLI,392,32,1373,1797,159,13,447,619,567,7015,493,20529,28037,14458,8,0,28,36
3134,CUDDAPAH,Veeraballe,VONGIMALLA,536,9,1307,1852,177,4,416,597,595,14314,236,29099,43649,23787,54,1,98,153
3135,CUDDAPAH,Veerapunayunipalle,ALIDENA,64,6,518,588,34,6,322,362,373,2574,657,23820,27051,14612,16,6,101,123
3136,CUDDAPAH,Veerapunayunipalle,ANIMELA,221,13,654,888,78,5,291,374,376,4141,346,16508,20995,13404,17,1,51,69
3137,CUDDAPAH,Veerapunayunipalle,GANGIREDDIPALLE,69,1,629,699,30,0,224,254,240,1771,0,13126,14897,9720,5,0,25,30
3138,CUDDAPAH,Veerapunayunipalle,GONUMAKULAPALLE,89,2,372,463,33,0,161,194,192,1466,0,8856,10322,5666,4,0,20,24
3139,CUDDAPAH,Veerapunayunipalle,INDUKUR,241,8,726,975,79,0,298,377,349,3528,0,19702,23230,13905,5,0,52,57
3140,CUDDAPAH,Veerapunayunipalle,KOMMADDI,327,1,860,1188,146,1,314,461,423,7076,19,22059,29154,20315,8,0,66,74
3141,CUDDAPAH,Veerapunayunipalle,MITTAPALLE,125,0,157,282,49,0,58,107,97,1743,0,3196,4939,3255,1,0,11,12
3142,CUDDAPAH,Veerapunayunipalle,MOILLACHERUVU,7,2,457,466,4,1,280,285,286,339,92,20307,20738,11152,2,0,40,42
3143,CUDDAPAH,Veerapunayunipalle,N.PALAGIRI,308,20,817,1145,37,1,76,114,105,564,20,1020,1604,971,0,0,0,0
3144,CUDDAPAH,Veerapunayunipalle,PAYASAMPALLE,140,5,1040,1185,24,1,370,395,385,655,18,16522,17195,11714,0,0,6,6
3145,CUDDAPAH,Veerapunayunipalle,S.PALAGIRI,1,0,470,471,1,0,210,211,216,74,0,16995,17069,13089,0,0,85,85
3146,CUDDAPAH,Veerapunayunipalle,SARVARAJU PETA,62,0,489,551,38,0,203,241,223,3106,0,15935,19041,12118,16,0,63,79
3147,CUDDAPAH,Veerapunayunipalle,TALAPANUR,12,1,249,262,11,0,153,164,164,754,0,11387,12141,8276,3,0,43,46
3148,CUDDAPAH,Veerapunayunipalle,TANGEDUPALLE,246,17,360,623,122,0,129,251,208,9078,0,9679,18757,11646,36,0,33,69
3149,CUDDAPAH,Veerapunayunipalle,U.RAJUPALEM,116,0,469,585,66,0,274,340,328,5128,0,20398,25526,14460,24,0,77,101
3150,CUDDAPAH,Veerapunayunipalle,U.VENKATAPURAM,9,2,324,335,4,0,201,205,196,229,0,15216,15445,10101,0,0,45,45
3151,CUDDAPAH,Veerapunayunipalle,URUTUR,127,0,553,680,69,0,330,399,401,3545,0,19334,22879,18927,5,0,26,31
3152,CUDDAPAH,Veerapunayunipalle,V.NAYUNI PALLE,159,41,510,710,42,11,127,180,180,1483,366,9205,11054,7045,3,1,44,48
3153,CUDDAPAH,Veerapunayunipalle,VELDURTHI,245,0,523,768,117,0,301,418,415,8406,0,24900,33306,18732,26,0,122,148
3154,CUDDAPAH,Veerapunayunipalle,YERRAMALA PALLE,60,1,372,433,30,0,145,175,163,2337,0,11414,13751,7348,6,0,54,60
3155,CUDDAPAH,Vempalle,ALIREDDIPALLE,100,0,340,440,51,0,160,211,211,3189,0,8766,11955,6462,13,0,26,39
3156,CUDDAPAH,Vempalle,ALVALAPADU,132,2,462,596,42,1,175,218,212,2218,25,15227,17470,12062,13,0,85,98
3157,CUDDAPAH,Vempalle,AYYAVARIPALLI,9,4,176,189,7,2,86,95,85,523,106,7451,8080,5884,2,0,48,50
3158,CUDDAPAH,Vempalle,BAKKANNAGARIPALLE,52,281,296,629,12,60,133,205,190,370,2734,8133,11237,8779,1,7,18,26
3159,CUDDAPAH,Vempalle,GIDDANGIVARIPALLI,12,2,338,352,3,1,123,127,124,201,12,7267,7480,5305,1,0,26,27
3160,CUDDAPAH,Vempalle,IDUPULAPAYA,133,13,591,737,62,0,196,258,233,4089,0,10866,14955,9543,17,0,27,44
3161,CUDDAPAH,Vempalle,KATHALURU,175,20,530,725,29,1,199,229,208,885,20,13184,14089,11314,1,0,42,43
3162,CUDDAPAH,Vempalle,KUMMARAMPALLI,26,52,253,331,1,10,134,145,134,42,388,8440,8870,5619,0,1,25,26
3163,CUDDAPAH,Vempalle,KUPPALAPALLI,0,0,0,0,0,0,0,0,0,0,0,0,0,0,0,0,0,0
3164,CUDDAPAH,Vempalle,MUTHUKURU,160,6,596,762,81,1,241,323,333,2362,54,14989,17405,13921,2,0,36,38
3165,CUDDAPAH,Vempalle,NAGURU,75,1,185,261,42,0,66,108,109,2674,0,2883,5557,4387,10,0,9,19
3166,CUDDAPAH,Vempalle,PAMALUR,69,0,331,400,26,0,124,150,143,1161,0,5999,7160,5672,1,0,12,13
3167,CUDDAPAH,Vempalle,RAMIREDDIPALLE,60,0,780,840,11,0,293,304,294,102,0,18395,18497,11604,0,0,60,60
3168,CUDDAPAH,Vempalle,T.VELAMVARIPALLE,85,67,822,974,13,8,231,252,226,367,137,13778,14282,10839,0,0,46,46
3169,CUDDAPAH,Vempalle,TALLAPALLE,225,12,789,1026,46,0,233,279,267,1032,0,13621,14653,9327,1,0,40,41
3170,CUDDAPAH,Vempalle,VEMPALLE,1188,175,6595,7958,161,3,429,593,575,8648,88,19410,28146,23588,15,0,20,35
3171,CUDDAPAH,Vemula,CHAGALERU,275,0,674,949,168,0,421,589,547,12811,0,29023,41834,24675,63,0,98,161
3172,CUDDAPAH,Vemula,CHINTALAJUTUR,42,1,290,333,17,0,126,143,126,920,0,9364,10284,5868,0,0,29,29
3173,CUDDAPAH,Vemula,GOLLALAGUDUR,87,0,375,462,27,0,172,199,177,1963,0,15649,17612,10871,7,0,87,94
3174,CUDDAPAH,Vemula,GONDI PALLE,60,10,318,388,41,3,190,234,220,1621,204,14447,16272,12095,0,0,74,74
3175,CUDDAPAH,Vemula,KANAMKINDA KOTTALU,0,0,140,140,0,0,72,72,70,0,0,5951,5951,4106,0,0,42,42
3176,CUDDAPAH,Vemula,KONAREDDI PALLE,6,1,418,425,0,1,265,266,277,0,47,20154,20201,11817,0,0,86,86
3177,CUDDAPAH,Vemula,MEEDIPENTLA,13,1,663,677,8,0,353,361,373,636,0,24312,24948,17164,3,0,64,67
3178,CUDDAPAH,Vemula,MOBBUCHINTALA PALLE,77,0,339,416,39,0,117,156,150,3162,0,9262,12424,10441,18,0,41,59
3179,CUDDAPAH,Vemula,N.CHERUVUPALLE,147,0,310,457,38,0,181,219,225,1011,0,13952,14963,8855,0,0,63,63
3180,CUDDAPAH,Vemula,PEDDAJUTUR,216,0,628,844,53,0,190,243,228,2422,0,12399,14821,11236,1,0,24,25
3181,CUDDAPAH,Vemula,PENDLURU,103,0,153,256,48,0,76,124,123,1695,0,5029,6724,4777,3,0,23,26
3182,CUDDAPAH,Vemula,V.KOTHAPALLE,93,0,554,647,61,0,312,373,361,3168,0,22575,25743,15970,13,0,103,116
3183,CUDDAPAH,Vemula,VELPULA,74,16,713,803,34,9,360,403,374,1687,614,22011,24312,17212,2,0,55,57
3184,CUDDAPAH,Vemula,VEMULA,209,1,832,1042,12,1,212,225,229,79,11,7933,8023,6081,0,0,3,3
3185,CUDDAPAH,Vontimitta,CHINTARAJUPALLE,205,22,451,678,101,7,190,298,295,4288,376,8866,13530,8992,10,0,25,35
3186,CUDDAPAH,Vontimitta,GANGAPERURU,289,1,468,758,144,1,155,300,278,7403,58,4585,12046,9404,13,0,3,16
3187,CUDDAPAH,Vontimitta,GOLLAPALLE,115,23,183,321,78,9,92,179,191,6188,451,5893,12532,8988,30,0,20,50
3188,CUDDAPAH,Vontimitta,KONARAJUPALLE,150,5,238,393,94,3,112,209,213,4805,144,6785,11734,8457,16,0,27,43
3189,CUDDAPAH,Vontimitta,KONDAMACHUPALLE,10,2,150,162,2,0,16,18,13,171,0,464,635,375,1,0,0,1
3190,CUDDAPAH,Vontimitta,KOTHA MADHAVARAM,119,10,369,498,35,0,72,107,90,2067,0,3132,5199,4374,7,0,10,17
3191,CUDDAPAH,Vontimitta,MANTAPAMPALLE,252,68,577,897,77,23,163,263,228,4294,886,11285,16465,10800,11,1,45,57
3192,CUDDAPAH,Vontimitta,NADIMPALLE,89,5,319,413,37,4,91,132,92,1106,198,5007,6311,3592,1,0,12,13
3193,CUDDAPAH,Vontimitta,NARVAKATIPALLE,186,21,197,404,99,10,86,195,180,6050,690,6909,13649,10576,20,2,34,56
3194,CUDDAPAH,Vontimitta,PENNAPERURU,294,5,394,693,183,3,128,314,311,14284,118,7360,21762,17525,67,1,23,91
3195,CUDDAPAH,Vontimitta,R.GUDIPALLE,178,63,606,847,111,16,395,522,468,6496,408,26761,33665,23019,22,0,101,123
3196,CUDDAPAH,Vontimitta,SALABAD,405,13,301,719,178,6,83,267,235,6187,97,3987,10271,6823,4,0,5,9
3197,CUDDAPAH,Vontimitta,VONTIMITTA,411,26,596,1033,145,3,153,301,271,6698,31,7833,14562,11586,16,0,11,27
3198,CUDDAPAH,Yerraguntla,CHILAMKUR,523,49,1369,1941,87,3,275,365,371,1846,79,9470,11395,10584,1,0,1,2
3199,CUDDAPAH,Yerraguntla,CHINNADANDLURU,99,31,570,700,1,0,20,21,14,20,0,177,197,98,0,0,0,0
3200,CUDDAPAH,Yerraguntla,CHIRRAJUPALLE,1,2,358,361,0,0,171,171,176,0,0,11722,11722,9633,0,0,18,18
3201,CUDDAPAH,Yerraguntla,HANUMANGUTTI,165,5,447,617,75,0,121,196,218,2952,0,2130,5082,4392,2,0,0,2
3202,CUDDAPAH,Yerraguntla,ILLURU,50,0,215,265,28,0,83,111,115,881,0,3460,4341,2871,0,0,4,4
3203,CUDDAPAH,Yerraguntla,KADIRIVARI PALLE,140,0,105,245,57,0,40,97,103,2328,0,2409,4737,4420,2,0,3,5
3204,CUDDAPAH,Yerraguntla,KALAMALLA,244,20,597,861,63,0,118,181,188,1764,0,3795,5559,5125,0,0,0,0
3205,CUDDAPAH,Yerraguntla,KODURU,14,1,268,283,3,0,110,113,107,167,0,7578,7745,7061,0,0,21,21
3206,CUDDAPAH,Yerraguntla,MALEPADU,352,1,475,828,140,0,112,252,259,5183,0,5824,11007,10639,3,0,3,6
3207,CUDDAPAH,Yerraguntla,NIDIZIVVE,9,1,322,332,0,0,65,65,62,0,0,1773,1773,1715,0,0,0,0
3208,CUDDAPAH,Yerraguntla,P. VENKATAPURAM,19,0,130,149,9,0,55,64,69,529,0,2981,3510,3367,0,0,6,6
3209,CUDDAPAH,Yerraguntla,PEDDANAPADU,14,0,325,339,8,0,152,160,159,282,0,9038,9320,8433,0,0,6,6
3210,CUDDAPAH,Yerraguntla,POTLADURTHI,330,0,995,1325,113,0,306,419,430,3391,0,7437,10828,10490,5,0,0,5
3211,CUDDAPAH,Yerraguntla,SUNNAPURALLA PALLE,55,27,156,238,30,23,48,101,99,1338,934,2563,4835,4095,2,1,4,7
3212,CUDDAPAH,Yerraguntla,THIPPALURU,265,1,528,794,128,1,194,323,311,4192,19,7514,11725,8579,1,0,5,6
3213,CUDDAPAH,Yerraguntla,THUMMALA PALLE,73,0,248,321,23,0,145,168,177,835,0,8380,9215,8491,0,0,6,6
3214,CUDDAPAH,Yerraguntla,VALASAPALLE,67,1,215,283,16,0,100,116,117,1115,0,7994,9109,8400,3,0,41,44
3215,CUDDAPAH,Yerraguntla,YERRAGUNTLA,637,36,1719,2392,0,0,34,34,33,0,0,181,181,176,0,0,0,0
3216,EAST GODAVARI,Addateegala,ADDATEEGALA,52,638,252,942,2,204,34,240,236,68,10710,1586,12364,7626,0,19,4,23
3217,EAST GODAVARI,Addateegala,BHIMUDUPAKALU,1,339,11,351,1,254,7,262,273,87,14834,331,15252,8837,0,28,1,29
3218,EAST GODAVARI,Addateegala,BODLANKA,10,260,54,324,6,159,30,195,166,204,11893,1995,14092,7414,0,56,5,61
3219,EAST GODAVARI,Addateegala,D.BHEEMAVARAM,21,817,95,933,10,516,37,563,541,376,29092,1999,31467,17219,1,65,3,69
3220,EAST GODAVARI,Addateegala,D.RAMAVARAM,16,480,40,536,12,343,17,372,355,730,16760,453,17943,9740,1,20,0,21
3221,EAST GODAVARI,Addateegala,DAKODU,2,437,21,460,1,313,15,329,330,115,25916,851,26882,13721,1,118,0,119
3222,EAST GODAVARI,Addateegala,DHANYAMPALEM,1,821,17,839,0,576,9,585,608,0,37039,390,37429,19342,0,98,0,98
3223,EAST GODAVARI,Addateegala,DORAMAMIDI,31,382,136,549,24,309,115,448,425,1706,25921,6479,34106,17804,7,119,17,143
3224,EAST GODAVARI,Addateegala,DUCHERTHI,5,680,20,705,2,430,13,445,430,214,29646,978,30838,15848,1,67,1,69
3225,EAST GODAVARI,Addateegala,GONDOLU,57,369,73,499,39,285,47,371,368,1680,12793,1439,15912,8798,2,20,0,22
3226,EAST GODAVARI,Addateegala,GONTUVANIPALEM,204,45,349,598,104,30,207,341,212,2957,933,8316,12206,4962,0,0,7,7
3227,EAST GODAVARI,Addateegala,KIMMURU,46,158,270,474,30,53,150,233,89,1320,1808,6201,9329,2045,2,2,8,12
3228,EAST GODAVARI,Addateegala,KONALOVA,55,247,265,567,43,208,200,451,351,3329,15853,14833,34015,17728,13,51,54,118
3229,EAST GODAVARI,Addateegala,MATLAPADU,34,238,79,351,27,179,66,272,265,1913,9989,4208,16110,8503,8,24,10,42
3230,EAST GODAVARI,Addateegala,PULIGOGULAPADU,8,359,19,386,5,243,11,259,237,222,14525,368,15115,8237,0,36,0,36
3231,EAST GODAVARI,Addateegala,RAYAPALLE,5,740,70,815,0,460,23,483,460,0,26382,1006,27388,15675,0,47,0,47
3232,EAST GODAVARI,Addateegala,SOMANNAPALEM,4,365,9,378,1,281,4,286,304,12,13544,164,13720,7633,0,7,0,7
3233,EAST GODAVARI,Addateegala,THIMMAPURAM,123,156,284,563,99,83,177,359,324,6050,4684,11518,22252,10854,18,14,30,62
3234,EAST GODAVARI,Addateegala,THUNGAMADUGULA,5,522,64,591,1,320,20,341,336,18,15190,399,15607,8932,0,15,0,15
3235,EAST GODAVARI,Addateegala,VEERAVARAM,0,398,11,409,0,308,6,314,311,0,16074,171,16245,8831,0,24,0,24
3236,EAST GODAVARI,Addateegala,VETAMAMIDI,2,449,8,459,0,310,5,315,313,0,24028,189,24217,13930,0,83,0,83
3237,EAST GODAVARI,Addateegala,YELLAVARAM,46,250,228,524,24,152,98,274,232,776,6678,2500,9954,5611,0,9,1,10
3238,EAST GODAVARI,Ainavilli,AINAVILLI,422,5,349,776,304,2,141,447,388,11471,84,8408,19963,12671,5,0,26,31
3239,EAST GODAVARI,Ainavilli,AINAVILLILANKA,455,1,38,494,313,0,22,335,306,11539,0,1101,12640,9777,12,0,2,14
3240,EAST GODAVARI,Ainavilli,CHINTANA LANKA,232,6,165,403,172,4,103,279,251,7533,143,6553,14229,11224,8,0,12,20
3241,EAST GODAVARI,Ainavilli,K.J.PURAM,141,26,186,353,113,19,97,229,208,6625,910,5279,12814,10308,17,1,12,30
3242,EAST GODAVARI,Ainavilli,KONDUKUDURU,204,7,143,354,175,3,89,267,177,5821,72,2545,8438,3670,11,0,2,13
3243,EAST GODAVARI,Ainavilli,KRAPA,77,10,122,209,58,8,55,121,87,2381,533,1984,4898,3197,0,2,3,5
3244,EAST GODAVARI,Ainavilli,MADUPALLE,228,3,311,542,181,2,220,403,338,6341,41,4797,11179,7083,3,0,0,3
3245,EAST GODAVARI,Ainavilli,MAGAM,352,6,235,593,271,5,129,405,315,8873,84,3853,12810,8629,6,0,2,8
3246,EAST GODAVARI,Ainavilli,NALLACHERUVU,67,8,246,321,56,7,163,226,103,3181,472,8187,11840,5310,4,1,9,14
3247,EAST GODAVARI,Ainavilli,NEDUNURU,721,4,536,1261,542,1,316,859,686,17522,21,9314,26857,16196,11,0,1,12
3248,EAST GODAVARI,Ainavilli,PEDAPALEM,92,2,290,384,58,2,187,247,217,1696,36,5320,7052,5123,2,0,1,3
3249,EAST GODAVARI,Ainavilli,POTHUKURRU,201,2,108,311,150,1,83,234,215,6406,37,4641,11084,7850,9,0,9,18
3250,EAST GODAVARI,Ainavilli,POTTILANKA,156,0,213,369,110,0,113,223,159,5598,0,3600,9198,4603,17,0,4,21
3251,EAST GODAVARI,Ainavilli,S.MULAPALEM,129,1,130,260,95,1,85,181,145,3937,7,2272,6216,4036,4,0,0,4
3252,EAST GODAVARI,Ainavilli,SANAPALLI LANKA,480,4,210,694,332,3,114,449,397,14430,167,4637,19234,13530,18,0,4,22
3253,EAST GODAVARI,Ainavilli,SANKARAIGUDEM,123,3,390,516,92,2,256,350,319,3730,74,11015,14819,10652,4,0,13,17
3254,EAST GODAVARI,Ainavilli,SIRIPALLE,222,8,240,470,166,5,156,327,326,6271,174,4848,11293,8452,1,0,1,2
3255,EAST GODAVARI,Ainavilli,TOTHARAMUDI,521,11,401,933,320,4,128,452,432,16297,225,4915,21437,19140,26,1,2,29
3256,EAST GODAVARI,Ainavilli,VEERAVALLIPALEM,186,3,255,444,103,0,55,158,109,7048,0,1644,8692,5090,29,0,1,30
3257,EAST GODAVARI,Ainavilli,VELUVALAPALLE,171,1,223,395,134,1,160,295,268,7015,26,5653,12694,7967,12,0,3,15
3258,EAST GODAVARI,Ainavilli,VILASA,356,9,450,815,255,7,256,518,501,9841,287,8179,18307,13519,10,1,6,17
3259,EAST GODAVARI,Alamuru,ALAMURU,345,45,518,908,189,22,100,311,264,7832,862,3304,11998,8105,10,0,2,12
3260,EAST GODAVARI,Alamuru,BADUGUVANILANKA,284,1,170,455,184,0,23,207,141,4951,0,491,5442,2872,0,0,0,0
3261,EAST GODAVARI,Alamuru,CHEMUDULANKA,138,5,95,238,70,1,20,91,66,3786,52,852,4690,3384,1,0,0,1
3262,EAST GODAVARI,Alamuru,CHINTALURU,258,5,310,573,145,4,82,231,185,2791,153,1782,4726,2926,0,0,0,0
3263,EAST GODAVARI,Alamuru,CHOPPELA,136,8,678,822,41,3,164,208,83,1771,103,4244,6118,2050,2,0,0,2
3264,EAST GODAVARI,Alamuru,GUMMILERU,238,2,168,408,142,1,63,206,147,3977,46,1560,5583,2410,2,0,0,2
3265,EAST GODAVARI,Alamuru,JONNADA,214,9,219,442,137,6,71,214,161,3104,109,900,4113,2313,0,0,0,0
3266,EAST GODAVARI,Alamuru,KALAVACHERLA,24,1,213,238,13,1,101,115,41,92,1,1296,1389,479,0,0,0,0
3267,EAST GODAVARI,Alamuru,MADIKI,230,3,316,549,100,0,71,171,143,5255,0,3264,8519,5365,13,0,10,23
3268,EAST GODAVARI,Alamuru,MODUKURU,163,1,364,528,95,0,138,233,77,4054,0,3170,7224,1983,1,0,0,1
3269,EAST GODAVARI,Alamuru,MULASTANA AGRAHARAM,117,3,214,334,68,0,59,127,106,4276,0,3451,7727,5582,8,0,6,14
3270,EAST GODAVARI,Alamuru,NARSIPUDDI,187,5,570,762,87,0,165,252,155,1917,0,4255,6172,2560,0,0,0,0
3271,EAST GODAVARI,Alamuru,NAVABUPETA,51,2,176,229,42,2,143,187,105,2285,77,5139,7501,2865,6,0,3,9
3272,EAST GODAVARI,Alamuru,PEDAPALLE,172,5,256,433,114,3,112,229,176,1889,105,2600,4594,2917,0,0,0,0
3273,EAST GODAVARI,Alamuru,PENIKERU,141,6,475,622,104,5,189,298,183,1831,135,2155,4121,1858,0,0,0,0
3274,EAST GODAVARI,Alamuru,PINAPALLE,93,2,541,636,59,0,134,193,118,2255,0,3529,5784,2817,0,0,0,0
3275,EAST GODAVARI,Alamuru,SANDHIPUDI,53,4,436,493,45,3,333,381,132,2129,91,11461,13681,3023,0,0,4,4
3276,EAST GODAVARI,Alamuru,SURYARAO PETA,53,1,236,290,45,0,171,216,202,1769,0,4626,6395,3849,0,0,1,1
3277,EAST GODAVARI,Allavaram,ALLAVARAM,465,8,256,729,211,1,45,257,239,7370,10,958,8338,7044,8,0,0,8
3278,EAST GODAVARI,Allavaram,BENDAMURLANKA,175,20,595,790,98,10,255,363,332,5114,327,6796,12237,9125,14,0,1,15
3279,EAST GODAVARI,Allavaram,BODASAKURRU,330,9,414,753,203,2,143,348,370,9608,39,4682,14329,12887,9,0,1,10
3280,EAST GODAVARI,Allavaram,DEVAGUPTAM,440,2,249,691,300,1,162,463,430,13274,47,7617,20938,17068,13,0,6,19
3281,EAST GODAVARI,Allavaram,DEVAGUPTAMRAVULAPALEM,165,1,171,337,132,1,31,164,119,8804,20,905,9729,6305,26,0,1,27
3282,EAST GODAVARI,Allavaram,GODI,220,4,159,383,140,3,96,239,210,6821,79,5226,12126,9264,9,0,12,21
3283,EAST GODAVARI,Allavaram,GODILANKA,172,0,77,249,112,0,30,142,133,6833,0,2043,8876,7486,10,0,3,13
3284,EAST GODAVARI,Allavaram,GODITHIPPA,20,0,174,194,11,0,65,76,67,306,0,920,1226,884,0,0,0,0
3285,EAST GODAVARI,Allavaram,GUDALA,406,10,240,656,226,4,68,298,254,9562,100,2147,11809,8178,4,0,1,5
3286,EAST GODAVARI,Allavaram,GUNDIPUDI,96,0,171,267,75,0,102,177,170,2529,0,1742,4271,3108,0,0,0,0
3287,EAST GODAVARI,Allavaram,KODURUPADU,295,0,320,615,118,0,99,217,196,5302,0,3224,8526,6272,4,0,1,5
3288,EAST GODAVARI,Allavaram,KOMARAGIRIPATNAM,430,3,902,1335,168,0,149,317,269,8690,0,8341,17031,13209,17,0,11,28
3289,EAST GODAVARI,Allavaram,MOGALLAMURU,268,8,358,634,177,1,156,334,329,14283,48,9888,24219,15858,69,0,36,105
3290,EAST GODAVARI,Allavaram,RELLUGADDA,120,0,68,188,95,0,20,115,97,5439,0,725,6164,3926,10,0,2,12
3291,EAST GODAVARI,Allavaram,S.PALLIPALEM,71,0,204,275,44,0,144,188,184,1872,0,6219,8091,6592,1,0,4,5
3292,EAST GODAVARI,Allavaram,SAMANTHAKURRU,62,1,295,358,39,0,63,102,84,2441,0,3628,6069,4789,9,0,5,14
3293,EAST GODAVARI,Allavaram,TADIKONA,236,3,160,399,161,1,73,235,137,6328,6,1145,7479,3845,6,0,0,6
3294,EAST GODAVARI,Allavaram,THUMMALAPALLE,323,0,108,431,145,0,51,196,169,7480,0,2568,10048,7319,16,0,3,19
3295,EAST GODAVARI,Allavaram,THURPULANKA,117,5,211,333,89,3,135,227,198,3090,60,3302,6452,4254,1,0,0,1
3296,EAST GODAVARI,Allavaram,VODALAREVU,116,2,406,524,36,1,197,234,194,1113,8,7337,8458,6472,1,0,10,11
3297,EAST GODAVARI,Allavaram,YENTRIKONA,210,0,219,429,147,0,70,217,179,4857,0,1816,6673,5214,1,0,0,1
3298,EAST GODAVARI,Amalapuram,A.VEMAVARAM,257,11,195,463,128,3,67,198,175,7223,62,3300,10585,8515,17,0,3,20
3299,EAST GODAVARI,Amalapuram,A.VEMAVARAPADU,207,0,118,325,74,0,53,127,135,4820,0,2331,7151,6491,11,0,1,12
3300,EAST GODAVARI,Amalapuram,BANDARULANKA,359,16,769,1144,205,6,317,528,480,5011,115,6328,11454,9537,2,0,0,2
3301,EAST GODAVARI,Amalapuram,BHATNAVILLI,467,5,190,662,187,1,35,223,218,5963,14,964,6941,6127,3,0,0,3
3302,EAST GODAVARI,Amalapuram,CHINTHADAGARUVU,270,1,140,411,161,1,25,187,181,9778,100,1428,11306,8469,34,1,5,40
3303,EAST GODAVARI,Amalapuram,EDARAPALLE,173,14,62,249,103,6,18,127,128,2803,94,393,3290,2910,0,0,1,1
3304,EAST GODAVARI,Amalapuram,G.AGRAHARAM,213,6,142,361,116,3,52,171,168,2709,58,774,3541,3175,0,0,0,0
3305,EAST GODAVARI,Amalapuram,IMMIDIVARAPPADU,158,0,51,209,123,0,7,130,114,6324,0,190,6514,4571,11,0,0,11
3306,EAST GODAVARI,Amalapuram,INDUPALLE,307,3,412,722,196,2,181,379,391,6831,56,5751,12638,10846,6,0,2,8
3307,EAST GODAVARI,Amalapuram,JANUPALLE,175,3,143,321,116,0,56,172,156,5925,0,3443,9368,7529,5,0,8,13
3308,EAST GODAVARI,Amalapuram,KAMANAGARUVU,947,0,298,1245,316,0,55,371,344,10535,0,1374,11909,9326,8,0,0,8
3309,EAST GODAVARI,Amalapuram,NADIPUDI,160,4,285,449,87,0,145,232,218,1907,0,5327,7234,6023,0,0,5,5
3310,EAST GODAVARI,Amalapuram,NALLAMILLI,182,8,229,419,119,5,106,230,203,5479,102,4265,9846,6548,11,0,4,15
3311,EAST GODAVARI,Amalapuram,PALAGUMMI,343,0,314,657,208,0,197,405,380,5011,0,3783,8794,6142,1,0,1,2
3312,EAST GODAVARI,Amalapuram,PERURU,668,31,616,1315,327,3,192,522,499,7876,44,2685,10605,8838,1,0,0,1
3313,EAST GODAVARI,Amalapuram,REDDIPALLI,102,0,183,285,65,0,69,134,70,3202,0,1653,4855,3095,6,0,1,7
3314,EAST GODAVARI,Amalapuram,ROLLAPALEM,238,20,259,517,140,6,122,268,250,3216,107,1855,5178,4409,0,0,0,0
3315,EAST GODAVARI,Amalapuram,SAKURU,190,0,88,278,112,0,27,139,135,2490,0,937,3427,3086,0,0,1,1
3316,EAST GODAVARI,Amalapuram,SAMANASA,563,4,185,752,305,4,36,345,314,8317,64,765,9146,6732,3,0,0,3
3317,EAST GODAVARI,Amalapuram,SAVARAPPALEM,84,11,172,267,48,6,44,98,71,3218,229,2088,5535,3197,13,0,9,22
3318,EAST GODAVARI,Amalapuram,THANDAVAPALLE,332,5,239,576,210,1,99,310,259,9041,68,3588,12697,7598,20,0,3,23
3319,EAST GODAVARI,Amalapuram,V.CHINTALAPUDI,750,5,121,876,424,4,40,468,439,11278,142,837,12257,9490,8,0,0,8
3320,EAST GODAVARI,Ambajipeta,CHIRATAPUDI,347,10,470,827,233,5,120,358,312,5027,47,1651,6725,4536,0,0,0,0
3321,EAST GODAVARI,Ambajipeta,GANGALAKURRU,363,5,426,794,225,0,222,447,412,11320,0,8502,19822,16324,14,0,2,16
3322,EAST GODAVARI,Ambajipeta,GANGALAKURRU AGRAHARAM,191,16,651,858,87,12,231,330,324,2665,638,8300,11603,10870,0,1,0,1
3323,EAST GODAVARI,Ambajipeta,IRUSUMANDA,264,1,211,476,220,1,121,342,310,11773,22,4712,16507,10832,8,0,0,8
3324,EAST GODAVARI,Ambajipeta,ISUKAPUDI,512,15,359,886,317,10,105,432,409,11509,178,3324,15011,11143,1,0,1,2
3325,EAST GODAVARI,Ambajipeta,K. PEDAPUDI,367,4,369,740,173,0,88,261,248,4812,0,2132,6944,6276,1,0,1,2
3326,EAST GODAVARI,Ambajipeta,KAMUZUVARI LANKA,34,0,172,206,19,0,108,127,120,1387,0,6776,8163,5611,6,0,11,17
3327,EAST GODAVARI,Ambajipeta,MACHAVARAM,975,15,689,1679,623,1,187,811,772,34459,20,7889,42368,39588,53,0,7,60
3328,EAST GODAVARI,Ambajipeta,MOSALIPALLI,233,8,214,455,171,2,116,289,266,7442,55,4309,11806,8814,4,0,3,7
3329,EAST GODAVARI,Ambajipeta,MUKKAMALA,173,5,174,352,129,1,110,240,210,6717,6,6573,13296,8284,12,0,9,21
3330,EAST GODAVARI,Ambajipeta,NANDAMPUDI,231,0,268,499,152,0,164,316,314,9998,0,8935,18933,17006,14,0,4,18
3331,EAST GODAVARI,Ambajipeta,PASUPALLI,169,3,371,543,140,2,294,436,350,8266,149,9545,17960,9691,13,1,3,17
3332,EAST GODAVARI,Ambajipeta,PULLETIKURRU,750,8,490,1248,425,3,154,582,519,8980,52,2637,11669,9233,0,0,0,0
3333,EAST GODAVARI,Ambajipeta,THONDAVARAM,127,3,188,318,83,2,71,156,159,4247,17,3339,7603,6631,3,0,2,5
3334,EAST GODAVARI,Ambajipeta,VAKALAGARUVU,120,2,242,364,70,1,58,129,114,3975,44,2776,6795,5576,4,0,1,5
3335,EAST GODAVARI,Ambajipeta,VAKKALANKA,160,4,274,438,92,3,138,233,215,3199,98,4290,7587,6057,0,0,1,1
3336,EAST GODAVARI,Anaparthi,ANAPARTHY,510,20,1351,1881,321,7,581,909,801,16592,334,30121,47047,26591,18,0,23,41
3337,EAST GODAVARI,Anaparthi,DUPPALAPUDI,142,2,194,338,95,0,86,181,133,5363,0,4238,9601,6797,20,0,12,32
3338,EAST GODAVARI,Anaparthi,KOPPAVARAM,101,2,494,597,64,0,197,261,191,579,0,1773,2352,1310,0,0,0,0
3339,EAST GODAVARI,Anaparthi,KUTUKULURU,170,0,337,507,96,0,110,206,156,2036,0,2718,4754,3121,0,0,0,0
3340,EAST GODAVARI,Anaparthi,LAXMINARASA PURAM,8,0,370,378,6,0,262,268,150,143,0,10205,10348,3414,0,0,17,17
3341,EAST GODAVARI,Anaparthi,MAHENDRAWADA,116,0,298,414,77,0,176,253,160,1717,0,3152,4869,2526,0,0,0,0
3342,EAST GODAVARI,Anaparthi,PEDAPARTHI,49,3,176,228,27,0,70,97,46,611,0,1232,1843,764,0,0,0,0
3343,EAST GODAVARI,Anaparthi,PERA RAMACHANDRAPURAM,168,0,357,525,110,0,111,221,160,7105,0,6377,13482,8432,21,0,15,36
3344,EAST GODAVARI,Anaparthi,POLAMURU,84,8,628,720,39,4,189,232,150,1140,97,8032,9269,4854,0,0,0,0
3345,EAST GODAVARI,Anaparthi,PULAGURTHA,144,17,478,639,61,10,181,252,194,1731,674,2602,5007,2753,1,2,0,3
3346,EAST GODAVARI,Anaparthi,RAMAVARAM,93,5,384,482,20,2,206,228,139,467,50,5543,6060,3359,0,0,0,0
3347,EAST GODAVARI,Atreyapuram,ANKAMPALEM,358,2,242,602,274,0,96,370,263,9470,0,3917,13387,6541,4,0,3,7
3348,EAST GODAVARI,Atreyapuram,ATREYAPURAM,394,6,244,644,270,1,48,319,272,9531,31,1725,11287,7024,1,0,4,5
3349,EAST GODAVARI,Atreyapuram,BOBBERLANKA,224,1,122,347,2,0,5,7,5,37,0,83,120,51,0,0,0,0
3350,EAST GODAVARI,Atreyapuram,KATTUNGA,218,3,162,383,160,2,48,210,174,10039,35,2200,12274,8117,37,0,3,40
3351,EAST GODAVARI,Atreyapuram,LOLLA,96,5,258,359,63,1,48,112,72,3957,41,2075,6073,3180,9,0,2,11
3352,EAST GODAVARI,Atreyapuram,MERLAPALEM,142,0,181,323,76,0,47,123,113,5207,0,1480,6687,5402,15,0,1,16
3353,EAST GODAVARI,Atreyapuram,NARKEDIMILLI,209,1,379,589,163,1,209,373,279,4141,61,4763,8965,5039,0,0,0,0
3354,EAST GODAVARI,Atreyapuram,PERAVARAM,355,0,516,871,189,0,51,240,201,4716,0,720,5436,4044,0,0,0,0
3355,EAST GODAVARI,Atreyapuram,PULIDINDI,165,0,93,258,127,0,68,195,158,5876,0,2618,8494,5187,6,0,1,7
3356,EAST GODAVARI,Atreyapuram,RAJAVARAM,260,2,394,656,192,2,223,417,364,6504,72,6558,13134,8994,2,0,0,2
3357,EAST GODAVARI,Atreyapuram,RYALI,436,1,480,917,263,0,118,381,334,9112,0,3129,12241,8281,2,0,1,3
3358,EAST GODAVARI,Atreyapuram,TATIPUDI,129,0,419,548,90,0,163,253,212,4560,0,4493,9053,6906,5,0,0,5
3359,EAST GODAVARI,Atreyapuram,UTCHILI,102,0,110,212,57,0,20,77,56,3527,0,893,4420,2575,6,0,0,6
3360,EAST GODAVARI,Atreyapuram,VADAPALLE,54,1,172,227,27,1,16,44,32,1280,34,335,1649,1028,0,0,0,0
3361,EAST GODAVARI,Atreyapuram,VADDIPARRU,385,0,134,519,190,0,7,197,182,7863,0,383,8246,6408,8,0,0,8
3362,EAST GODAVARI,Atreyapuram,VASANTHAWADA,110,6,289,405,73,5,187,265,218,2318,286,7087,9691,6260,0,0,0,0
3363,EAST GODAVARI,Atreyapuram,VELICHERU,277,0,271,548,149,0,126,275,195,6009,0,4482,10491,5190,1,0,1,2
3364,EAST GODAVARI,Biccavolu,ARIKAREVULA,84,3,607,694,7,1,324,332,106,129,14,9487,9630,2709,0,0,2,2
3365,EAST GODAVARI,Biccavolu,BALABHADRAPURAM,435,9,1303,1747,158,1,217,376,308,2936,36,4316,7288,4610,0,0,0,0
3366,EAST GODAVARI,Biccavolu,BICCAVOLU,663,66,1816,2545,180,0,373,553,397,4346,0,8694,13040,7407,0,0,1,1
3367,EAST GODAVARI,Biccavolu,ILLAPALLE,274,2,576,852,163,1,284,448,371,4766,25,7051,11842,8072,0,0,0,0
3368,EAST GODAVARI,Biccavolu,KAPAVARAM,330,0,337,667,194,0,112,306,161,6101,0,3818,9919,4505,11,0,8,19
3369,EAST GODAVARI,Biccavolu,KOMARIPALEM,256,1,486,743,103,0,121,224,197,3355,0,3958,7313,5520,0,0,1,1
3370,EAST GODAVARI,Biccavolu,KONKUDURU,260,6,851,1117,200,3,568,771,522,3561,57,11330,14948,6168,0,0,0,0
3371,EAST GODAVARI,Biccavolu,MELLURU,118,5,304,427,101,5,240,346,149,2406,71,4492,6969,1770,0,0,0,0
3372,EAST GODAVARI,Biccavolu,PANDALAPAKA,317,9,763,1089,189,3,299,491,388,5143,140,7950,13233,5534,0,1,3,4
3373,EAST GODAVARI,Biccavolu,RAILWAY STATION PETA,23,0,163,186,0,0,0,0,0,0,0,0,0,0,0,0,0,0
3374,EAST GODAVARI,Biccavolu,RANGAPURAM,206,6,1275,1487,98,1,626,725,688,3435,41,34975,38451,25249,4,0,113,117
3375,EAST GODAVARI,Biccavolu,TOSSIPUDI,202,0,247,449,104,0,50,154,117,3140,0,1167,4307,2885,0,0,0,0
3376,EAST GODAVARI,Biccavolu,VOOLAPALLE,273,9,1473,1755,116,2,443,561,392,2178,31,5868,8077,3993,0,0,0,0
3377,EAST GODAVARI,Chintur,A.G.Koderu,3,652,27,682,1,436,7,444,419,6,2377,31,2414,1257,0,0,0,0
3378,EAST GODAVARI,Chintur,Chadalavada,2,613,7,622,1,216,0,217,214,6,2053,0,2059,1104,0,0,0,0
3379,EAST GODAVARI,Chintur,Chatti,7,609,35,651,1,153,10,164,137,4,750,70,824,497,0,0,0,0
3380,EAST GODAVARI,Chintur,Chidumuru,10,829,2,841,0,118,0,118,102,0,1212,0,1212,720,0,0,0,0
3381,EAST GODAVARI,Chintur,Chintoor,73,1124,195,1392,0,175,0,175,175,0,1681,0,1681,1086,0,0,0,0
3382,EAST GODAVARI,Chintur,Edugurallapally,8,991,84,1083,0,33,1,34,33,0,209,3,212,120,0,0,0,0
3383,EAST GODAVARI,Chintur,Guduru,6,427,1,434,0,136,0,136,138,0,1314,0,1314,829,0,0,0,0
3384,EAST GODAVARI,Chintur,Kalleru,4,467,69,540,2,121,35,158,181,13,1234,332,1579,996,0,0,0,0
3385,EAST GODAVARI,Chintur,Kothapally,1,377,6,384,0,26,0,26,29,0,190,0,190,109,0,0,0,0
3386,EAST GODAVARI,Chintur,Kummur,8,535,0,543,3,235,0,238,186,19,1932,0,1951,1031,0,0,0,0
3387,EAST GODAVARI,Chintur,Mothugudem,266,87,212,565,15,0,1,16,17,170,0,3,173,100,0,0,0,0
3388,EAST GODAVARI,Chintur,Mukunuru,0,529,3,532,0,292,1,293,273,0,4292,12,4304,2394,0,0,0,0
3389,EAST GODAVARI,Chintur,Pedaseetanapally,6,600,2,608,3,322,1,326,288,29,3159,9,3197,1703,0,0,0,0
3390,EAST GODAVARI,Chintur,Pega,1,1303,18,1322,0,84,0,84,65,0,577,0,577,275,0,0,0,0
3391,EAST GODAVARI,Chintur,Tummala,12,883,4,899,0,58,0,58,53,0,524,0,524,261,0,0,0,0
3392,EAST GODAVARI,Devipatnam,CH.RAMANAYYAPET,65,540,386,991,44,347,172,563,455,2026,18289,7649,27964,13947,3,34,12,49
3393,EAST GODAVARI,Devipatnam,CHOPPAKONDA,1,489,11,501,0,370,7,377,346,0,19249,208,19457,9686,0,31,0,31
3394,EAST GODAVARI,Devipatnam,DEVARAM,15,418,87,520,11,243,56,310,244,618,16243,2988,19849,9182,2,52,7,61
3395,EAST GODAVARI,Devipatnam,DEVIPATNAM,201,264,577,1042,81,160,160,401,339,1635,5346,3844,10825,5770,0,3,0,3
3396,EAST GODAVARI,Devipatnam,INDUKURU,136,937,318,1391,70,438,142,650,546,1251,22234,3127,26612,13053,1,62,3,66
3397,EAST GODAVARI,Devipatnam,INDUKURUPETA,69,135,704,908,35,71,145,251,139,2119,4037,2558,8714,4250,8,3,2,13
3398,EAST GODAVARI,Devipatnam,KONDAMODALU,7,711,76,794,6,539,53,598,584,246,22372,1911,24529,13600,1,4,0,5
3399,EAST GODAVARI,Devipatnam,MANTURU,9,409,67,485,1,280,28,309,287,96,15255,862,16213,9457,0,28,1,29
3400,EAST GODAVARI,Devipatnam,PALEM,0,362,10,372,0,295,6,301,312,0,21813,163,21976,11770,0,62,0,62
3401,EAST GODAVARI,Devipatnam,PAMUGANDI,5,490,13,508,2,372,4,378,379,132,30048,184,30364,14770,1,122,1,124
3402,EAST GODAVARI,Devipatnam,PUDIPALLE,45,419,187,651,21,268,78,367,283,1093,11206,3011,15310,7234,3,19,3,25
3403,EAST GODAVARI,Devipatnam,SARABHAVARAM,36,271,179,486,14,172,116,302,256,425,10119,6204,16748,7603,0,31,15,46
3404,EAST GODAVARI,Devipatnam,THUMMURU,1,340,1,342,0,277,0,277,297,0,19481,0,19481,10735,0,66,0,66
3405,EAST GODAVARI,Devipatnam,V.RAMANAPALEM,4,478,16,498,2,322,5,329,328,75,21146,56,21277,11323,0,71,0,71
3406,EAST GODAVARI,Gandepalle,BORRAMPALEM,25,1,265,291,14,1,116,131,41,815,3,4379,5197,1524,1,0,4,5
3407,EAST GODAVARI,Gandepalle,GANDEPALLE,251,9,1144,1404,73,1,253,327,245,4261,20,12303,16584,9960,17,0,30,47
3408,EAST GODAVARI,Gandepalle,K. NAYAKAMPALLE,147,1,185,333,107,0,30,137,119,6309,0,1251,7560,5428,18,0,2,20
3409,EAST GODAVARI,Gandepalle,K.GOPALAPURAM,67,113,429,609,36,57,226,319,268,2584,2701,12876,18161,8166,8,6,34,48
3410,EAST GODAVARI,Gandepalle,MALLEPALLI,269,7,1554,1830,132,1,487,620,319,5664,1,18808,24473,9337,14,0,38,52
3411,EAST GODAVARI,Gandepalle,MURARI,546,2,1150,1698,247,0,177,424,330,12467,0,6831,19298,11106,28,0,15,43
3412,EAST GODAVARI,Gandepalle,N.T.RAJAPURAM,126,0,399,525,51,0,131,182,161,1807,0,5664,7471,5503,3,0,6,9
3413,EAST GODAVARI,Gandepalle,NEELADRIRAOPETA,189,0,1505,1694,104,0,470,574,527,5916,0,23635,29551,22245,15,0,45,60
3414,EAST GODAVARI,Gandepalle,P. NAYAKAMPALLE,158,20,327,505,50,2,109,161,90,1869,25,4839,6733,3052,2,0,14,16
3415,EAST GODAVARI,Gandepalle,P.SURAMPALEM,223,2,784,1009,108,0,184,292,168,4795,0,5919,10714,4421,10,0,12,22
3416,EAST GODAVARI,Gandepalle,RAMAYYAPALEM,8,0,423,431,0,0,79,79,56,0,0,1834,1834,939,0,0,4,4
3417,EAST GODAVARI,Gandepalle,SINGARAMPALEM,146,0,186,332,71,0,64,135,107,3542,0,3547,7089,4994,10,0,13,23
3418,EAST GODAVARI,Gandepalle,SUBBAYAMMA PETA,2,0,369,371,1,0,286,287,244,100,0,14512,14612,8067,1,0,32,33
3419,EAST GODAVARI,Gandepalle,TALLURU,161,1,531,693,4,0,105,109,73,130,0,5824,5954,3358,1,0,14,15
3420,EAST GODAVARI,Gandepalle,UPPALAPADU,166,0,752,918,75,0,200,275,142,2501,0,8882,11383,5435,3,0,27,30
3421,EAST GODAVARI,Gandepalle,YELLAMILLI,263,11,581,855,70,4,219,293,137,3764,125,9447,13336,4058,11,0,25,36
3422,EAST GODAVARI,Gandepalle,YERRAMPALEM,286,10,271,567,70,1,118,189,4,3592,36,5472,9100,59,7,0,8,15
3423,EAST GODAVARI,Gandepalle,Z.RAGAMPETA,357,5,355,717,164,5,56,225,184,7772,70,2029,9871,4984,18,0,3,21
3424,EAST GODAVARI,Gangavaram,AMUDALABANDA,20,336,15,371,17,275,3,295,286,971,20224,125,21320,11912,2,66,0,68
3425,EAST GODAVARI,Gangavaram,BAYYANAPALLI,4,278,24,306,1,196,18,215,167,86,8443,848,9377,4731,0,18,1,19
3426,EAST GODAVARI,Gangavaram,DORAMAMIDI,5,256,18,279,5,216,8,229,219,430,17542,556,18528,10367,2,81,0,83
3427,EAST GODAVARI,Gangavaram,GANGAVARAM,6,383,58,447,4,294,30,328,315,243,24527,1687,26457,15233,0,101,5,106
3428,EAST GODAVARI,Gangavaram,JAGGAMPALEM,13,232,78,323,9,149,13,171,156,295,10068,647,11010,7231,0,35,2,37
3429,EAST GODAVARI,Gangavaram,JIYYAMPALEM,18,166,109,293,15,134,92,241,237,676,8970,5486,15132,9848,2,32,11,45
3430,EAST GODAVARI,Gangavaram,KOTHADA,11,256,10,277,7,151,4,162,148,174,7368,157,7699,3894,0,19,0,19
3431,EAST GODAVARI,Gangavaram,LAKKONDA,17,531,33,581,12,353,21,386,410,571,24578,1071,26220,14137,0,94,2,96
3432,EAST GODAVARI,Gangavaram,MARRIPALEM,1,416,15,432,0,322,14,336,339,0,27702,668,28370,14885,0,121,1,122
3433,EAST GODAVARI,Gangavaram,MOHANAPURAM,1,335,30,366,0,224,20,244,253,0,18773,1134,19907,10316,0,87,5,92
3434,EAST GODAVARI,Gangavaram,MOLLERU,57,352,880,1289,29,173,325,527,486,1902,10570,13878,26350,14180,3,35,29,67
3435,EAST GODAVARI,Gangavaram,NELLIPUDI,525,221,684,1430,235,126,339,700,726,12193,5858,13695,31746,18207,34,6,18,58
3436,EAST GODAVARI,Gangavaram,PANDRAPROLU,4,432,3,439,2,349,3,354,366,119,32070,74,32263,17193,0,139,0,139
3437,EAST GODAVARI,Gangavaram,PIDATHAMAMIDI,76,376,254,706,39,189,140,368,348,3110,14456,7489,25055,14890,17,62,27,106
3438,EAST GODAVARI,Gangavaram,SURAMPALEM,2,369,31,402,0,265,6,271,278,0,20497,319,20816,12176,0,89,0,89
3439,EAST GODAVARI,Gangavaram,YENDAPALLI,1,522,27,550,0,418,6,424,448,0,35286,402,35688,20584,0,145,0,145
3440,EAST GODAVARI,Gangavaram,ZADERU,15,632,59,706,8,417,41,466,457,157,24817,1039,26013,14754,0,69,0,69
3441,EAST GODAVARI,Gokavaram,ATCHUTAPURAM,287,0,378,665,137,0,127,264,124,5417,0,5224,10641,3285,8,0,11,19
3442,EAST GODAVARI,Gokavaram,GADELAPALEM,112,5,260,377,82,4,138,224,128,5683,273,5034,10990,4696,24,1,11,36
3443,EAST GODAVARI,Gokavaram,GANGAM PALEM,51,192,643,886,10,120,290,420,211,588,8397,15964,24949,10121,2,29,49,80
3444,EAST GODAVARI,Gokavaram,GOKAVARAM,493,64,723,1280,170,4,92,266,206,9001,261,1809,11071,5675,38,2,1,41
3445,EAST GODAVARI,Gokavaram,GUMMALADODDI,198,3,466,667,62,0,110,172,114,3345,0,6464,9809,5290,9,0,23,32
3446,EAST GODAVARI,Gokavaram,ITIKAYALA PALLE,187,8,470,665,72,3,127,202,142,3137,98,5612,8847,4309,5,0,18,23
3447,EAST GODAVARI,Gokavaram,KAMARAJU PETA,165,80,1626,1871,78,54,692,824,614,3517,3030,31028,37575,20040,5,8,46,59
3448,EAST GODAVARI,Gokavaram,KOTHAPALLI,417,102,800,1319,77,48,229,354,183,3054,2443,13809,19306,7977,7,6,34,47
3449,EAST GODAVARI,Gokavaram,KRISHNUNI PALEM,420,216,205,841,140,147,46,333,299,6308,7667,2027,16002,10423,12,16,2,30
3450,EAST GODAVARI,Gokavaram,MALLAVARAM,312,33,1274,1619,102,4,513,619,416,1920,44,10890,12854,6320,0,0,4,4
3451,EAST GODAVARI,Gokavaram,RAMPA YERRAMPALEM,423,12,1570,2005,172,5,580,757,360,8630,158,18791,27579,11754,25,0,33,58
3452,EAST GODAVARI,Gokavaram,THANTI KONDA,336,29,844,1209,165,2,215,382,250,9486,203,10593,20282,9678,33,1,37,71
3453,EAST GODAVARI,Gokavaram,TIRUMALAYAPALEM,175,5,614,794,66,2,168,236,86,3016,169,6461,9646,2983,10,1,8,19
3454,EAST GODAVARI,Gokavaram,VEDURUPAKA,117,0,837,954,42,0,242,284,182,1645,0,9821,11466,6311,3,0,14,17
3455,EAST GODAVARI,Gollaprolu,A.K. MALLAVARAM,351,1,534,886,251,0,279,530,233,6885,0,5673,12558,3949,1,0,1,2
3456,EAST GODAVARI,Gollaprolu,A.P. MALLAVARAM,47,0,479,526,29,0,318,347,160,532,0,4006,4538,1690,0,0,0,0
3457,EAST GODAVARI,Gollaprolu,A.VIJAYANAGARAM,242,0,95,337,194,0,55,249,177,16093,0,3365,19458,8655,85,0,6,91
3458,EAST GODAVARI,Gollaprolu,CHEBROLU,395,5,2186,2586,48,0,562,610,175,1005,0,21655,22660,4607,1,0,36,37
3459,EAST GODAVARI,Gollaprolu,CHENDURTHI,424,14,940,1378,276,10,537,823,540,11475,330,26751,38556,18012,18,0,55,73
3460,EAST GODAVARI,Gollaprolu,CHINA JAGGAMPETA,125,0,770,895,86,0,369,455,410,6424,0,20328,26752,14299,23,0,39,62
3461,EAST GODAVARI,Gollaprolu,DURGADA,499,3,1931,2433,267,0,582,849,346,12296,0,20371,32667,10015,27,0,13,40
3462,EAST GODAVARI,Gollaprolu,GOLLAPROLU,628,7,308,943,0,0,0,0,0,0,0,0,0,0,0,0,0,0
3463,EAST GODAVARI,Gollaprolu,KODAVALI,427,3,789,1219,250,1,430,681,501,8912,16,16996,25924,13166,10,0,27,37
3464,EAST GODAVARI,Gollaprolu,TATIPARTHI,340,3,1090,1433,175,1,297,473,161,11910,6,13311,25227,6771,52,0,26,78
3465,EAST GODAVARI,Gollaprolu,VANNEPUDI,155,3,971,1129,108,0,309,417,120,4672,0,7873,12545,3116,9,0,1,10
3466,EAST GODAVARI,I Polavaram,BHYRAMPALEM,0,0,3,3,0,0,0,0,0,0,0,0,0,0,0,0,0,0
3467,EAST GODAVARI,I Polavaram,G.MOOLAPALEM,237,11,403,651,162,4,216,382,270,8646,178,8505,17329,10290,16,0,3,19
3468,EAST GODAVARI,I Polavaram,G.VEMAVARAM,325,13,730,1068,242,11,305,558,263,14301,445,9191,23937,10663,43,0,16,59
3469,EAST GODAVARI,I Polavaram,GOGULLANKA,258,0,135,393,214,0,103,317,242,18420,0,7818,26238,14342,96,0,32,128
3470,EAST GODAVARI,I Polavaram,GUTHINADEEVI,194,14,355,563,111,5,197,313,263,4252,123,7816,12191,8773,3,0,2,5
3471,EAST GODAVARI,I Polavaram,I.POLAVARAM,289,5,626,920,209,3,288,500,444,8239,54,8378,16671,11466,1,0,0,1
3472,EAST GODAVARI,I Polavaram,KESANAKURRU,851,10,800,1661,590,3,379,972,834,19280,87,10773,30140,19694,22,0,11,33
3473,EAST GODAVARI,I Polavaram,KOMARAGIRI,378,1,225,604,316,1,131,448,338,14226,26,3977,18229,11771,6,0,1,7
3474,EAST GODAVARI,I Polavaram,MURAMALLA,180,16,242,438,134,6,175,315,293,6509,446,8509,15464,13297,4,2,5,11
3475,EAST GODAVARI,I Polavaram,PASUVULLANKA,302,1,82,385,143,0,18,161,161,5399,0,449,5848,5171,1,0,0,1
3476,EAST GODAVARI,I Polavaram,PATHA INJARAM,289,1,164,454,218,1,83,302,252,10879,45,4475,15399,9421,3,0,7,10
3477,EAST GODAVARI,I Polavaram,T.KOTHAPALLE,612,12,759,1383,352,6,409,767,617,9930,261,15036,25227,15574,5,0,11,16
3478,EAST GODAVARI,I Polavaram,THILLAKKUPPA,230,4,250,484,173,4,121,298,208,8173,163,3890,12226,7150,3,0,3,6
3479,EAST GODAVARI,I Polavaram,YEDURULANKA,273,1,187,461,222,0,107,329,293,12665,0,4790,17455,12066,32,0,5,37
3480,EAST GODAVARI,Jaggampeta,GOLLALAGUNTA,77,2,431,510,60,1,294,355,333,2581,61,12560,15202,7955,3,0,12,15
3481,EAST GODAVARI,Jaggampeta,GOVINDAPURAM,88,200,361,649,59,180,235,474,378,3641,14013,12711,30365,14745,14,74,36,124
3482,EAST GODAVARI,Jaggampeta,GURRAPALEM,140,4,1236,1380,99,0,530,629,527,5877,0,22994,28871,13822,9,0,44,53
3483,EAST GODAVARI,Jaggampeta,IRRIPAKA,251,1,757,1009,167,0,420,587,346,4716,0,9374,14090,5478,0,0,2,2
3484,EAST GODAVARI,Jaggampeta,J.KOTHURU,207,1,690,898,136,0,387,523,222,3535,0,11460,14995,4047,3,0,16,19
3485,EAST GODAVARI,Jaggampeta,JAGGAMPETA,562,22,2117,2701,184,5,467,656,599,9986,170,19041,29197,20044,30,0,34,64
3486,EAST GODAVARI,Jaggampeta,KANDREGULA,94,0,483,577,62,0,191,253,85,2303,0,6027,8330,1810,0,0,2,2
3487,EAST GODAVARI,Jaggampeta,KATRAVULAPALLE,432,12,2134,2578,201,2,354,557,285,9421,19,11849,21289,7966,23,0,20,43
3488,EAST GODAVARI,Jaggampeta,MALLISALA,222,16,841,1079,101,8,280,389,286,5132,182,9260,14574,9302,18,0,25,43
3489,EAST GODAVARI,Jaggampeta,MAMIDADA,125,3,736,864,79,0,398,477,208,3325,0,18414,21739,7427,6,0,33,39
3490,EAST GODAVARI,Jaggampeta,MANYANVARI PALEM,70,0,738,808,36,0,447,483,436,1366,0,18006,19372,8049,1,0,26,27
3491,EAST GODAVARI,Jaggampeta,MARRIPAKA,153,4,503,660,103,1,207,311,226,2912,5,9807,12724,6572,2,0,17,19
3492,EAST GODAVARI,Jaggampeta,NARENDRAPATNAM,392,62,787,1241,251,39,454,744,373,13373,3022,23480,39875,12872,31,13,66,110
3493,EAST GODAVARI,Jaggampeta,RAJAPUDI,139,7,1284,1430,31,0,539,570,436,1014,0,23483,24497,13027,1,0,57,58
3494,EAST GODAVARI,Jaggampeta,RAMAVARAM,216,6,1170,1392,142,1,312,455,360,6244,83,13677,20004,8496,2,0,13,15
3495,EAST GODAVARI,Jaggampeta,VENGAYAMMA PURAM,5,0,549,554,2,0,327,329,260,73,0,10901,10974,5531,0,0,16,16
3496,EAST GODAVARI,K.Gangavaram,ADDAMPALLE,88,4,384,476,67,1,200,268,164,1696,8,4408,6112,2944,0,0,0,0
3497,EAST GODAVARI,K.Gangavaram,AMJURU,253,7,377,637,140,6,195,341,282,2798,78,3094,5970,3098,1,0,0,1
3498,EAST GODAVARI,K.Gangavaram,BALANTHARAM,137,2,227,366,70,0,126,196,170,1859,0,2617,4476,2496,0,0,0,0
3499,EAST GODAVARI,K.Gangavaram,BHATLA PALIKA,403,6,437,846,287,4,242,533,442,8039,77,3609,11725,6236,0,0,0,0
3500,EAST GODAVARI,K.Gangavaram,BRAHMAPURI,4,0,240,244,2,0,137,139,105,42,0,4333,4375,2997,0,0,2,2
3501,EAST GODAVARI,K.Gangavaram,DANGERU,268,1,1217,1486,193,1,796,990,823,4898,19,18242,23159,11827,3,0,4,7
3502,EAST GODAVARI,K.Gangavaram,G.BHAGA,29,0,239,268,19,0,143,162,149,540,0,2349,2889,1401,0,0,0,0
3503,EAST GODAVARI,K.Gangavaram,GANGAVARAM,209,3,526,738,125,1,116,242,196,2261,10,1935,4206,2712,0,0,0,0
3504,EAST GODAVARI,K.Gangavaram,KOOLLA,273,5,734,1012,197,1,394,592,437,4597,24,6608,11229,5233,0,0,1,1
3505,EAST GODAVARI,K.Gangavaram,KOTA,353,4,520,877,251,3,198,452,355,6621,33,3553,10207,5770,3,0,2,5
3506,EAST GODAVARI,K.Gangavaram,KOTIPALLE,100,2,464,566,76,0,120,196,157,1537,0,3360,4897,2935,0,0,2,2
3507,EAST GODAVARI,K.Gangavaram,KUDUPURU,81,4,365,450,70,3,218,291,195,2144,61,4432,6637,2844,0,0,0,0
3508,EAST GODAVARI,K.Gangavaram,KUNDURU,129,4,804,937,91,1,395,487,352,1096,7,3873,4976,2205,0,0,0,0
3509,EAST GODAVARI,K.Gangavaram,MASAKAPALLE,0,0,443,443,0,0,274,274,245,0,0,5360,5360,3187,0,0,0,0
3510,EAST GODAVARI,K.Gangavaram,PAMARRU,198,3,439,640,130,0,205,335,260,2970,0,2615,5585,3253,0,0,0,0
3511,EAST GODAVARI,K.Gangavaram,PANINGAPALLE,162,19,200,381,108,7,101,216,190,2781,136,2515,5432,3172,2,0,0,2
3512,EAST GODAVARI,K.Gangavaram,PEKERU,4,1,231,236,2,1,153,156,99,83,56,8863,9002,3941,0,0,20,20
3513,EAST GODAVARI,K.Gangavaram,SATYAWADA,105,8,698,811,75,2,265,342,175,2510,46,5138,7694,2487,0,0,2,2
3514,EAST GODAVARI,K.Gangavaram,SERILANKA,304,0,36,340,209,0,8,217,171,7548,0,113,7661,4134,0,0,0,0
3515,EAST GODAVARI,K.Gangavaram,SIVALA,124,6,382,512,88,3,212,303,235,2638,80,5070,7788,4183,0,0,0,0
3516,EAST GODAVARI,K.Gangavaram,SUNDARAPALLE,129,2,292,423,90,2,170,262,111,4521,19,5081,9621,3557,8,0,3,11
3517,EAST GODAVARI,K.Gangavaram,TALLAPADU,209,2,249,460,158,0,179,337,297,5341,0,5094,10435,5488,2,0,3,5
3518,EAST GODAVARI,K.Gangavaram,THAMARAPALLE,142,1,198,341,105,1,91,197,128,5248,18,3164,8430,4181,8,0,2,10
3519,EAST GODAVARI,K.Gangavaram,UDUMUDI,30,0,278,308,25,0,205,230,59,1613,0,8947,10560,2696,4,0,13,17
3520,EAST GODAVARI,K.Gangavaram,Y.POTHAVARAM,148,24,508,680,69,7,214,290,230,2594,120,4686,7400,3787,0,0,3,3
3521,EAST GODAVARI,K.Gangavaram,YENDAGANDI,141,2,263,406,92,2,139,233,180,2944,22,3465,6431,3362,0,0,0,0
3522,EAST GODAVARI,Kadiam,DAMIREDDIPALLE,101,2,26,129,23,2,5,30,26,282,14,62,358,279,0,0,0,0
3523,EAST GODAVARI,Kadiam,DULLA,238,6,271,515,134,0,38,172,85,7079,0,1361,8440,2556,21,0,3,24
3524,EAST GODAVARI,Kadiam,JEGURUPADU,178,7,188,373,61,1,28,90,51,3895,26,1396,5317,2498,7,0,3,10
3525,EAST GODAVARI,Kadiam,KADIAM,270,2,320,592,58,1,40,99,81,1929,20,580,2529,1690,0,0,0,0
3526,EAST GODAVARI,Kadiam,KADIAMPUSAVARAM,74,1,219,294,12,0,16,28,21,399,0,264,663,317,1,0,0,1
3527,EAST GODAVARI,Kadiam,KADIYAPULANKA,185,16,261,462,5,0,40,45,41,84,0,484,568,525,0,0,0,0
3528,EAST GODAVARI,Kadiam,MADHAVARAYUDUPALEM,151,16,527,694,40,5,184,229,65,2011,274,5986,8271,1812,6,1,17,24
3529,EAST GODAVARI,Kadiam,MURAMANDA,417,16,232,665,160,1,44,205,168,7135,5,847,7987,4859,9,0,0,9
3530,EAST GODAVARI,Kadiam,POTTILANKA,190,0,119,309,47,0,19,66,35,1348,0,321,1669,745,0,0,0,0
3531,EAST GODAVARI,Kadiam,VEERAVARAM,88,1,106,195,10,0,21,31,27,141,0,313,454,348,0,0,0,0
3532,EAST GODAVARI,Kadiam,VEMAGIRI,177,22,455,654,33,2,54,89,78,456,8,789,1253,1109,0,0,0,0
3533,EAST GODAVARI,Kajuluru,ANDRANGI,62,2,312,376,42,2,163,207,170,1210,37,5592,6839,4202,0,0,3,3
3534,EAST GODAVARI,Kajuluru,ARYAVATAM,327,13,665,1005,66,0,122,188,149,1348,0,3087,4435,3063,0,0,0,0
3535,EAST GODAVARI,Kajuluru,BANDANAPUDI,169,4,260,433,110,1,108,219,112,3755,55,3307,7117,2813,0,0,1,1
3536,EAST GODAVARI,Kajuluru,CHEDUVADA,145,4,187,336,101,2,115,218,179,2760,100,2313,5173,2587,0,0,0,0
3537,EAST GODAVARI,Kajuluru,DUGGUDURRU,382,8,514,904,303,8,204,515,496,16630,168,6639,23437,13535,49,0,2,51
3538,EAST GODAVARI,Kajuluru,GOLLAPALEM,369,1,333,703,186,1,15,202,161,4627,8,126,4761,2492,4,0,0,4
3539,EAST GODAVARI,Kajuluru,ITHAPUDI,46,9,393,448,33,6,222,261,142,936,135,4426,5497,2571,0,0,0,0
3540,EAST GODAVARI,Kajuluru,JAGANNATHAGIRI,103,0,265,368,55,0,138,193,146,2382,0,5685,8067,4233,0,0,2,2
3541,EAST GODAVARI,Kajuluru,KAJULURU,301,14,1708,2023,124,9,136,269,174,2835,224,1996,5055,2565,0,0,0,0
3542,EAST GODAVARI,Kajuluru,KOLANKA,232,14,320,566,131,0,101,232,172,3373,0,1129,4502,2370,0,0,0,0
3543,EAST GODAVARI,Kajuluru,KUYYERU,161,7,916,1084,86,3,412,501,369,1438,35,7651,9124,3754,0,0,3,3
3544,EAST GODAVARI,Kajuluru,MANJERU,235,7,329,571,157,2,66,225,161,5130,12,1537,6679,3104,1,0,0,1
3545,EAST GODAVARI,Kajuluru,MATHUKUMILLI,45,2,171,218,31,2,86,119,68,2085,116,4778,6979,3970,8,0,17,25
3546,EAST GODAVARI,Kajuluru,NAMAVANIPALEM,149,0,58,207,109,0,30,139,106,4978,0,1016,5994,3573,1,0,0,1
3547,EAST GODAVARI,Kajuluru,ONTITHADI,172,0,56,228,138,0,41,179,155,4372,0,1292,5664,2973,0,0,0,0
3548,EAST GODAVARI,Kajuluru,PALLI PALEM,282,5,1178,1465,128,1,333,462,408,3776,41,8593,12410,7438,3,0,4,7
3549,EAST GODAVARI,Kajuluru,PEDALANKA,85,0,93,178,75,0,28,103,72,1281,0,254,1535,965,0,0,0,0
3550,EAST GODAVARI,Kajuluru,PENUMALLA,120,5,352,477,80,3,143,226,172,3854,106,5074,9034,4546,2,0,1,3
3551,EAST GODAVARI,Kajuluru,SEELA,184,9,636,829,128,2,232,362,219,2906,21,2713,5640,2013,0,0,0,0
3552,EAST GODAVARI,Kajuluru,SELAPAKA,430,0,80,510,276,0,34,310,217,5783,0,382,6165,2853,1,0,0,1
3553,EAST GODAVARI,Kajuluru,T.MAMIDADA,10,0,174,184,8,0,106,114,70,380,0,3009,3389,1614,0,0,0,0
3554,EAST GODAVARI,Kajuluru,TANUKUWADA,1,2,323,326,1,0,238,239,191,16,0,6030,6046,3092,0,0,0,0
3555,EAST GODAVARI,Kajuluru,TANUMALLA,118,0,61,179,90,0,39,129,103,4020,0,1372,5392,2811,2,0,0,2
3556,EAST GODAVARI,Kajuluru,TARLAMPUDI,73,2,189,264,65,0,142,207,165,2902,0,4254,7156,2920,2,0,0,2
3557,EAST GODAVARI,Kajuluru,TIPPARAJU PALEM,175,1,235,411,105,1,146,252,154,4186,38,5273,9497,4000,1,0,2,3
3558,EAST GODAVARI,Kajuluru,UPPUMILLI,73,7,236,316,33,2,113,148,102,1250,118,4804,6172,3134,1,0,3,4
3559,EAST GODAVARI,Kakinada (Rural),CHIDIGA,16,0,351,367,6,0,116,122,120,111,0,3479,3590,2973,0,0,0,0
3560,EAST GODAVARI,Kakinada (Rural),GANGANAPALLI,164,1,216,381,84,0,13,97,66,4266,0,462,4728,2987,9,0,0,9
3561,EAST GODAVARI,Kakinada (Rural),INDRA PALEM,22,0,188,210,6,0,38,44,37,42,0,337,379,286,0,0,0,0
3562,EAST GODAVARI,Kakinada (Rural),KOVVADA,206,0,186,392,79,0,12,91,71,6116,0,338,6454,3428,27,0,0,27
3563,EAST GODAVARI,Kakinada (Rural),KOVVURU,324,36,205,565,158,4,61,223,169,4370,85,1329,5784,3411,0,0,0,0
3564,EAST GODAVARI,Kakinada (Rural),NEMAM,194,3,1082,1279,140,1,785,926,772,8074,17,29513,37604,20536,10,0,24,34
3565,EAST GODAVARI,Kakinada (Rural),P.VENKATAPURAM,6,1,201,208,3,0,104,107,92,59,0,3253,3312,2487,0,0,3,3
3566,EAST GODAVARI,Kakinada (Rural),PANDURU,209,3,752,964,132,1,111,244,169,7572,90,4733,12395,7325,16,0,8,24
3567,EAST GODAVARI,Kakinada (Rural),PENUMARTHI,181,0,75,256,103,0,31,134,110,3841,0,1295,5136,3824,1,0,0,1
3568,EAST GODAVARI,Kakinada (Rural),RAMANAYYAPETA,28,1,223,252,1,0,52,53,50,79,0,2556,2635,2472,0,0,6,6
3569,EAST GODAVARI,Kakinada (Rural),REPURU,40,0,638,678,18,0,36,54,24,1031,0,1557,2588,1042,5,0,5,10
3570,EAST GODAVARI,Kakinada (Rural),S.ATCHUTAPURAM,46,0,105,151,0,0,0,0,0,0,0,0,0,0,0,0,0,0
3571,EAST GODAVARI,Kakinada (Rural),SARPAVARAM,262,2,518,782,141,0,195,336,295,5636,0,6991,12627,9292,7,0,6,13
3572,EAST GODAVARI,Kakinada (Rural),SURYARAO PETA,7,1,854,862,2,1,297,300,278,63,49,11569,11681,8370,0,0,12,12
3573,EAST GODAVARI,Kakinada (Rural),SWAMYNAGAR,4,0,355,359,1,0,48,49,46,45,0,1501,1546,1376,0,0,0,0
3574,EAST GODAVARI,Kakinada (Rural),THAMMAVARAM,37,7,567,611,29,7,259,295,220,1495,353,11667,13515,9355,1,1,16,18
3575,EAST GODAVARI,Kakinada (Rural),THIMMAPURAM,290,17,256,563,185,14,49,248,185,11557,493,2152,14202,8972,28,0,0,28
3576,EAST GODAVARI,Kakinada (Rural),TOORANGI,145,1,1139,1285,22,0,166,188,171,861,0,3527,4388,3242,0,0,1,1
3577,EAST GODAVARI,Kakinada (Rural),VAKALAPUDI,196,0,381,577,135,0,185,320,264,6518,0,9576,16094,11464,8,0,10,18
3578,EAST GODAVARI,Kakinada (Rural),VALASAPAKALU,1,0,79,80,0,0,53,53,46,0,0,4551,4551,3154,0,0,20,20
3579,EAST GODAVARI,Kapileswarapuram,ADDANKIVARI LANKA,404,0,205,609,270,0,67,337,309,7961,0,1649,9610,7794,1,0,0,1
3580,EAST GODAVARI,Kapileswarapuram,ANGARA,171,5,646,822,108,0,287,395,291,4486,0,7239,11725,6609,10,0,4,14
3581,EAST GODAVARI,Kapileswarapuram,ATCHUTA PURAM,82,0,213,295,53,0,80,133,88,1084,0,1542,2626,1543,0,0,0,0
3582,EAST GODAVARI,Kapileswarapuram,K.PURAM,374,19,1175,1568,223,12,348,583,490,1782,98,4176,6056,3298,0,0,0,0
3583,EAST GODAVARI,Kapileswarapuram,KALERU,254,7,177,438,193,6,88,287,188,10762,297,2465,13524,8004,11,1,0,12
3584,EAST GODAVARI,Kapileswarapuram,KEDRA LANKA,240,2,386,628,154,0,122,276,254,4322,0,2081,6403,4383,1,0,0,1
3585,EAST GODAVARI,Kapileswarapuram,KORUMILLI,132,15,841,988,91,14,320,425,105,6183,401,10008,16592,4642,24,0,15,39
3586,EAST GODAVARI,Kapileswarapuram,MACHARA,239,11,723,973,171,7,481,659,518,2466,105,8200,10771,5143,0,0,1,1
3587,EAST GODAVARI,Kapileswarapuram,N.METTA,89,1,234,324,61,1,77,139,71,3454,121,2326,5901,3062,4,1,2,7
3588,EAST GODAVARI,Kapileswarapuram,NAGULACHERUVU,2,1,247,250,1,1,185,187,162,104,101,4835,5040,2714,1,1,0,2
3589,EAST GODAVARI,Kapileswarapuram,NALLURU,102,3,448,553,65,2,228,295,252,1267,47,6230,7544,3188,0,0,10,10
3590,EAST GODAVARI,Kapileswarapuram,NELATURU,159,3,549,711,94,0,192,286,184,2402,0,5218,7620,3471,1,0,2,3
3591,EAST GODAVARI,Kapileswarapuram,TEKI,371,33,1051,1455,209,9,462,680,568,4848,71,7607,12526,7566,1,0,3,4
3592,EAST GODAVARI,Kapileswarapuram,THATAPUDI,303,0,218,521,224,0,101,325,241,4932,0,1097,6029,3307,0,0,0,0
3593,EAST GODAVARI,Kapileswarapuram,VADLAMURU,213,4,163,380,126,2,59,187,140,2670,18,826,3514,1643,2,0,0,2
3594,EAST GODAVARI,Kapileswarapuram,VAKATIPPA,184,2,281,467,115,2,176,293,249,2449,24,2953,5426,3051,0,0,0,0
3595,EAST GODAVARI,Kapileswarapuram,VALLURU,434,1,522,957,253,0,192,445,347,5232,0,1786,7018,4213,0,0,0,0
3596,EAST GODAVARI,Kapileswarapuram,VEDURUMUDI,162,2,328,492,114,2,163,279,225,3101,24,4469,7594,3958,1,0,0,1
3597,EAST GODAVARI,Kapileswarapuram,WEST KHANDRIKA,261,0,438,699,147,0,104,251,191,4030,0,2082,6112,3481,0,0,0,0
3598,EAST GODAVARI,Karapa,ARATLAKATTA,220,9,938,1167,154,6,437,597,363,6807,211,11804,18822,8931,12,0,4,16
3599,EAST GODAVARI,Karapa,G. BHAVARAM,239,2,106,347,119,0,20,139,110,2087,0,349,2436,1229,0,0,0,0
3600,EAST GODAVARI,Karapa,GODDATIPALEM,36,5,205,246,12,0,34,46,30,321,0,1084,1405,663,0,0,0,0
3601,EAST GODAVARI,Karapa,GORRIPUDI,215,5,1140,1360,89,2,111,202,129,6895,159,4665,11719,7805,35,0,8,43
3602,EAST GODAVARI,Karapa,GURAJANAPALLE,200,5,517,722,105,2,104,211,128,4991,48,3094,8133,4314,7,0,0,7
3603,EAST GODAVARI,Karapa,KARAPA,310,24,1390,1724,169,7,406,582,381,5642,266,10854,16762,7924,1,0,4,5
3604,EAST GODAVARI,Karapa,KONGODU,87,5,429,521,66,1,247,314,199,3250,18,6693,9961,3711,4,0,1,5
3605,EAST GODAVARI,Karapa,KORIPALLE,66,7,395,468,42,2,180,224,162,3753,157,13297,17207,9490,21,1,79,101
3606,EAST GODAVARI,Karapa,KURADA,200,5,849,1054,123,3,347,473,256,3259,36,7049,10344,3770,3,0,20,23
3607,EAST GODAVARI,Karapa,NADAKUDURU,293,4,980,1277,180,1,379,560,504,6164,107,12456,18727,14588,7,1,13,21
3608,EAST GODAVARI,Karapa,PATHARLAGADDA,131,0,154,285,80,0,36,116,77,3954,0,1567,5521,2708,18,0,5,23
3609,EAST GODAVARI,Karapa,PEDA KOTHURU,103,2,285,390,80,1,111,192,104,4045,71,4381,8497,4096,8,0,4,12
3610,EAST GODAVARI,Karapa,PEDDAPURAPPADU,147,0,412,559,110,0,198,308,164,5196,0,6275,11471,4262,9,0,3,12
3611,EAST GODAVARI,Karapa,PENUGUDURU,232,23,302,557,96,15,90,201,157,3350,268,2390,6008,4134,2,0,3,5
3612,EAST GODAVARI,Karapa,SIRIPURAM,150,4,211,365,103,4,97,204,134,5241,317,3491,9049,4559,8,2,4,14
3613,EAST GODAVARI,Karapa,UPPALANKA,3,0,532,535,2,0,23,25,9,40,0,285,325,128,0,0,0,0
3614,EAST GODAVARI,Karapa,VAKADA,190,3,429,622,112,0,152,264,162,6126,0,7014,13140,5758,8,0,13,21
3615,EAST GODAVARI,Karapa,VALASAPAKULU,122,1,360,483,62,0,206,268,236,2006,0,8209,10215,5904,1,0,8,9
3616,EAST GODAVARI,Karapa,VELANGI,251,12,908,1171,136,3,360,499,438,4215,74,7015,11304,7512,1,0,3,4
3617,EAST GODAVARI,Karapa,VEMULAVADA,77,3,805,885,64,3,369,436,339,3187,190,13545,16922,9886,2,0,5,7
3618,EAST GODAVARI,Karapa,VIJAYARAYUDU PALEM,80,2,173,255,60,1,120,181,105,3762,2,5181,8945,3860,9,0,6,15
3619,EAST GODAVARI,Karapa,YANDAMURU,210,6,408,624,158,4,301,463,423,6721,347,14855,21923,9915,9,1,19,29
3620,EAST GODAVARI,Karapa,Z. BHAVARAM,105,4,214,323,55,2,104,161,97,3382,176,6592,10150,4247,14,1,22,37
3621,EAST GODAVARI,Katrenikona,BANTUMILLI,81,0,107,188,60,0,62,122,100,2666,0,2158,4824,3039,4,0,1,5
3622,EAST GODAVARI,Katrenikona,BRAHMASAMEDYAM,41,0,712,753,23,0,264,287,266,669,0,6743,7412,5417,0,0,5,5
3623,EAST GODAVARI,Katrenikona,CHEYYERU,1774,11,609,2394,623,3,104,730,581,20217,7,3074,23298,15880,14,0,2,16
3624,EAST GODAVARI,Katrenikona,CHIRRAYANAM,3,0,484,487,0,0,168,168,122,0,0,1795,1795,1000,0,0,0,0
3625,EAST GODAVARI,Katrenikona,DONTIKURRU,708,6,393,1107,297,2,77,376,329,11918,51,2617,14586,10344,10,0,0,10
3626,EAST GODAVARI,Katrenikona,GEDDANAPALLE,371,9,222,602,242,4,66,312,264,5460,125,1371,6956,4432,0,0,0,0
3627,EAST GODAVARI,Katrenikona,KANDIKUPPA,830,0,140,970,413,0,22,435,299,12739,0,501,13240,7701,16,0,0,16
3628,EAST GODAVARI,Katrenikona,KATRENIKONA,1534,51,1922,3507,571,16,428,1015,930,17266,453,12970,30689,21108,8,0,6,14
3629,EAST GODAVARI,Katrenikona,KOPPI GUNTA,201,7,403,611,85,4,181,270,235,2672,159,5449,8280,6028,2,0,4,6
3630,EAST GODAVARI,Katrenikona,KUNDALESWARAM,302,1,132,435,116,0,29,145,128,2488,0,319,2807,2092,1,0,0,1
3631,EAST GODAVARI,Katrenikona,LAKSHMIWADA,125,0,102,227,103,0,56,159,139,3776,0,1899,5675,3889,1,0,1,2
3632,EAST GODAVARI,Katrenikona,NADAVAPALLE,162,5,218,385,74,2,44,120,95,2343,30,1133,3506,2368,1,0,0,1
3633,EAST GODAVARI,Katrenikona,PALLAM,94,0,725,819,55,0,75,130,107,2891,0,2806,5697,3348,4,0,3,7
3634,EAST GODAVARI,Katrenikona,PALLAMKURRU,2109,4,645,2758,857,3,91,951,582,20616,60,1281,21957,12454,1,0,0,1
3635,EAST GODAVARI,Katrenikona,PENUWALLA,224,3,139,366,153,0,34,187,148,8058,0,1531,9589,6702,15,0,3,18
3636,EAST GODAVARI,Katrenikona,UPPUDI,293,18,145,456,125,3,28,156,118,3652,115,632,4399,2785,2,0,0,2
3637,EAST GODAVARI,Kirlampudi,BHUPALAPANTAM,121,1,236,358,71,0,83,154,69,1413,0,1978,3391,932,0,0,3,3
3638,EAST GODAVARI,Kirlampudi,BURUGUPUDI,140,5,1195,1340,91,1,339,431,127,3513,99,11371,14983,3545,5,0,14,19
3639,EAST GODAVARI,Kirlampudi,GEDDANAPALLE,115,1,525,641,73,0,118,191,84,2502,0,2013,4515,1713,4,0,0,4
3640,EAST GODAVARI,Kirlampudi,GONEDA,204,3,772,979,122,0,139,261,110,5275,0,3530,8805,3217,2,0,0,2
3641,EAST GODAVARI,Kirlampudi,JAGAPATHINAGARAM,851,25,3415,4291,456,1,1014,1471,991,17335,26,25428,42789,19823,7,0,8,15
3642,EAST GODAVARI,Kirlampudi,KRISHNAVARAM,75,2,631,708,48,1,328,377,98,1537,46,7777,9360,1809,2,0,0,2
3643,EAST GODAVARI,Kirlampudi,MUKKOLLU,159,2,608,769,133,2,447,582,236,3434,67,9042,12543,2866,0,0,0,0
3644,EAST GODAVARI,Kirlampudi,PALEM,22,12,336,370,14,2,87,103,19,504,18,1839,2361,457,0,0,0,0
3645,EAST GODAVARI,Kirlampudi,RAJUPALEM,176,9,298,483,115,6,114,235,99,3215,107,2501,5823,1931,0,0,2,2
3646,EAST GODAVARI,Kirlampudi,RAMACHANDRA PURAM,74,1,295,370,41,0,84,125,47,2001,0,3142,5143,1764,3,0,6,9
3647,EAST GODAVARI,Kirlampudi,RAMAKRISHNAPURAM,172,2,166,340,117,2,85,204,124,4212,92,3130,7434,2886,4,0,1,5
3648,EAST GODAVARI,Kirlampudi,S.THIMMAPURAM,150,12,301,463,94,10,137,241,201,2686,222,3681,6589,3369,0,0,1,1
3649,EAST GODAVARI,Kirlampudi,SIMHADRI PURAM,47,3,716,766,24,0,276,300,48,822,0,10175,10997,1139,0,0,6,6
3650,EAST GODAVARI,Kirlampudi,SOMANARAYANI PETA,10,3,425,438,8,3,141,152,41,355,88,4265,4708,1405,0,0,0,0
3651,EAST GODAVARI,Kirlampudi,SOMAVARAM,134,2,651,787,41,0,165,206,109,1335,0,7895,9230,4026,1,0,9,10
3652,EAST GODAVARI,Kirlampudi,SUNGARAYUNIPALEM,97,0,535,632,64,0,141,205,67,2174,0,2692,4866,1433,0,0,0,0
3653,EAST GODAVARI,Kirlampudi,THAMARADA,56,0,633,689,32,0,300,332,40,562,0,4869,5431,539,0,0,4,4
3654,EAST GODAVARI,Kirlampudi,VEERAVARAM,366,3,955,1324,37,0,75,112,8,413,0,470,883,85,0,0,0,0
3655,EAST GODAVARI,Kirlampudi,VELANKA,150,5,776,931,69,1,203,273,163,2407,6,6883,9296,3273,1,0,6,7
3656,EAST GODAVARI,Korukonda,BOLLEDDUPALEM,168,62,622,852,72,35,339,446,332,4901,2515,25301,32717,17339,18,10,112,140
3657,EAST GODAVARI,Korukonda,BURUGUPUDI,176,5,370,551,53,0,135,188,88,3153,0,5774,8927,4027,6,0,10,16
3658,EAST GODAVARI,Korukonda,BUTCHEMPETA,327,3,281,611,117,0,116,233,97,4923,0,3331,8254,2716,12,0,0,12
3659,EAST GODAVARI,Korukonda,DOSAKAYALA PALLI,352,1,648,1001,102,0,140,242,197,4454,0,6374,10828,7234,7,0,11,18
3660,EAST GODAVARI,Korukonda,GADALA,395,1,133,529,191,0,13,204,175,9174,0,269,9443,7234,21,0,0,21
3661,EAST GODAVARI,Korukonda,GADARADA,189,5,1124,1318,125,1,594,720,136,8267,100,24816,33183,4510,38,1,20,59
3662,EAST GODAVARI,Korukonda,JAGANNADHA PURAM,311,0,143,454,169,0,34,203,127,10657,0,1141,11798,5329,30,0,4,34
3663,EAST GODAVARI,Korukonda,JAMBUPATNAM,159,1,599,759,40,0,165,205,105,1806,0,7400,9206,3952,6,0,5,11
3664,EAST GODAVARI,Korukonda,KANUPURU,204,9,835,1048,141,2,407,550,280,6707,86,15679,22472,7612,32,0,37,69
3665,EAST GODAVARI,Korukonda,KAPAVARAM,188,6,491,685,58,1,206,265,111,2009,20,7001,9030,3147,4,0,7,11
3666,EAST GODAVARI,Korukonda,KORUKONDA,175,56,654,885,65,7,215,287,184,3433,330,9403,13166,6492,12,0,19,31
3667,EAST GODAVARI,Korukonda,KOTI,218,11,584,813,129,5,335,469,84,7527,384,20763,28674,4007,21,0,63,84
3668,EAST GODAVARI,Korukonda,KOTIKESAVARAM,664,2,319,985,400,2,128,530,433,25459,49,7286,32794,18186,60,0,17,77
3669,EAST GODAVARI,Korukonda,MADHURAPUDI,248,20,322,590,81,4,29,114,66,3135,164,1460,4759,2023,9,0,6,15
3670,EAST GODAVARI,Korukonda,MUNAGALA,152,2,481,635,87,0,263,350,143,5242,0,14353,19595,5464,14,0,34,48
3671,EAST GODAVARI,Korukonda,NARASAPURAM,157,4,900,1061,73,3,372,448,170,2505,118,11411,14034,5644,5,0,25,30
3672,EAST GODAVARI,Korukonda,NIDIGATLA,212,2,360,574,40,0,86,126,33,1611,0,2851,4462,1389,3,0,10,13
3673,EAST GODAVARI,Korukonda,RAGHAVAPURAM,204,5,400,609,115,3,189,307,210,6027,103,10039,16169,7874,7,0,21,28
3674,EAST GODAVARI,Korukonda,SRIRANGAPATNAM,226,19,1731,1976,75,1,676,752,429,3130,3,30003,33136,16554,3,0,45,48
3675,EAST GODAVARI,Korukonda,WEST GONAGUDEM,235,4,496,735,74,0,106,180,153,2858,0,3892,6750,4727,2,0,10,12
3676,EAST GODAVARI,Kotananduru,ALLIPUDI,559,3,781,1343,248,0,479,727,691,9024,0,25349,34373,17999,4,0,34,38
3677,EAST GODAVARI,Kotananduru,B.H.KOTA,425,1,445,871,186,0,276,462,469,5685,0,12557,18242,12188,3,0,11,14
3678,EAST GODAVARI,Kotananduru,BILLANANDURU,97,0,610,707,56,0,430,486,401,2025,0,22266,24291,11541,3,0,28,31
3679,EAST GODAVARI,Kotananduru,BODHAVARAM,216,1,826,1043,116,0,551,667,627,2919,0,20059,22978,12244,1,0,13,14
3680,EAST GODAVARI,Kotananduru,INDUGAPALLE,70,1,354,425,63,0,275,338,292,4035,0,12883,16918,9161,9,0,16,25
3681,EAST GODAVARI,Kotananduru,JAGANNADHAPURAM,118,2,588,708,91,1,383,475,460,3539,18,9656,13213,8093,2,0,0,2
3682,EAST GODAVARI,Kotananduru,K.A.MALLAVARAM,161,32,650,843,97,24,323,444,382,3672,1071,9651,14394,7352,4,0,4,8
3683,EAST GODAVARI,Kotananduru,K.E.CHINNAYYAPALEM,327,7,987,1321,225,5,481,711,614,10401,222,22069,32692,16906,16,0,27,43
3684,EAST GODAVARI,Kotananduru,K.KOTTAM,160,5,597,762,99,0,370,469,308,2563,0,5546,8109,3646,1,0,0,1
3685,EAST GODAVARI,Kotananduru,K.O.AGRAHARAM,175,1,229,405,144,0,169,313,307,7718,0,7633,15351,9272,14,0,8,22
3686,EAST GODAVARI,Kotananduru,KAKARAPALLE,84,0,591,675,63,0,241,304,167,4868,0,11179,16047,5789,18,0,28,46
3687,EAST GODAVARI,Kotananduru,KOTANANDURU,517,8,1186,1711,169,1,388,558,506,7023,60,22922,30005,17270,19,0,72,91
3688,EAST GODAVARI,Kotananduru,L.D.PETA,187,0,149,336,150,0,68,218,150,4777,0,1182,5959,2682,0,0,0,0
3689,EAST GODAVARI,Kotananduru,P.KOTTAM,222,196,955,1373,120,90,279,489,474,4090,5710,5949,15749,7652,6,18,0,24
3690,EAST GODAVARI,Kotananduru,S.R.PETA,62,0,993,1055,31,0,716,747,722,1099,0,32684,33783,16999,1,0,18,19
3691,EAST GODAVARI,Kotananduru,T.J.NAGARAM,13,0,314,327,6,0,222,228,196,182,0,12604,12786,7250,0,0,31,31
3692,EAST GODAVARI,Kothapeta,AVIDI,663,7,450,1120,422,4,255,681,608,16567,198,6327,23092,14178,5,0,1,6
3693,EAST GODAVARI,Kothapeta,BILLA KURU,503,9,507,1019,305,3,236,544,428,14442,46,9027,23515,12595,12,0,6,18
3694,EAST GODAVARI,Kothapeta,GANTI,634,7,192,833,439,5,85,529,488,10035,85,2337,12457,7419,3,0,0,3
3695,EAST GODAVARI,Kothapeta,KHANDRIGA,193,2,417,612,90,2,268,360,334,2972,81,8952,12005,6508,0,0,6,6
3696,EAST GODAVARI,Kothapeta,KOTHA PETA,1151,7,1490,2648,495,6,511,1012,926,14611,78,14920,29609,19632,6,0,4,10
3697,EAST GODAVARI,Kothapeta,MANDAPALLI,58,0,66,124,48,0,2,50,49,2157,0,56,2213,1479,0,0,0,0
3698,EAST GODAVARI,Kothapeta,MODEKURU,569,8,943,1520,299,2,224,525,455,7348,49,4271,11668,7083,3,0,1,4
3699,EAST GODAVARI,Kothapeta,PALIVELA,829,1,292,1122,655,0,63,718,653,22996,0,1643,24639,14092,12,0,0,12
3700,EAST GODAVARI,Kothapeta,VADAPALEM,240,1,236,477,118,0,23,141,98,1673,0,204,1877,1243,0,0,0,0
3701,EAST GODAVARI,Kothapeta,VANAPALLI,1133,13,910,2056,564,0,162,726,662,8951,0,2121,11072,7058,0,0,0,0
3702,EAST GODAVARI,Kunavaram,Abhicherla (Z),9,370,9,388,1,103,1,105,81,2,183,1,186,110,0,0,0,0
3703,EAST GODAVARI,Kunavaram,Chinarukur (G),10,658,16,684,1,217,0,218,156,6,1752,0,1758,904,0,0,0,0
3704,EAST GODAVARI,Kunavaram,Chuchirevulagudem (G),85,473,241,799,1,97,1,99,53,6,1438,9,1453,564,0,1,0,1
3705,EAST GODAVARI,Kunavaram,Jaggavaram (G),62,198,108,368,0,9,1,10,6,0,58,14,72,36,0,0,0,0
3706,EAST GODAVARI,Kunavaram,Kachavaram (Z),128,3,264,395,0,0,0,0,0,0,0,0,0,0,0,0,0,0
3707,EAST GODAVARI,Kunavaram,Karakagudem (Z),40,485,66,591,0,115,0,115,71,0,527,0,527,285,0,0,0,0
3708,EAST GODAVARI,Kunavaram,Kondrajupeta (G),10,554,9,573,0,10,0,10,6,0,30,0,30,18,0,0,0,0
3709,EAST GODAVARI,Kunavaram,Kunavaram (G),581,125,560,1266,28,2,9,39,32,278,10,181,469,307,0,0,0,0
3710,EAST GODAVARI,Kunavaram,Kuturu (Z),32,521,80,633,0,1,1,2,2,0,8,8,16,8,0,0,0,0
3711,EAST GODAVARI,Kunavaram,Lingapuram (Z),6,263,1,270,0,105,0,105,86,0,563,0,563,325,0,0,0,0
3712,EAST GODAVARI,Kunavaram,Marrigudem (Z),15,3,204,222,1,0,17,18,12,14,0,218,232,111,0,0,0,0
3713,EAST GODAVARI,Kunavaram,Peddarukur (G),17,994,26,1037,2,185,1,188,119,4,1208,10,1222,518,0,0,0,0
3714,EAST GODAVARI,Kunavaram,Pochavaram (Z),258,290,208,756,0,28,0,28,9,0,144,0,144,10,0,0,0,0
3715,EAST GODAVARI,Kunavaram,Ragulapadu (G),13,495,32,540,2,63,11,76,59,9,339,20,368,199,0,0,0,0
3716,EAST GODAVARI,Kunavaram,Tekubaka (Z),16,2,122,140,0,0,0,0,0,0,0,0,0,0,0,0,0,0
3717,EAST GODAVARI,Kunavaram,Venkatayapalem (G),87,721,63,871,0,27,3,30,17,0,284,47,331,113,0,0,0,0
3718,EAST GODAVARI,Malikipuram,BATTELANKA,35,0,127,162,14,0,62,76,61,393,0,1847,2240,1678,0,0,0,0
3719,EAST GODAVARI,Malikipuram,CHINTALAMORI,324,0,200,524,104,0,85,189,135,4104,0,4088,8192,5453,6,0,10,16
3720,EAST GODAVARI,Malikipuram,DINDI,140,0,48,188,106,0,30,136,107,6171,0,1752,7923,5614,19,0,7,26
3721,EAST GODAVARI,Malikipuram,G.PALLIPALEM,55,0,326,381,22,0,226,248,200,1132,0,15782,16914,12900,5,0,70,75
3722,EAST GODAVARI,Malikipuram,GOLLAPALEM,166,2,98,266,97,1,48,146,84,6111,95,3120,9326,5114,34,0,14,48
3723,EAST GODAVARI,Malikipuram,GUBBALAPALEM,154,0,122,276,96,0,55,151,112,8188,0,4070,12258,7886,57,0,21,78
3724,EAST GODAVARI,Malikipuram,GUDAPALLI,179,0,278,457,116,0,105,221,164,6109,0,3373,9482,6155,20,0,5,25
3725,EAST GODAVARI,Malikipuram,GUDIMELLANKA,161,3,206,370,93,1,96,190,174,5555,50,5734,11339,9311,22,0,21,43
3726,EAST GODAVARI,Malikipuram,IRUSUMANDA,100,6,119,225,62,1,16,79,58,3701,11,795,4507,2503,9,0,1,10
3727,EAST GODAVARI,Malikipuram,KATHIMANDA,66,0,194,260,34,0,89,123,106,1615,0,2468,4083,3125,3,0,0,3
3728,EAST GODAVARI,Malikipuram,KESANAPALLI,256,4,145,405,113,1,47,161,69,7481,42,2422,9945,4045,24,0,4,28
3729,EAST GODAVARI,Malikipuram,LAKKAVARAM,108,2,128,238,76,0,31,107,80,7910,0,2455,10365,6699,58,0,18,76
3730,EAST GODAVARI,Malikipuram,MALIKIPURAM,121,9,202,332,29,0,65,94,84,1107,0,2228,3335,2869,1,0,1,2
3731,EAST GODAVARI,Malikipuram,MATTAPARRU,83,0,82,165,51,0,53,104,81,3117,0,2963,6080,4274,9,0,3,12
3732,EAST GODAVARI,Malikipuram,MEDICHERLAPALEM,103,0,81,184,65,0,31,96,83,3619,0,1170,4789,3446,10,0,0,10
3733,EAST GODAVARI,Malikipuram,PADAMATIPALEM,176,10,181,367,110,6,55,171,77,8055,406,2720,11181,4373,40,2,8,50
3734,EAST GODAVARI,Malikipuram,RAMARAJULANKA,273,7,358,638,87,5,55,147,141,2814,343,1600,4757,3760,4,1,1,6
3735,EAST GODAVARI,Malikipuram,SANKARAGUPTHAM,317,1,429,747,110,0,60,170,81,6141,0,3551,9692,3702,19,0,12,31
3736,EAST GODAVARI,Malikipuram,TURPUPALEM,224,1,293,518,103,0,18,121,70,8415,0,299,8714,3771,47,0,0,47
3737,EAST GODAVARI,Malikipuram,VISWESWARAYAPURAM,122,8,316,446,50,5,110,165,157,2784,221,5376,8381,6790,10,1,15,26
3738,EAST GODAVARI,Mamidikuduru,ADURRU,229,10,257,496,88,4,97,189,167,4216,177,4715,9108,7482,6,0,2,8
3739,EAST GODAVARI,Mamidikuduru,APPANAPALLE,197,4,124,325,71,0,33,104,77,4806,0,1291,6097,4070,19,0,2,21
3740,EAST GODAVARI,Mamidikuduru,B.DODDAVARAM,82,2,266,350,32,0,63,95,55,2081,0,3130,5211,3510,9,0,11,20
3741,EAST GODAVARI,Mamidikuduru,EDARADA,199,6,70,275,108,2,18,128,92,5826,36,882,6744,4120,15,0,1,16
3742,EAST GODAVARI,Mamidikuduru,GEDDADA,67,1,133,201,34,1,58,93,75,1890,24,2860,4774,3423,7,0,5,12
3743,EAST GODAVARI,Mamidikuduru,GOGANNAMATTAM,322,7,632,961,137,3,214,354,234,9747,117,11799,21663,11918,24,0,16,40
3744,EAST GODAVARI,Mamidikuduru,KARAVAKA,63,0,384,447,41,0,278,319,266,1491,0,11909,13400,10157,1,0,6,7
3745,EAST GODAVARI,Mamidikuduru,KOMARADA,105,0,92,197,62,0,33,95,61,4118,0,1594,5712,3445,12,0,4,16
3746,EAST GODAVARI,Mamidikuduru,LUTUKURRU,158,0,219,377,66,0,23,89,67,3753,0,725,4478,3594,5,0,1,6
3747,EAST GODAVARI,Mamidikuduru,MAGATAPALLE,156,4,84,244,100,1,27,128,99,6046,129,970,7145,4850,16,1,0,17
3748,EAST GODAVARI,Mamidikuduru,MAKANAPALEM,89,0,87,176,35,0,25,60,53,2156,0,1602,3758,3030,6,0,5,11
3749,EAST GODAVARI,Mamidikuduru,MAMIDIKUDURU,121,37,162,320,36,24,79,139,112,1709,1847,3811,7367,5187,8,12,15,35
3750,EAST GODAVARI,Mamidikuduru,MOGALIKUDURU,104,2,116,222,59,1,54,114,84,3481,20,2547,6048,4700,10,0,7,17
3751,EAST GODAVARI,Mamidikuduru,NAGARAM,254,15,279,548,69,8,41,118,86,5037,466,2000,7503,4570,11,2,4,17
3752,EAST GODAVARI,Mamidikuduru,PASARLAPUDI,273,4,550,827,70,3,75,148,123,4129,87,4012,8228,6362,13,0,20,33
3753,EAST GODAVARI,Mamidikuduru,PASARLAPUDILANKA,127,3,157,287,53,3,47,103,87,2977,56,1287,4320,3833,19,0,2,21
3754,EAST GODAVARI,Mamidikuduru,PEDAPATNAM,164,9,425,598,86,2,105,193,132,4500,4,3881,8385,5728,11,0,1,12
3755,EAST GODAVARI,Mamidikuduru,PEDAPATNAM LANKA,177,7,274,458,73,0,75,148,115,3955,0,2682,6637,5082,14,0,2,16
3756,EAST GODAVARI,Mandapeta,ARTHAMURU,212,1,83,296,118,0,28,146,139,5569,0,873,6442,4849,10,0,1,11
3757,EAST GODAVARI,Mandapeta,DWARAPUDI,480,2,521,1003,146,0,147,293,240,5863,0,3520,9383,7180,9,0,2,11
3758,EAST GODAVARI,Mandapeta,IPPANAPADU,171,0,106,277,103,0,25,128,104,2931,0,486,3417,2310,4,0,0,4
3759,EAST GODAVARI,Mandapeta,KESAVARAM,325,10,293,628,144,0,31,175,113,5373,0,893,6266,2584,9,0,3,12
3760,EAST GODAVARI,Mandapeta,MAREDUBAKA,135,3,186,324,84,1,72,157,130,4613,25,3424,8062,4862,13,0,8,21
3761,EAST GODAVARI,Mandapeta,MERNIPADU,133,4,57,194,6,0,2,8,7,23,0,6,29,25,0,0,0,0
3762,EAST GODAVARI,Mandapeta,PALATHODU,220,3,311,534,156,2,93,251,147,5280,10,1259,6549,3024,0,0,0,0
3763,EAST GODAVARI,Mandapeta,TAPESWARAM,304,10,384,698,139,2,280,421,352,5270,106,8305,13681,8275,1,0,0,1
3764,EAST GODAVARI,Mandapeta,VELAGATHODU,202,6,338,546,132,4,228,364,319,2335,135,4796,7266,4553,1,0,9,10
3765,EAST GODAVARI,Mandapeta,Y.SEETHANAGARAM,46,1,151,198,40,0,66,106,37,2410,0,2908,5318,1684,8,0,1,9
3766,EAST GODAVARI,Mandapeta,YEDITHA,557,5,479,1041,205,0,109,314,272,6464,0,1662,8126,5477,3,0,0,3
3767,EAST GODAVARI,Mandapeta,Z.MEDAPADU,224,0,114,338,69,0,10,79,64,854,0,159,1013,689,0,0,0,0
3768,EAST GODAVARI,Maredumilli,CHATLAWADA,1,348,0,349,0,235,0,235,224,0,11480,0,11480,5414,0,27,0,27
3769,EAST GODAVARI,Maredumilli,CHAVIDIKOTA,4,769,0,773,0,326,0,326,352,0,12134,0,12134,6666,0,16,0,16
3770,EAST GODAVARI,Maredumilli,D.V.KOTA,5,516,0,521,0,347,0,347,375,0,18044,0,18044,9869,0,42,0,42
3771,EAST GODAVARI,Maredumilli,DORACHINTALAPALEM,4,409,3,416,0,293,2,295,324,0,15181,9,15190,7443,0,46,0,46
3772,EAST GODAVARI,Maredumilli,G.M.VALASA,1,327,22,350,0,234,0,234,255,0,15904,0,15904,8271,0,52,0,52
3773,EAST GODAVARI,Maredumilli,KUNDADA,3,222,2,227,0,120,0,120,135,0,7225,0,7225,3724,0,26,0,26
3774,EAST GODAVARI,Maredumilli,MAREDUMILLI,24,816,62,902,6,289,13,308,293,102,11286,312,11700,6708,0,25,0,25
3775,EAST GODAVARI,Maredumilli,PAMULERU,2,258,1,261,0,185,0,185,208,0,11711,0,11711,5689,0,35,0,35
3776,EAST GODAVARI,Maredumilli,PULLANGI,1,415,0,416,0,333,0,333,335,0,26212,0,26212,13134,0,124,0,124
3777,EAST GODAVARI,Maredumilli,SUNNAMPADU,3,389,0,392,0,264,0,264,286,0,11272,0,11272,6021,0,23,0,23
3778,EAST GODAVARI,Maredumilli,TADEPALLI,2,671,0,673,1,339,0,340,357,18,15638,0,15656,7582,0,41,0,41
3779,EAST GODAVARI,Maredumilli,VETUKURU,3,371,83,457,0,287,0,287,308,0,26315,0,26315,14124,0,125,0,125
3780,EAST GODAVARI,Mummidivaram,AINAPURAM,702,12,595,1309,380,5,222,607,553,13670,244,6745,20659,15438,6,0,11,17
3781,EAST GODAVARI,Mummidivaram,ANANTHAVARAM,395,7,371,773,239,3,181,423,383,6798,45,4728,11571,9150,6,0,4,10
3782,EAST GODAVARI,Mummidivaram,ANNAMPALLE,132,1,441,574,77,1,217,295,279,1636,61,5159,6856,5692,0,0,1,1
3783,EAST GODAVARI,Mummidivaram,CH.GUNNEPALLE,152,9,351,512,95,3,109,207,165,4637,201,4750,9588,6869,9,0,10,19
3784,EAST GODAVARI,Mummidivaram,CHINAKOTHALANKA,25,0,107,132,23,0,63,86,73,1669,0,4004,5673,4557,4,0,8,12
3785,EAST GODAVARI,Mummidivaram,GADILANKA,86,5,228,319,64,2,112,178,149,3978,68,7383,11429,9034,7,0,14,21
3786,EAST GODAVARI,Mummidivaram,GEDELLANKA,68,3,351,422,37,3,140,180,120,1571,174,7149,8894,4571,3,0,20,23
3787,EAST GODAVARI,Mummidivaram,KAMINI,331,1,87,419,145,0,4,149,120,6060,0,147,6207,3412,16,0,0,16
3788,EAST GODAVARI,Mummidivaram,KARRIVANIREVU,227,1,168,396,151,1,90,242,230,6131,30,3437,9598,6930,9,0,3,12
3789,EAST GODAVARI,Mummidivaram,KOMANAPALLE,243,7,157,407,138,0,44,182,162,1875,0,543,2418,2032,0,0,0,0
3790,EAST GODAVARI,Mummidivaram,KOTHALANKA,130,15,805,950,74,6,291,371,316,4933,141,11565,16639,11822,17,0,13,30
3791,EAST GODAVARI,Mummidivaram,KRAPA CHINTALAPUDI,86,5,88,179,0,0,0,0,0,0,0,0,0,0,0,0,0,0
3792,EAST GODAVARI,Mummidivaram,KRAPA CHINTALAPUDIPALEM,149,4,100,253,84,3,21,108,94,5345,303,1486,7134,4584,18,2,5,25
3793,EAST GODAVARI,Mummidivaram,LANKA OF THANELANKA,230,1,253,484,108,0,92,200,175,3972,0,2874,6846,5037,3,0,2,5
3794,EAST GODAVARI,Mummidivaram,MARLAPALEM,39,0,121,160,27,0,71,98,88,1433,0,3432,4865,3723,3,0,3,6
3795,EAST GODAVARI,Mummidivaram,MUMMIDIVARAM,659,0,681,1340,0,0,0,0,0,0,0,0,0,0,0,0,0,0
3796,EAST GODAVARI,Mummidivaram,PALLAVARI PALEM,66,0,110,176,48,0,59,107,75,2587,0,2378,4965,2800,8,0,1,9
3797,EAST GODAVARI,Mummidivaram,SOMIDEVARA PALEM,237,7,111,355,0,0,0,0,0,0,0,0,0,0,0,0,0,0
3798,EAST GODAVARI,Mummidivaram,TANELANKA,304,4,591,899,196,2,332,530,474,10507,184,17099,27790,24414,14,1,7,22
3799,EAST GODAVARI,Nellipaka,Chodavaram,113,435,85,633,0,22,0,22,16,0,171,0,171,100,0,0,0,0
3800,EAST GODAVARI,Nellipaka,Gannavaram,192,16,213,421,0,0,0,0,0,0,0,0,0,0,0,0,0,0
3801,EAST GODAVARI,Nellipaka,Gommu Kothagudem,92,647,16,755,0,10,0,10,5,0,46,0,46,16,0,0,0,0
3802,EAST GODAVARI,Nellipaka,Gowridevipeta,233,91,276,600,2,3,12,17,11,18,21,71,110,39,0,0,0,0
3803,EAST GODAVARI,Nellipaka,Gundala,191,324,359,874,2,0,0,2,0,4,0,0,4,0,0,0,0,0
3804,EAST GODAVARI,Nellipaka,Kannaigudem,230,242,384,856,0,17,0,17,15,0,81,0,81,47,0,0,0,0
3805,EAST GODAVARI,Nellipaka,Krishnavaram,2,555,4,561,0,0,0,0,0,0,0,0,0,0,0,0,0,0
3806,EAST GODAVARI,Nellipaka,Lakshmipuram,167,756,34,957,48,65,0,113,83,217,141,0,358,191,0,0,0,0
3807,EAST GODAVARI,Nellipaka,Murumuru,29,225,67,321,0,0,0,0,0,0,0,0,0,0,0,0,0,0
3808,EAST GODAVARI,Nellipaka,Nallakunta,2,296,0,298,0,0,0,0,0,0,0,0,0,0,0,0,0,0
3809,EAST GODAVARI,Nellipaka,Nandigama,209,12,294,515,0,0,0,0,0,0,0,0,0,0,0,0,0,0
3810,EAST GODAVARI,Nellipaka,Nellipaka,239,376,238,853,0,21,0,21,16,0,99,0,99,60,0,0,0,0
3811,EAST GODAVARI,Nellipaka,Pitchikalapadu,22,715,1,738,0,76,1,77,63,0,836,4,840,406,0,0,0,0
3812,EAST GODAVARI,Nellipaka,Purushothapatnam,45,50,335,430,0,0,0,0,0,0,0,0,0,0,0,0,0,0
3813,EAST GODAVARI,Nellipaka,Ramagopalapuram,75,256,24,355,0,32,6,38,17,0,69,12,81,29,0,0,0,0
3814,EAST GODAVARI,Nellipaka,Rayanapeta,302,709,114,1125,1,11,0,12,8,14,55,0,69,33,0,0,0,0
3815,EAST GODAVARI,Nellipaka,Thotapalli,10,370,70,450,0,4,3,7,4,0,17,18,35,18,0,0,0,0
3816,EAST GODAVARI,Nellipaka,Tripura Penta Veedu,312,6,282,600,0,0,0,0,0,0,0,0,0,0,0,0,0,0
3817,EAST GODAVARI,Nellipaka,Venkatareddipeta,7,2,153,162,0,0,0,0,0,0,0,0,0,0,0,0,0,0
3818,EAST GODAVARI,Nellipaka,Vissapuram,6,1211,11,1228,0,248,3,251,206,0,2201,25,2226,1044,0,0,0,0
3819,EAST GODAVARI,Nellipaka,Yetapaka,343,593,399,1335,0,0,0,0,0,0,0,0,0,0,0,0,0,0
3820,EAST GODAVARI,P Gannavaram,BELLAMPUDI,216,3,297,516,149,0,48,197,134,5754,0,894,6648,3200,6,0,1,7
3821,EAST GODAVARI,P Gannavaram,G.PEDAPUDI,447,8,299,754,269,1,53,323,283,11977,32,2651,14660,8527,7,0,8,15
3822,EAST GODAVARI,P Gannavaram,K.MUNJAVARAM,117,7,105,229,84,4,44,132,122,6149,292,2874,9315,8274,23,1,7,31
3823,EAST GODAVARI,P Gannavaram,K.YENUGUPALLE,143,5,281,429,93,2,127,222,166,2510,68,3415,5993,4232,1,0,1,2
3824,EAST GODAVARI,P Gannavaram,KUNDALAPALLE,52,0,264,316,38,0,86,124,61,2807,0,3319,6126,3349,9,0,5,14
3825,EAST GODAVARI,P Gannavaram,LANKALAGANNAVARAM,338,7,455,800,184,5,106,295,246,9838,146,3714,13698,10631,18,0,6,24
3826,EAST GODAVARI,P Gannavaram,MANEPALLE,136,18,218,372,46,6,56,108,79,2726,340,2784,5850,3893,5,1,1,7
3827,EAST GODAVARI,P Gannavaram,MONDEPU LANKA,84,0,208,292,43,0,96,139,106,2312,0,3524,5836,3954,3,0,3,6
3828,EAST GODAVARI,P Gannavaram,MUNGANDA,382,19,454,855,286,11,297,594,590,17557,425,13872,31854,25168,36,0,14,50
3829,EAST GODAVARI,P Gannavaram,MUNGANDAPALEM,70,6,137,213,51,6,101,158,149,3852,356,6608,10816,9297,19,1,21,41
3830,EAST GODAVARI,P Gannavaram,NAGULLANKA,423,1,165,589,191,0,51,242,191,8609,0,2503,11112,8050,7,0,3,10
3831,EAST GODAVARI,P Gannavaram,NARENDRAPURAM,444,19,423,886,304,11,206,521,492,7358,163,3521,11042,7402,0,0,0,0
3832,EAST GODAVARI,P Gannavaram,PATHAGANNAVARAM,587,1,548,1136,328,0,145,473,417,6096,0,2167,8263,5074,0,0,0,0
3833,EAST GODAVARI,P Gannavaram,POTHAVARAM,583,1,196,780,419,1,79,499,475,16914,24,2561,19499,15675,9,0,0,9
3834,EAST GODAVARI,P Gannavaram,R.YENUGUPALLI,45,0,129,174,23,0,89,112,109,2103,0,7730,9833,8225,18,0,46,64
3835,EAST GODAVARI,P Gannavaram,RAJULAPALEM,407,0,145,552,282,0,52,334,328,9319,0,1127,10446,7937,2,0,0,2
3836,EAST GODAVARI,P Gannavaram,UDIMUDI,758,8,296,1062,445,4,35,484,376,12604,90,902,13596,8392,1,0,1,2
3837,EAST GODAVARI,P Gannavaram,VADREVUPALLE,92,0,183,275,37,0,101,138,102,1681,0,5052,6733,5183,1,0,3,4
3838,EAST GODAVARI,P Gannavaram,Y.KOTHAPALLE,234,0,197,431,161,0,102,263,212,5187,0,3208,8395,5667,1,0,1,2
3839,EAST GODAVARI,P Gannavaram,YERRAMSETTIVARI PALEM,0,3,174,177,0,2,76,78,11,0,231,6494,6725,1159,0,2,44,46
3840,EAST GODAVARI,Pedapudi,A.P. TRAYAM,200,4,415,619,90,1,157,248,142,3507,3,6837,10347,4309,5,0,10,15
3841,EAST GODAVARI,Pedapudi,CHINTAPALLE,85,0,238,323,33,0,72,105,76,374,0,782,1156,515,0,0,0,0
3842,EAST GODAVARI,Pedapudi,DOMADA,70,5,288,363,51,2,152,205,142,3085,93,6561,9739,4656,6,0,6,12
3843,EAST GODAVARI,Pedapudi,G. MAMIDADA,358,9,1095,1462,194,4,346,544,425,6644,99,12151,18894,10348,3,0,3,6
3844,EAST GODAVARI,Pedapudi,GANDREDU,88,2,684,774,49,1,294,344,290,1606,7,4334,5947,4034,0,0,0,0
3845,EAST GODAVARI,Pedapudi,KAIKAVOLU,162,3,246,411,76,0,110,186,149,2041,0,2758,4799,2728,1,0,0,1
3846,EAST GODAVARI,Pedapudi,KANDREGULA,85,1,469,555,42,0,264,306,158,1260,0,5277,6537,2413,0,0,0,0
3847,EAST GODAVARI,Pedapudi,KARAKUDURU,241,3,436,680,148,1,214,363,125,4175,1,5178,9354,2074,2,0,0,2
3848,EAST GODAVARI,Pedapudi,KUMARAPRIYAM,69,3,456,528,53,0,233,286,119,2065,0,6708,8773,2745,1,0,4,5
3849,EAST GODAVARI,Pedapudi,PEDADUDI,386,35,1124,1545,203,10,570,783,563,5917,233,14677,20827,10711,0,0,0,0
3850,EAST GODAVARI,Pedapudi,PEDDADA,269,11,510,790,131,3,215,349,247,4379,73,6378,10830,6041,1,0,1,2
3851,EAST GODAVARI,Pedapudi,PUTTAKONDA,21,1,493,515,12,0,222,234,209,183,0,2905,3088,1831,0,0,0,0
3852,EAST GODAVARI,Pedapudi,PYNA,177,4,274,455,128,4,130,262,228,5769,187,3794,9750,5380,2,0,0,2
3853,EAST GODAVARI,Pedapudi,RAJUPALEM,116,2,466,584,74,0,206,280,194,1256,0,1998,3254,1390,0,0,0,0
3854,EAST GODAVARI,Pedapudi,RAMESWARAM,248,3,393,644,123,0,123,246,129,5260,0,3775,9035,3445,10,0,2,12
3855,EAST GODAVARI,Pedapudi,SAHAPURAM,129,3,693,825,49,0,368,417,264,1332,0,5279,6611,3142,0,0,0,0
3856,EAST GODAVARI,Pedapudi,SAMPARA,169,1,584,754,123,1,125,249,163,6101,33,3574,9708,4818,5,0,0,5
3857,EAST GODAVARI,Pedapudi,VENDRA,178,3,506,687,125,0,208,333,127,3985,0,3148,7133,2782,1,0,6,7
3858,EAST GODAVARI,Peddapuram,ANURU,385,0,429,814,253,0,184,437,184,12561,0,5349,17910,5841,25,0,1,26
3859,EAST GODAVARI,Peddapuram,CHADALADA,1,2,539,542,0,0,304,304,12,0,0,7537,7537,310,0,0,0,0
3860,EAST GODAVARI,Peddapuram,CHANDRAMAMPALLE,0,0,378,378,0,0,220,220,3,0,0,8967,8967,170,0,0,13,13
3861,EAST GODAVARI,Peddapuram,CHINABRAHMADEVAM,95,0,457,552,49,0,144,193,105,3795,0,7063,10858,6490,7,0,12,19
3862,EAST GODAVARI,Peddapuram,DIVLLI,236,1,540,777,134,0,219,353,150,5335,0,4305,9640,4449,4,0,3,7
3863,EAST GODAVARI,Peddapuram,G. RAGAMPETA,276,4,346,626,99,3,134,236,193,3590,225,4808,8623,6629,3,0,2,5
3864,EAST GODAVARI,Peddapuram,GORINTA,125,2,593,720,61,0,175,236,80,2646,0,3265,5911,2551,1,0,0,1
3865,EAST GODAVARI,Peddapuram,GUDIVADA,88,3,262,353,61,3,112,176,54,3216,96,2903,6215,1642,5,0,1,6
3866,EAST GODAVARI,Peddapuram,J. THIMMAPURAM,245,2,670,917,151,0,171,322,250,5356,0,2925,8281,4495,3,0,1,4
3867,EAST GODAVARI,Peddapuram,KANDRAKOTA,209,2,1130,1341,124,1,391,516,125,3602,20,6757,10379,2293,2,0,1,3
3868,EAST GODAVARI,Peddapuram,KATTAMURU,368,27,1326,1721,213,4,208,425,308,9707,158,6043,15908,9529,7,0,1,8
3869,EAST GODAVARI,Peddapuram,KONDAPALLE,218,4,752,974,139,2,156,297,150,6446,87,4865,11398,4890,9,0,2,11
3870,EAST GODAVARI,Peddapuram,MARLAVA,50,13,627,690,30,5,412,447,21,660,93,6562,7315,384,0,0,1,1
3871,EAST GODAVARI,Peddapuram,PULIMERU,201,8,527,736,124,1,236,361,149,3294,5,4380,7679,2314,1,0,0,1
3872,EAST GODAVARI,Peddapuram,R.B.KOTHURU,522,1,632,1155,216,0,235,451,394,7819,0,7871,15690,11842,1,0,3,4
3873,EAST GODAVARI,Peddapuram,RAYABHUPALAPATNAM,302,2,714,1018,173,0,199,372,249,8308,0,6306,14614,8612,6,0,4,10
3874,EAST GODAVARI,Peddapuram,SIRIVADA,25,1,292,318,14,1,116,131,18,1015,36,5887,6938,916,3,0,13,16
3875,EAST GODAVARI,Peddapuram,TATIPARTHI,113,1,454,568,76,0,155,231,80,3992,0,3615,7607,2944,6,0,1,7
3876,EAST GODAVARI,Peddapuram,TIRUPATI,290,10,523,823,182,0,280,462,157,6057,0,5697,11754,3574,1,0,0,1
3877,EAST GODAVARI,Peddapuram,TURUPU PAKALU,16,1,303,320,10,0,187,197,16,410,0,4810,5220,474,0,0,2,2
3878,EAST GODAVARI,Peddapuram,ULIMESWARAM,47,3,503,553,36,2,304,342,66,3026,114,11609,14749,2702,15,0,18,33
3879,EAST GODAVARI,Peddapuram,VADLAMURU,249,0,277,526,192,0,118,310,228,13007,0,5139,18146,11446,40,0,9,49
3880,EAST GODAVARI,Peddapuram,VALUTHIMMAPURAM,433,1,57,491,236,0,30,266,252,12013,0,1197,13210,10800,20,0,0,20
3881,EAST GODAVARI,Pithapuram,B PRATHIPADU,6,2,793,801,1,2,481,484,26,27,76,35145,35248,915,0,0,107,107
3882,EAST GODAVARI,Pithapuram,B. KOTHURU,224,0,259,483,165,0,172,337,161,8504,0,4894,13398,4844,7,0,1,8
3883,EAST GODAVARI,Pithapuram,BHOGAPURAM,335,2,614,951,244,0,354,598,367,9075,0,8611,17686,6974,13,0,12,25
3884,EAST GODAVARI,Pithapuram,CHITRADA,315,13,681,1009,214,3,336,553,420,8624,77,15183,23884,14530,18,0,31,49
3885,EAST GODAVARI,Pithapuram,FAKRUDDINPALEM,173,0,182,355,140,0,69,209,134,6937,0,1702,8639,4162,13,0,1,14
3886,EAST GODAVARI,Pithapuram,GOKIVADA,306,0,429,735,148,0,250,398,115,7344,0,5777,13121,4638,25,0,2,27
3887,EAST GODAVARI,Pithapuram,JALLURU,213,7,545,765,158,1,275,434,242,6088,33,8451,14572,6184,5,0,13,18
3888,EAST GODAVARI,Pithapuram,JAMULAPALLI,209,0,268,477,162,0,177,339,162,6747,0,4843,11590,3744,12,0,5,17
3889,EAST GODAVARI,Pithapuram,KANDARADA,218,3,613,834,147,0,286,433,152,4377,0,6421,10798,3204,0,0,3,3
3890,EAST GODAVARI,Pithapuram,KOLANKA,146,3,533,682,89,3,266,358,83,4006,167,6080,10253,2245,9,0,2,11
3891,EAST GODAVARI,Pithapuram,KUMARAPURAM,134,0,453,587,85,0,224,309,170,2076,0,7878,9954,3145,1,0,12,13
3892,EAST GODAVARI,Pithapuram,L N PURAM,16,0,568,584,4,0,323,327,155,222,0,10515,10737,4461,0,0,11,11
3893,EAST GODAVARI,Pithapuram,MADHAVAPURAM,207,1,512,720,146,1,316,463,205,7148,7,15095,22250,6096,17,0,35,52
3894,EAST GODAVARI,Pithapuram,MALLAM,298,6,766,1070,226,1,329,556,216,9650,35,8209,17894,6648,7,0,4,11
3895,EAST GODAVARI,Pithapuram,MANGITURTHI,82,1,725,808,63,1,390,454,158,2950,23,6900,9873,2169,4,0,15,19
3896,EAST GODAVARI,Pithapuram,NARASINGAPURAM,302,1,439,742,195,0,252,447,354,6690,0,8892,15582,7723,2,0,15,17
3897,EAST GODAVARI,Pithapuram,NAVAKANDRAVADA,203,4,110,317,146,0,60,206,168,9584,0,3432,13016,8246,35,0,8,43
3898,EAST GODAVARI,Pithapuram,P DONTHAMURU,229,2,603,834,152,0,416,568,261,6077,0,15303,21380,6922,2,0,16,18
3899,EAST GODAVARI,Pithapuram,P RAYAVARAM,197,0,391,588,153,0,296,449,152,5384,0,6001,11385,2741,4,0,1,5
3900,EAST GODAVARI,Pithapuram,P THIMMAPURAM,125,0,552,677,75,0,381,456,417,1990,0,9530,11520,5470,0,0,15,15
3901,EAST GODAVARI,Pithapuram,RAPARTHI,190,1,683,874,136,1,301,438,147,5804,39,13938,19781,5817,4,0,16,20
3902,EAST GODAVARI,Pithapuram,VELDURTHI,225,3,1208,1436,114,0,349,463,147,5877,0,12175,18052,5100,11,0,23,34
3903,EAST GODAVARI,Pithapuram,VIRAVA,104,3,724,831,81,1,317,399,128,5451,58,13259,18768,4108,16,0,42,58
3904,EAST GODAVARI,Pithapuram,VIRAWADA,325,4,783,1112,173,0,183,356,178,8934,0,8817,17751,6997,20,0,30,50
3905,EAST GODAVARI,Prathipadu,BAVURUVAKA,55,443,110,608,27,107,26,160,161,1218,3509,1007,5734,3477,0,2,0,2
3906,EAST GODAVARI,Prathipadu,BURADAKOTA,5,376,12,393,0,256,6,262,232,0,6885,293,7178,3875,0,0,0,0
3907,EAST GODAVARI,Prathipadu,CHINASANKARLAPUDI,106,4,880,990,59,1,313,373,211,1202,20,4316,5538,2413,0,0,0,0
3908,EAST GODAVARI,Prathipadu,CHINTALURU,381,0,537,918,75,0,137,212,129,2345,0,3867,6212,1951,0,0,3,3
3909,EAST GODAVARI,Prathipadu,DHARMAVARAM,725,16,1739,2480,208,2,372,582,391,11243,128,16219,27590,15566,35,1,23,59
3910,EAST GODAVARI,Prathipadu,GAJJANAPUDI,251,53,842,1146,104,7,271,382,332,2440,186,6668,9294,4723,1,0,0,1
3911,EAST GODAVARI,Prathipadu,GOKAVARAM,32,632,343,1007,7,291,197,495,465,192,10703,5861,16756,9825,0,24,1,25
3912,EAST GODAVARI,Prathipadu,LAMPAKALOVA,248,6,638,892,80,1,143,224,125,2064,6,3366,5436,2348,4,0,1,5
3913,EAST GODAVARI,Prathipadu,PEDA SANKARLAPUDI,321,7,771,1099,227,0,349,576,518,13198,0,14554,27752,12103,21,0,14,35
3914,EAST GODAVARI,Prathipadu,PEDDIPALEM,158,132,1354,1644,85,94,669,848,703,1508,7095,19335,27938,14407,0,29,3,32
3915,EAST GODAVARI,Prathipadu,POTHULURU,488,1,688,1177,114,0,53,167,126,1636,0,577,2213,1113,0,0,0,0
3916,EAST GODAVARI,Prathipadu,PRATHIPADU,780,66,861,1707,429,3,204,636,597,20948,145,6071,27164,15757,8,0,0,8
3917,EAST GODAVARI,Prathipadu,RACHAPALLE,261,4,1372,1637,121,0,239,360,256,5502,0,9800,15302,9204,9,0,10,19
3918,EAST GODAVARI,Prathipadu,SARABHAVARAM,20,5,792,817,3,0,260,263,61,87,0,10453,10540,1912,0,0,12,12
3919,EAST GODAVARI,Prathipadu,U.JAGANNADHAPURAM,199,0,456,655,97,0,33,130,107,2018,0,615,2633,1512,0,0,0,0
3920,EAST GODAVARI,Prathipadu,UTTARAKANCHI,452,36,1572,2060,40,5,127,172,68,1207,30,1390,2627,774,3,0,0,3
3921,EAST GODAVARI,Prathipadu,VAKAPALLE,76,0,483,559,38,0,279,317,282,1300,0,17146,18446,11071,0,0,50,50
3922,EAST GODAVARI,Prathipadu,VENKATANAGARAM,26,210,211,447,9,134,45,188,153,158,7120,834,8112,4234,0,23,2,25
3923,EAST GODAVARI,Prathipadu,VOMMANGI,554,23,1594,2171,114,0,94,208,144,2967,0,2388,5355,2739,2,0,1,3
3924,EAST GODAVARI,Prathipadu,YELURU,712,78,1144,1934,267,0,251,518,367,9416,0,3155,12571,6108,8,0,0,8
3925,EAST GODAVARI,Rajahmundry(Rural),BOMMURU,89,4,221,314,36,1,97,134,113,1998,105,5463,7566,5921,6,1,11,18
3926,EAST GODAVARI,Rajahmundry(Rural),DOWLESWARAM,246,50,462,758,32,15,152,199,166,2778,1297,6702,10777,8473,16,3,32,51
3927,EAST GODAVARI,Rajahmundry(Rural),HUKUMPETA,163,14,151,328,86,1,49,136,130,6410,95,2090,8595,7687,36,0,5,41
3928,EAST GODAVARI,Rajahmundry(Rural),KATHERU,332,4,299,635,65,0,107,172,149,1145,0,4758,5903,4185,2,0,16,18
3929,EAST GODAVARI,Rajahmundry(Rural),KOLAMURU,949,47,234,1230,473,19,72,564,461,39668,384,3098,43150,26916,220,0,15,235
3930,EAST GODAVARI,Rajahmundry(Rural),PIDIMGOYYI,77,0,139,216,63,0,114,177,150,5046,0,10263,15309,12583,30,0,68,98
3931,EAST GODAVARI,Rajahmundry(Rural),RAJAVOLU,364,2,225,591,186,1,99,286,232,8935,45,3572,12552,8393,30,0,5,35
3932,EAST GODAVARI,Rajahmundry(Rural),SATELITECITY,17,2,159,178,8,1,91,100,84,437,76,6092,6605,5368,0,0,17,17
3933,EAST GODAVARI,Rajahmundry(Rural),TORREDU,665,2,220,887,209,1,31,241,214,6854,51,560,7465,4884,16,0,1,17
3934,EAST GODAVARI,Rajahmundry(Rural),VENKATANAGARAM,323,0,178,501,195,0,64,259,183,14020,0,4560,18580,9282,47,0,5,52
3935,EAST GODAVARI,Rajanagaram,BHUPALAPATNAM,94,1,375,470,28,0,144,172,60,967,0,5641,6608,993,2,0,16,18
3936,EAST GODAVARI,Rajanagaram,CHAKRADWARABANDAM,134,2,415,551,40,1,88,129,59,1835,101,2730,4666,1088,7,1,9,17
3937,EAST GODAVARI,Rajanagaram,DIWANCHERUVU,294,3,209,506,99,0,30,129,112,4305,0,620,4925,4081,11,0,0,11
3938,EAST GODAVARI,Rajanagaram,EAST GONAGUDEM,77,2,235,314,31,1,160,192,74,1492,68,10043,11603,3266,3,0,40,43
3939,EAST GODAVARI,Rajanagaram,FERIZELLIPETA,75,1,277,353,17,0,32,49,21,181,0,1572,1753,182,0,0,5,5
3940,EAST GODAVARI,Rajanagaram,G.YERRAMPALEM,156,20,417,593,21,2,57,80,18,762,16,2029,2807,281,1,0,5,6
3941,EAST GODAVARI,Rajanagaram,KALAVACHERLA,243,9,890,1142,172,3,479,654,289,10937,76,23890,34903,11988,40,0,53,93
3942,EAST GODAVARI,Rajanagaram,KANAVARAM,121,1,622,744,41,1,115,157,35,2204,18,6140,8362,2092,10,0,23,33
3943,EAST GODAVARI,Rajanagaram,KONDA GUNTURU,101,0,519,620,46,0,206,252,81,2242,0,9009,11251,2657,4,0,10,14
3944,EAST GODAVARI,Rajanagaram,KOTHA THUNGAPADU,74,6,621,701,21,0,140,161,28,951,0,5715,6666,1281,4,0,11,15
3945,EAST GODAVARI,Rajanagaram,LALACHERUVU,4,0,98,102,0,0,25,25,19,0,0,593,593,387,0,0,0,0
3946,EAST GODAVARI,Rajanagaram,MUKKINADA,238,3,135,376,141,0,34,175,129,5429,0,624,6053,4085,9,0,0,9
3947,EAST GODAVARI,Rajanagaram,NAMAVARAM,70,0,203,273,23,0,73,96,42,1382,0,4547,5929,2116,7,0,19,26
3948,EAST GODAVARI,Rajanagaram,NANDARADA,54,7,628,689,31,1,159,191,133,2556,48,10932,13536,6767,11,0,46,57
3949,EAST GODAVARI,Rajanagaram,NARENDRAPURAM,66,1,870,937,27,0,350,377,250,795,0,12069,12864,7440,0,0,13,13
3950,EAST GODAVARI,Rajanagaram,PALACHARLA,219,1,119,339,60,0,26,86,51,3105,0,1678,4783,2060,10,0,3,13
3951,EAST GODAVARI,Rajanagaram,PALLAKADIAM,341,4,411,756,132,1,131,264,154,8253,6,7684,15943,6351,43,0,38,81
3952,EAST GODAVARI,Rajanagaram,PATHA THUNGAPADU,202,12,568,782,117,2,94,213,96,8099,102,4566,12767,5006,32,0,10,42
3953,EAST GODAVARI,Rajanagaram,RADHEYAPALEM,116,3,351,470,45,3,105,153,75,1720,198,4675,6593,1919,3,1,15,19
3954,EAST GODAVARI,Rajanagaram,RAJANAGARAM,258,21,690,969,45,1,145,191,112,2944,14,9061,12019,6725,6,0,10,16
3955,EAST GODAVARI,Rajanagaram,SAMPATHANAGARAM,21,0,531,552,5,0,209,214,25,206,0,6187,6393,566,0,0,5,5
3956,EAST GODAVARI,Rajanagaram,SEETHARAMAPURAM,29,9,832,870,16,2,436,454,228,1076,20,26397,27493,11376,2,0,93,95
3957,EAST GODAVARI,Rajanagaram,SRIKRISHNAPATNAM,132,1,148,281,17,0,19,36,21,363,0,100,463,110,0,0,0,0
3958,EAST GODAVARI,Rajanagaram,THOKADA,379,9,701,1089,235,1,186,422,266,16413,61,8673,25147,13359,69,0,28,97
3959,EAST GODAVARI,Rajanagaram,VELUGUBANDA,84,0,620,704,35,0,161,196,40,2095,0,8132,10227,1168,5,0,16,21
3960,EAST GODAVARI,Rajavommangi,AMINABADA,16,176,251,443,8,136,182,326,193,280,7788,8988,17056,7808,0,20,21,41
3961,EAST GODAVARI,Rajavommangi,BADADANAMPALLI,11,530,94,635,1,446,72,519,484,82,26010,3771,29863,15832,0,54,4,58
3962,EAST GODAVARI,Rajavommangi,CHERUVUKOMMUPALEM,52,349,404,805,4,176,88,268,223,55,7579,2290,9924,5211,0,11,2,13
3963,EAST GODAVARI,Rajavommangi,CHIKILINTHA,7,588,23,618,3,460,11,474,480,83,25636,821,26540,14139,0,50,3,53
3964,EAST GODAVARI,Rajavommangi,DUSARIPAMU,56,208,450,714,19,119,274,412,332,974,7411,17951,26336,14174,1,14,37,52
3965,EAST GODAVARI,Rajavommangi,GADUVAKURTHI,1,448,19,468,0,370,13,383,419,0,21171,589,21760,12138,0,43,0,43
3966,EAST GODAVARI,Rajavommangi,JADDANGI,79,748,296,1123,30,409,129,568,487,1056,24523,5366,30945,16832,0,70,15,85
3967,EAST GODAVARI,Rajavommangi,KINDRA,4,479,157,640,0,299,124,423,437,0,16224,6563,22787,12281,0,39,7,46
3968,EAST GODAVARI,Rajavommangi,KIRRABU,0,268,15,283,0,230,11,241,241,0,17028,897,17925,9957,0,66,3,69
3969,EAST GODAVARI,Rajavommangi,KONDAPALLI,3,210,1,214,1,158,1,160,136,12,13531,109,13652,7523,0,83,1,84
3970,EAST GODAVARI,Rajavommangi,LABBARTHI,11,327,512,850,3,237,342,582,544,49,11949,16162,28160,15731,0,17,3,20
3971,EAST GODAVARI,Rajavommangi,LAGARAYI,13,398,137,548,6,204,71,281,250,287,11888,4015,16190,9027,0,22,6,28
3972,EAST GODAVARI,Rajavommangi,LODODDI,1,295,7,303,0,215,6,221,218,0,12386,150,12536,7184,0,37,0,37
3973,EAST GODAVARI,Rajavommangi,MAREDUPAKA,14,427,26,467,9,346,14,369,319,248,19767,649,20664,11318,0,54,0,54
3974,EAST GODAVARI,Rajavommangi,RAJAVOMMANGI,126,723,1365,2214,52,454,913,1419,1270,2359,26533,60960,89852,58706,3,87,167,257
3975,EAST GODAVARI,Rajavommangi,SARABHAVARAM,8,412,74,494,0,260,16,276,273,0,12271,565,12836,7511,0,29,1,30
3976,EAST GODAVARI,Rajavommangi,THANTIKONDA,19,427,475,921,11,271,264,546,502,654,15150,11189,26993,14344,0,31,12,43
3977,EAST GODAVARI,Rajavommangi,VANCHANGI,4,500,3,507,0,382,3,385,359,0,23185,139,23324,12093,0,71,0,71
3978,EAST GODAVARI,Rajavommangi,VATANGI,4,626,31,661,1,449,14,464,460,120,32752,431,33303,18046,1,127,0,128
3979,EAST GODAVARI,Ramachandrapuram,ADIVARAPU PETA,91,2,91,184,83,3,25,111,88,2631,80,418,3129,1582,0,0,0,0
3980,EAST GODAVARI,Ramachandrapuram,ANNAI PETA,27,0,142,169,14,0,51,65,44,137,0,583,720,369,0,0,0,0
3981,EAST GODAVARI,Ramachandrapuram,BAPANAYYA CHERUVU,20,3,326,349,9,3,203,215,183,149,57,3471,3677,2196,0,0,0,0
3982,EAST GODAVARI,Ramachandrapuram,BEEMAKRROSUPALEM,169,2,206,377,115,1,94,210,143,2778,48,1284,4110,1990,1,0,0,1
3983,EAST GODAVARI,Ramachandrapuram,CHODAVARAM,502,3,330,835,226,2,105,333,299,2521,32,1090,3643,1744,0,0,0,0
3984,EAST GODAVARI,Ramachandrapuram,DRAKSHARAMA,258,34,306,598,132,1,6,139,109,5330,41,63,5434,3107,5,0,0,5
3985,EAST GODAVARI,Ramachandrapuram,HASANBADA,104,1,190,295,65,0,77,142,82,2024,0,1869,3893,1833,0,0,0,0
3986,EAST GODAVARI,Ramachandrapuram,JAGANNAIKULAPALEM,90,4,307,401,59,4,97,160,79,1002,64,1449,2515,1095,0,0,0,0
3987,EAST GODAVARI,Ramachandrapuram,KANDULAPALEM,137,0,351,488,73,0,192,265,210,1931,0,4222,6153,3378,0,0,0,0
3988,EAST GODAVARI,Ramachandrapuram,KAPAVARAM,114,4,335,453,60,1,147,208,185,1589,12,2581,4182,2259,0,0,0,0
3989,EAST GODAVARI,Ramachandrapuram,MALA PADU,160,0,66,226,138,0,62,200,152,5137,0,2079,7216,3669,2,0,0,2
3990,EAST GODAVARI,Ramachandrapuram,NARASAPURAPUPETA,153,5,357,515,100,3,215,318,221,3210,92,4393,7695,4143,0,0,0,0
3991,EAST GODAVARI,Ramachandrapuram,NELAPARTHIPADU,8,0,182,190,0,0,50,50,21,0,0,450,450,136,0,0,0,0
3992,EAST GODAVARI,Ramachandrapuram,ODURU,381,4,196,581,176,3,26,205,133,4517,74,203,4794,2423,4,0,0,4
3993,EAST GODAVARI,Ramachandrapuram,TADIPALLE,105,1,162,268,56,0,78,134,92,730,0,565,1295,601,0,0,0,0
3994,EAST GODAVARI,Ramachandrapuram,THALLAPALEM,92,2,1165,1259,23,0,216,239,202,377,0,3262,3639,1976,0,0,1,1
3995,EAST GODAVARI,Ramachandrapuram,THOTAPETA,183,9,375,567,123,5,51,179,157,4655,95,1536,6286,3986,1,0,0,1
3996,EAST GODAVARI,Ramachandrapuram,UNDURU,186,2,313,501,132,2,131,265,208,6035,12,2916,8963,4211,5,0,0,5
3997,EAST GODAVARI,Ramachandrapuram,UTRUMILLI,91,3,258,352,72,1,127,200,129,2492,4,3280,5776,3552,1,0,1,2
3998,EAST GODAVARI,Ramachandrapuram,VEGAYAMMAPETA,320,2,750,1072,210,0,305,515,452,4963,0,4294,9257,4595,1,0,0,1
3999,EAST GODAVARI,Ramachandrapuram,VELAMPALEM,200,8,784,992,32,3,124,159,135,541,60,1905,2506,1167,0,0,0,0
4000,EAST GODAVARI,Ramachandrapuram,VELLA,186,6,1179,1371,114,2,519,635,156,1119,12,4948,6079,1030,0,0,0,0
4001,EAST GODAVARI,Ramachandrapuram,VENKATAYAPALEM,318,4,650,972,150,1,72,223,196,2163,8,1609,3780,2303,0,0,0,0
4002,EAST GODAVARI,Ramachandrapuram,YANAMADALA,258,6,357,621,175,3,168,346,322,3594,69,3147,6810,3620,0,0,0,0
4003,EAST GODAVARI,Ramachandrapuram,YERUPALLE,105,0,369,474,60,0,109,169,22,778,0,538,1316,176,0,0,0,0
4004,EAST GODAVARI,Rampachodavaram,AKURU,2,406,3,411,1,301,1,303,293,50,15418,18,15486,8144,0,28,0,28
4005,EAST GODAVARI,Rampachodavaram,B.VELAMALAKOTA,10,713,22,745,8,527,15,550,515,283,34054,491,34828,19940,0,91,0,91
4006,EAST GODAVARI,Rampachodavaram,BANDAPALLE,1,521,10,532,1,395,3,399,393,94,27180,110,27384,14839,0,91,0,91
4007,EAST GODAVARI,Rampachodavaram,BEERAMPALLE,0,444,15,459,0,365,10,375,406,0,25765,588,26353,15309,0,62,2,64
4008,EAST GODAVARI,Rampachodavaram,BOLAGONDA,4,763,15,782,0,556,10,566,584,0,38104,472,38576,22089,0,107,0,107
4009,EAST GODAVARI,Rampachodavaram,BUSIGUDEM,3,471,6,480,1,354,4,359,347,32,14159,141,14332,8634,0,1,0,1
4010,EAST GODAVARI,Rampachodavaram,FOULKSPETA,7,469,16,492,4,352,11,367,374,222,18792,224,19238,12079,0,32,0,32
4011,EAST GODAVARI,Rampachodavaram,I.POLAVARAM,15,615,67,697,6,321,17,344,341,312,14131,1029,15472,8775,1,14,3,18
4012,EAST GODAVARI,Rampachodavaram,MADICHERLA,2,431,3,436,0,327,3,330,361,0,15815,83,15898,8367,0,10,0,10
4013,EAST GODAVARI,Rampachodavaram,MARRIWADA,1,361,0,362,0,247,0,247,263,0,11492,0,11492,6891,0,19,0,19
4014,EAST GODAVARI,Rampachodavaram,MUSURUMILLI,9,467,16,492,4,276,5,285,288,364,16521,445,17330,9740,2,33,3,38
4015,EAST GODAVARI,Rampachodavaram,PEDAGEDDADA,12,744,38,794,0,461,24,485,500,0,33937,1278,35215,21799,0,93,1,94
4016,EAST GODAVARI,Rampachodavaram,RAMPA,18,592,5,615,0,249,3,252,230,0,8460,159,8619,5127,0,8,1,9
4017,EAST GODAVARI,Rampachodavaram,RAMPACHODAVARAM,66,510,233,809,21,181,65,267,214,981,9679,4090,14750,11472,1,28,12,41
4018,EAST GODAVARI,Rampachodavaram,TAMARAPALLE,7,655,2,664,2,446,0,448,440,32,20014,0,20046,10276,0,40,0,40
4019,EAST GODAVARI,Rampachodavaram,TATIWADA,3,260,6,269,1,215,4,220,218,63,11631,139,11833,7136,0,21,0,21
4020,EAST GODAVARI,Rampachodavaram,UTLA,1,362,8,371,0,288,6,294,300,0,17349,217,17566,9386,0,34,0,34
4021,EAST GODAVARI,Rampachodavaram,VADAPALLE,0,254,4,258,0,201,1,202,192,0,16354,49,16403,9058,0,69,0,69
4022,EAST GODAVARI,Rampachodavaram,VEMULAKONDA,0,1006,1,1007,0,694,0,694,715,0,34715,0,34715,17225,0,66,0,66
4023,EAST GODAVARI,Rangampeta,CHANDREDU,139,5,359,503,73,3,153,229,107,4158,240,9856,14254,5472,9,0,21,30
4024,EAST GODAVARI,Rangampeta,DODDIGUNTA,322,15,929,1266,79,0,258,337,133,2074,0,9725,11799,4106,2,0,6,8
4025,EAST GODAVARI,Rangampeta,ELAKOLANU,178,7,777,962,106,1,349,456,218,4547,5,17334,21886,7893,9,0,52,61
4026,EAST GODAVARI,Rangampeta,G.DONTHAMURU,343,2,548,893,242,2,265,509,347,12357,55,12117,24529,12618,18,0,16,34
4027,EAST GODAVARI,Rangampeta,KOTAPADU,218,2,698,918,124,0,172,296,109,6017,0,7165,13182,3979,13,0,21,34
4028,EAST GODAVARI,Rangampeta,MARRIPUDI,415,2,776,1193,297,1,393,691,372,15850,118,17953,33921,17739,25,1,27,53
4029,EAST GODAVARI,Rangampeta,MUKUNDAVARAM,249,2,493,744,135,1,177,313,173,8645,60,8828,17533,8986,35,0,33,68
4030,EAST GODAVARI,Rangampeta,NALLAMILLI,196,0,538,734,135,0,307,442,193,10013,0,18809,28822,11283,42,0,56,98
4031,EAST GODAVARI,Rangampeta,PEDARAYAVARAM,273,0,266,539,105,0,135,240,101,2955,0,5828,8783,2389,1,0,5,6
4032,EAST GODAVARI,Rangampeta,RANGAMPETA,140,19,859,1018,80,3,300,383,224,4378,58,15016,19452,9397,9,0,24,33
4033,EAST GODAVARI,Rangampeta,S.T.RAJA PURAM,145,0,165,310,71,0,63,134,73,4743,0,3469,8212,4404,11,0,10,21
4034,EAST GODAVARI,Rangampeta,SINGAMPALLE,146,3,714,863,94,1,313,408,245,7042,63,18993,26098,13495,34,0,73,107
4035,EAST GODAVARI,Rangampeta,SUBHADRAMPETA,99,9,518,626,39,2,94,135,33,2006,93,4013,6112,1492,4,0,8,12
4036,EAST GODAVARI,Rangampeta,VADISALERU,731,7,911,1649,395,1,267,663,326,15932,1,11076,27009,7966,32,0,7,39
4037,EAST GODAVARI,Rangampeta,VEERAMPALEM,303,1,273,577,156,0,25,181,139,8237,0,512,8749,5756,21,0,0,21
4038,EAST GODAVARI,Rangampeta,VENKATAPURAM,84,5,549,638,38,1,198,237,108,1620,24,9380,11024,4596,3,0,16,19
4039,EAST GODAVARI,Ravulapalem,DEVARAPALLI,297,1,1417,1715,137,0,780,917,836,7049,0,20843,27892,16730,14,0,6,20
4040,EAST GODAVARI,Ravulapalem,ETHAKOTA,187,17,417,621,138,9,193,340,281,5850,312,7787,13949,8876,9,0,16,25
4041,EAST GODAVARI,Ravulapalem,GOPALAPURAM,421,10,294,725,282,5,128,415,386,11595,345,6097,18037,10953,16,1,6,23
4042,EAST GODAVARI,Ravulapalem,KETHARAJUPALLI,122,0,76,198,85,0,18,103,91,6889,0,429,7318,4418,32,0,0,32
4043,EAST GODAVARI,Ravulapalem,KOMARAJU LANKA,227,5,271,503,135,3,70,208,201,6415,79,1809,8303,6200,6,0,0,6
4044,EAST GODAVARI,Ravulapalem,LAKSHMIPOLAVARAM,206,11,376,593,144,6,143,293,258,8853,473,3820,13146,9069,32,1,4,37
4045,EAST GODAVARI,Ravulapalem,MUMMIDIVARAPPADU,242,1,76,319,154,0,7,161,132,9049,0,445,9494,5583,19,0,2,21
4046,EAST GODAVARI,Ravulapalem,PODAGATLAPALLI,387,7,421,815,231,3,66,300,227,15548,164,1727,17439,11080,39,0,5,44
4047,EAST GODAVARI,Ravulapalem,RAVULAPADU,317,23,451,791,161,6,243,410,409,5076,185,6972,12233,10344,0,0,0,0
4048,EAST GODAVARI,Ravulapalem,RAVULAPALEM,249,27,689,965,102,4,129,235,212,3743,52,5635,9430,8191,4,0,9,13
4049,EAST GODAVARI,Ravulapalem,UBALANKA,310,41,772,1123,118,10,205,333,308,1817,336,4249,6402,4932,0,1,1,2
4050,EAST GODAVARI,Ravulapalem,VEDIRESWARAM,156,12,584,752,65,0,177,242,232,3237,0,6061,9298,8150,6,0,2,8
4051,EAST GODAVARI,Rayavaram,CHELLURU,355,9,1021,1385,214,4,378,596,525,5761,109,9634,15504,9629,0,0,1,1
4052,EAST GODAVARI,Rayavaram,KURAKALLAPALLE,33,8,357,398,21,5,230,256,227,1309,256,7050,8615,5058,4,0,1,5
4053,EAST GODAVARI,Rayavaram,KURMAPURAM,172,6,348,526,132,1,209,342,249,5056,40,5080,10176,6038,4,0,0,4
4054,EAST GODAVARI,Rayavaram,LOLLA,129,0,145,274,90,0,79,169,116,7648,0,4050,11698,5403,34,0,7,41
4055,EAST GODAVARI,Rayavaram,MACHAVARAM,593,3,724,1320,355,0,49,404,370,12107,0,1800,13907,9395,6,0,2,8
4056,EAST GODAVARI,Rayavaram,NADURUBADA,96,3,185,284,70,1,107,178,134,2091,2,3155,5248,2739,0,0,0,0
4057,EAST GODAVARI,Rayavaram,PASALAPUDI,294,3,597,894,170,2,242,414,356,2701,9,4370,7080,4614,0,0,1,1
4058,EAST GODAVARI,Rayavaram,RAYAVARAM,280,13,452,745,121,6,175,302,261,6117,394,9353,15864,10663,13,0,21,34
4059,EAST GODAVARI,Rayavaram,SOMESWARAM,239,4,532,775,132,2,147,281,216,3154,33,2684,5871,3647,1,0,1,2
4060,EAST GODAVARI,Rayavaram,V.SAVARAM,51,3,502,556,30,1,249,280,268,161,5,1359,1525,1122,0,0,0,0
4061,EAST GODAVARI,Rayavaram,VEDURUPAKA,231,11,645,887,148,6,251,405,299,4342,84,4663,9089,5388,1,0,0,1
4062,EAST GODAVARI,Rayavaram,VENTURU,261,11,840,1112,120,2,493,615,538,836,5,6408,7249,3853,0,0,0,0
4063,EAST GODAVARI,Razole,B.SAVARAM,110,3,97,210,64,2,53,119,113,4803,79,3632,8514,6685,20,0,19,39
4064,EAST GODAVARI,Razole,CHENNADAM,238,1,1,240,156,0,0,156,96,8888,0,0,8888,4486,21,0,0,21
4065,EAST GODAVARI,Razole,CHINTALAPALLE,143,4,169,316,71,0,66,137,71,4935,0,3295,8230,4111,22,0,14,36
4066,EAST GODAVARI,Razole,KADALI,470,10,268,748,213,2,68,283,185,10374,70,3132,13576,7523,19,0,2,21
4067,EAST GODAVARI,Razole,KATRENIPADU,197,4,326,527,54,0,84,138,67,3438,0,3812,7250,3659,7,0,7,14
4068,EAST GODAVARI,Razole,KUNAVARAM,60,0,271,331,39,0,153,192,129,2902,0,11802,14704,8713,18,0,70,88
4069,EAST GODAVARI,Razole,MERKAPALEM,152,0,96,248,98,0,20,118,75,8139,0,1151,9290,5297,48,0,6,54
4070,EAST GODAVARI,Razole,MULIKIPALLE,76,2,96,174,55,1,53,109,92,4497,80,4187,8764,6958,27,0,24,51
4071,EAST GODAVARI,Razole,PALAGUMMI,72,2,115,189,40,1,74,115,98,2634,8,5671,8313,5830,9,0,21,30
4072,EAST GODAVARI,Razole,PODALADA,53,3,87,143,26,1,55,82,75,1288,21,3921,5230,4321,5,0,10,15
4073,EAST GODAVARI,Razole,PONNAMANDA,343,4,197,544,151,2,63,216,117,8610,96,3360,12066,5704,12,0,3,15
4074,EAST GODAVARI,Razole,RAZOLE,72,4,132,208,28,1,77,106,64,1583,9,2863,4455,2498,6,0,5,11
4075,EAST GODAVARI,Razole,SIVAKODU,354,18,284,656,90,1,33,124,92,5479,19,1088,6586,4840,26,0,3,29
4076,EAST GODAVARI,Razole,SOMPALLE,60,6,259,325,23,2,125,150,128,813,177,9433,10423,9524,4,1,62,67
4077,EAST GODAVARI,Razole,TATIPAKA,304,9,515,828,133,2,170,305,218,10492,79,9868,20439,12736,52,0,42,94
4078,EAST GODAVARI,Razole,VEGIVARIPALEM,92,1,160,253,33,0,56,89,68,1359,0,1765,3124,2310,1,0,2,3
4079,EAST GODAVARI,Rowthulapudi,A.MALLAVARAM,149,0,796,945,55,0,464,519,469,2920,0,29939,32859,19054,8,0,98,106
4080,EAST GODAVARI,Rowthulapudi,BALARAMPURAM,81,0,401,482,60,0,181,241,172,3088,0,8517,11605,6434,10,0,17,27
4081,EAST GODAVARI,Rowthulapudi,BANGARAYYAPETA,32,5,327,364,18,0,132,150,82,642,0,5931,6573,3553,1,0,8,9
4082,EAST GODAVARI,Rowthulapudi,DIGUVA SIVADA,0,0,269,269,0,0,226,226,233,0,0,14544,14544,8325,0,0,46,46
4083,EAST GODAVARI,Rowthulapudi,GANGAVARAM,61,0,341,402,36,0,225,261,219,1541,0,13082,14623,7991,2,0,31,33
4084,EAST GODAVARI,Rowthulapudi,GIDAJAM,244,5,630,879,172,0,252,424,330,8408,0,8269,16677,9077,19,0,11,30
4085,EAST GODAVARI,Rowthulapudi,GUMMAREGULA,61,28,509,598,11,4,135,150,128,266,29,6087,6382,4641,0,0,23,23
4086,EAST GODAVARI,Rowthulapudi,JALDAM,7,279,5,291,2,195,2,199,204,28,8589,45,8662,4619,0,19,0,19
4087,EAST GODAVARI,Rowthulapudi,LACHIREDDYPALEM,202,109,505,816,138,33,126,297,245,8014,666,3715,12395,6737,16,0,4,20
4088,EAST GODAVARI,Rowthulapudi,M.KOTHURU,27,155,53,235,14,122,38,174,190,415,5887,2451,8753,4759,0,9,7,16
4089,EAST GODAVARI,Rowthulapudi,MULAGAPUDI,201,25,938,1164,122,3,363,488,407,5541,44,4106,9691,4920,4,0,0,4
4090,EAST GODAVARI,Rowthulapudi,NAMAGIRI NARENDRAPATNAM,137,71,781,989,64,25,314,403,375,2686,468,9265,12419,6807,4,0,7,11
4091,EAST GODAVARI,Rowthulapudi,P.CHAMAVARAM,368,2,586,956,135,0,152,287,116,4672,0,2422,7094,2505,1,0,0,1
4092,EAST GODAVARI,Rowthulapudi,PARUPAKA,173,6,760,939,81,0,387,468,396,3119,0,17361,20480,10983,6,0,30,36
4093,EAST GODAVARI,Rowthulapudi,RAGHAVAPATNAM,26,457,40,523,0,9,2,11,6,0,70,4,74,27,0,0,0,0
4094,EAST GODAVARI,Rowthulapudi,RAJAVARAM,97,56,333,486,51,20,167,238,178,1966,270,7839,10075,4940,0,0,18,18
4095,EAST GODAVARI,Rowthulapudi,ROWTHULAPUDI,715,3,1721,2439,264,0,230,494,429,10162,0,5707,15869,8210,19,0,7,26
4096,EAST GODAVARI,Rowthulapudi,S.AGRAHARAM,76,0,1047,1123,29,0,206,235,192,939,0,6201,7140,3485,0,0,11,11
4097,EAST GODAVARI,Rowthulapudi,S.PYDIPALA,37,192,529,758,15,69,334,418,416,518,1933,14809,17260,12711,0,0,11,11
4098,EAST GODAVARI,Rowthulapudi,SRINGAVARAM,221,0,937,1158,109,0,70,179,144,3387,0,912,4299,2179,1,0,0,1
4099,EAST GODAVARI,Sakhinetipalle,ANTARVEDI,294,0,302,596,142,0,63,205,130,12551,0,4474,17025,9649,33,0,9,42
4100,EAST GODAVARI,Sakhinetipalle,ANTARVEDIPALEM,152,0,122,274,73,0,47,120,100,5125,0,3789,8914,6860,19,0,15,34
4101,EAST GODAVARI,Sakhinetipalle,ANTERVEDI DEVASTHANAM,167,3,111,281,82,1,42,125,57,6930,75,3005,10010,4034,37,0,11,48
4102,EAST GODAVARI,Sakhinetipalle,APPANARAMUNI LANKA,161,1,314,476,57,1,75,133,104,3866,21,3596,7483,5138,9,0,7,16
4103,EAST GODAVARI,Sakhinetipalle,GONDI,237,1,334,572,153,0,112,265,181,10677,0,6703,17380,10890,43,0,20,63
4104,EAST GODAVARI,Sakhinetipalle,GUDIMULA,113,0,163,276,75,0,89,164,115,4995,0,5865,10860,5609,16,0,22,38
4105,EAST GODAVARI,Sakhinetipalle,KESAVADASUPALEM,244,2,167,413,162,1,95,258,181,10365,27,5386,15778,9588,27,0,9,36
4106,EAST GODAVARI,Sakhinetipalle,MORI,113,8,281,402,50,3,121,174,127,2190,97,7470,9757,6717,1,0,12,13
4107,EAST GODAVARI,Sakhinetipalle,MORIPADU,123,0,310,433,57,0,124,181,129,3078,0,5903,8981,5928,7,0,8,15
4108,EAST GODAVARI,Sakhinetipalle,PALLI PALEM,28,0,568,596,12,0,352,364,287,529,0,17410,17939,10584,0,0,25,25
4109,EAST GODAVARI,Sakhinetipalle,RAMESWARAM,244,4,277,525,134,3,132,269,217,5226,83,5334,10643,7432,2,0,2,4
4110,EAST GODAVARI,Sakhinetipalle,SAKINETIPALLE,348,14,324,686,88,1,64,153,103,5669,96,2295,8060,5456,13,0,1,14
4111,EAST GODAVARI,Sakhinetipalle,SAKINETIPALLE LANKA,101,17,201,319,46,10,68,124,82,2845,396,4870,8111,5152,10,0,16,26
4112,EAST GODAVARI,Sakhinetipalle,SRUNGAVARAPPADU,126,4,222,352,69,0,67,136,115,4216,0,3286,7502,5050,17,0,7,24
4113,EAST GODAVARI,Sakhinetipalle,TEKISETTI PALEM,9,30,58,97,3,20,30,53,43,214,1624,2149,3987,2824,0,6,4,10
4114,EAST GODAVARI,Sakhinetipalle,VUYYURIVARI MERAKA,119,1,149,269,64,1,81,146,113,4139,2,4220,8361,6018,9,0,3,12
4115,EAST GODAVARI,Samalkota,ATCHAM  PETA,173,2,530,705,101,0,173,274,100,4123,0,3781,7904,3204,9,0,0,9
4116,EAST GODAVARI,Samalkota,BOYANAPUDI,36,0,331,367,22,0,259,281,180,495,0,12468,12963,6468,0,0,16,16
4117,EAST GODAVARI,Samalkota,CHANDRAM PALEM,203,3,605,811,81,3,202,286,224,1823,92,6958,8873,6210,0,0,7,7
4118,EAST GODAVARI,Samalkota,G. KOTHURU,105,2,141,248,81,1,63,145,78,5064,9,2198,7271,4383,18,0,4,22
4119,EAST GODAVARI,Samalkota,G. MEDAPADU,249,6,1376,1631,62,0,269,331,279,1860,0,7160,9020,6292,5,0,12,17
4120,EAST GODAVARI,Samalkota,GONCHALA,268,2,334,604,199,1,161,361,197,5596,29,1892,7517,3978,3,0,0,3
4121,EAST GODAVARI,Samalkota,HUSSIANPURAM,279,4,377,660,166,0,124,290,258,7900,0,4637,12537,8738,7,0,4,11
4122,EAST GODAVARI,Samalkota,KAPAVARAM,189,2,248,439,125,0,144,269,133,6074,0,5295,11369,4647,6,0,2,8
4123,EAST GODAVARI,Samalkota,MADHAVAPATNAM,164,2,453,619,97,1,172,270,214,3956,26,5435,9417,6778,4,0,3,7
4124,EAST GODAVARI,Samalkota,NAVARA,183,14,674,871,92,5,173,270,146,3392,175,4761,8328,4450,3,0,5,8
4125,EAST GODAVARI,Samalkota,P. VEMAVARAM,67,2,586,655,37,2,266,305,74,1524,17,8888,10429,2376,0,0,9,9
4126,EAST GODAVARI,Samalkota,PANASAPADU,7,3,517,527,4,2,244,250,230,69,38,5811,5918,4038,0,0,2,2
4127,EAST GODAVARI,Samalkota,PANDRAVADA,15,2,300,317,7,1,165,173,142,248,38,6607,6893,4801,0,0,5,5
4128,EAST GODAVARI,Samalkota,PAVARA,275,5,218,498,176,3,58,237,200,6771,92,1146,8009,4719,5,0,0,5
4129,EAST GODAVARI,Samalkota,PEDABRAHMADEVAM,256,17,1159,1432,69,1,447,517,184,1587,14,12455,14056,3958,1,0,8,9
4130,EAST GODAVARI,Samalkota,UNDURU,438,7,554,999,292,3,240,535,313,10908,41,7544,18493,9541,2,0,9,11
4131,EAST GODAVARI,Samalkota,VENKATAKRISHNARAYAPURAM,690,8,333,1031,319,6,70,395,315,13508,277,1338,15123,7479,11,0,0,11
4132,EAST GODAVARI,Samalkota,VETLAPALEM,966,30,2010,3006,369,5,426,800,746,8017,93,8894,17004,11249,7,0,8,15
4133,EAST GODAVARI,Sankhavaram,ANNAVARAM,473,16,1662,2151,106,0,216,322,277,3840,0,6144,9984,7783,1,0,1,2
4134,EAST GODAVARI,Sankhavaram,GONDHI KOTHAPALLI,159,4,586,749,109,0,355,464,433,4633,0,16358,20991,13448,9,0,17,26
4135,EAST GODAVARI,Sankhavaram,GOWRAMPETA,31,255,390,676,16,138,127,281,180,830,3898,4222,8950,2977,0,2,5,7
4136,EAST GODAVARI,Sankhavaram,JAGGAMPETA,110,8,613,731,76,6,188,270,197,5541,426,7064,13031,6559,24,2,1,27
4137,EAST GODAVARI,Sankhavaram,KATHIPUDI,399,8,1430,1837,84,0,380,464,362,3523,0,16067,19590,13713,3,0,8,11
4138,EAST GODAVARI,Sankhavaram,KONTHANGI,151,28,928,1107,89,12,322,423,304,5175,418,16559,22152,12826,8,0,36,44
4139,EAST GODAVARI,Sankhavaram,MANDAPAM,341,232,837,1410,125,142,283,550,434,1646,4306,10187,16139,8067,0,2,13,15
4140,EAST GODAVARI,Sankhavaram,NELLIPUDI,359,24,1177,1560,124,13,412,549,492,7383,758,25381,33522,26955,26,2,74,102
4141,EAST GODAVARI,Sankhavaram,PEDA.MALLAPURAM,80,950,108,1138,6,243,36,285,263,100,5188,647,5935,3964,0,2,0,2
4142,EAST GODAVARI,Sankhavaram,SANKHAVARAM,2004,40,2769,4813,416,0,193,609,468,8791,0,4884,13675,7731,1,0,1,2
4143,EAST GODAVARI,Sankhavaram,VAZRAKUTAM,88,7,281,376,49,3,77,129,49,3211,70,2339,5620,1972,9,0,0,9
4144,EAST GODAVARI,Sankhavaram,VELANGI,32,561,18,611,9,305,8,322,308,481,11161,250,11892,7024,2,18,0,20
4145,EAST GODAVARI,Seethanagaram,BOBBILLANKA,529,4,278,811,257,2,31,290,252,9759,34,717,10510,8289,10,0,0,10
4146,EAST GODAVARI,Seethanagaram,CHINAKONDEPUDI,290,109,566,965,84,36,137,257,104,2949,1573,4753,9275,2777,0,1,0,1
4147,EAST GODAVARI,Seethanagaram,HUNDESWARAPURAM,243,15,325,583,107,0,72,179,86,3790,0,2404,6194,2160,6,0,3,9
4148,EAST GODAVARI,Seethanagaram,INAGANTIVARI PETA,175,0,243,418,103,0,123,226,72,4254,0,3490,7744,2481,5,0,2,7
4149,EAST GODAVARI,Seethanagaram,JALIMUDUI,96,1,75,172,37,0,0,37,30,1571,0,0,1571,1103,2,0,0,2
4150,EAST GODAVARI,Seethanagaram,KATAVARAM,254,4,188,446,42,0,15,57,33,1295,0,168,1463,709,0,0,0,0
4151,EAST GODAVARI,Seethanagaram,KUNAVARAM,121,8,598,727,71,4,365,440,47,4502,151,16663,21316,1971,20,1,29,50
4152,EAST GODAVARI,Seethanagaram,MIRTHIPADU,106,7,246,359,53,0,142,195,168,2281,0,4996,7277,5145,3,0,3,6
4153,EAST GODAVARI,Seethanagaram,MUGGAULLA,241,5,169,415,138,1,77,216,113,6075,1,2038,8114,3629,12,0,0,12
4154,EAST GODAVARI,Seethanagaram,MULAKALLANKA,0,0,67,67,0,0,13,13,12,0,0,343,343,264,0,0,0,0
4155,EAST GODAVARI,Seethanagaram,MUNIKUDALI,165,1,124,290,94,0,55,149,98,4501,0,2300,6801,2961,15,0,2,17
4156,EAST GODAVARI,Seethanagaram,NAGAM PALLE,298,47,193,538,187,23,123,333,248,7880,716,6171,14767,9329,17,0,13,30
4157,EAST GODAVARI,Seethanagaram,PURUSHOTHA PATNAM,360,47,228,635,140,7,76,223,170,5108,68,3178,8354,4742,6,0,5,11
4158,EAST GODAVARI,Seethanagaram,RAGHUDEVA PURAM,357,89,933,1379,135,45,239,419,155,6170,2595,5500,14265,4705,23,12,2,37
4159,EAST GODAVARI,Seethanagaram,SEETHANAGARAM,122,17,151,290,81,8,73,162,123,4651,647,3303,8601,4731,9,2,6,17
4160,EAST GODAVARI,Seethanagaram,SINGAVARAM,155,2,311,468,81,0,80,161,88,4818,0,4153,8971,3737,11,0,4,15
4161,EAST GODAVARI,Seethanagaram,VANGALAPUDI,239,1,311,551,131,1,108,240,127,5585,50,5211,10846,3806,7,0,4,11
4162,EAST GODAVARI,Thallarevu,CHOLLANGI,208,0,271,479,108,0,121,229,189,4441,0,4526,8967,5714,3,0,1,4
4163,EAST GODAVARI,Thallarevu,CHOLLANGI PETA,124,1,453,578,79,0,187,266,201,1816,0,3577,5393,2642,0,0,0,0
4164,EAST GODAVARI,Thallarevu,G. VEMAVARAM,78,1,843,922,41,0,263,304,235,1961,0,8195,10156,5980,6,0,3,9
4165,EAST GODAVARI,Thallarevu,GADIMOGA,182,0,2649,2831,92,0,65,157,129,5512,0,2262,7774,4699,18,0,4,22
4166,EAST GODAVARI,Thallarevu,GEOGE PETA,216,5,230,451,110,3,135,248,209,2337,119,3157,5613,3362,0,0,0,0
4167,EAST GODAVARI,Thallarevu,GOVA LANKA,282,1,3,286,145,0,3,148,99,2891,0,60,2951,1626,0,0,0,0
4168,EAST GODAVARI,Thallarevu,INJARAM,464,11,578,1053,282,6,173,461,380,7824,95,3721,11640,6788,1,0,0,1
4169,EAST GODAVARI,Thallarevu,KORINGA,575,6,2646,3227,222,0,311,533,456,6206,0,7941,14147,9511,6,0,2,8
4170,EAST GODAVARI,Thallarevu,LATCHIPALEM,27,0,208,235,22,0,148,170,90,1082,0,6870,7952,3449,2,0,11,13
4171,EAST GODAVARI,Thallarevu,NEELAPALLE,183,18,621,822,66,1,75,142,114,1283,17,701,2001,1205,0,0,0,0
4172,EAST GODAVARI,Thallarevu,P. MALLAVARAM,610,0,763,1373,430,0,442,872,707,10297,0,9242,19539,10546,1,0,0,1
4173,EAST GODAVARI,Thallarevu,PATAVALA,328,10,1441,1779,197,8,557,762,510,7184,196,12007,19387,9817,7,0,2,9
4174,EAST GODAVARI,Thallarevu,PILLANKA,180,22,169,371,102,4,87,193,170,3257,114,3655,7026,4852,0,0,3,3
4175,EAST GODAVARI,Thallarevu,POLEKURRU,534,5,652,1191,297,1,274,572,499,5883,5,3414,9302,5406,0,0,0,0
4176,EAST GODAVARI,Thallarevu,SUNKARAPALEM,233,3,297,533,145,0,67,212,171,3061,0,1357,4418,2907,0,0,0,0
4177,EAST GODAVARI,Thallarevu,TALLAREVU,422,9,1194,1625,204,5,470,679,629,4481,93,8036,12610,10130,1,0,1,2
4178,EAST GODAVARI,Thallarevu,UPPANGALA,143,21,403,567,101,5,235,341,273,2827,44,9439,12310,6942,0,0,25,25
4179,EAST GODAVARI,Thondangi,A.KOTHAPALLE,318,7,979,1304,61,2,120,183,60,1152,44,3092,4288,553,1,0,2,3
4180,EAST GODAVARI,Thondangi,A.V.NAGARAM,308,5,748,1061,189,0,382,571,484,4236,0,4032,8268,4745,0,0,0,0
4181,EAST GODAVARI,Thondangi,BENDAPUDI,659,0,1353,2012,115,0,327,442,378,5059,0,16270,21329,13483,12,0,42,54
4182,EAST GODAVARI,Thondangi,DANAVAIPETA,308,0,1070,1378,168,0,303,471,444,4131,0,7353,11484,9066,0,0,1,1
4183,EAST GODAVARI,Thondangi,GOLLAMUSALAYYAPETA,1,0,1228,1229,0,0,179,179,175,0,0,3788,3788,3044,0,0,1,1
4184,EAST GODAVARI,Thondangi,GOPALAPATNAM,188,0,200,388,33,0,36,69,32,403,0,726,1129,185,0,0,1,1
4185,EAST GODAVARI,Thondangi,KODADA,574,7,1240,1821,442,7,472,921,884,16868,214,7844,24926,13938,23,0,1,24
4186,EAST GODAVARI,Thondangi,KOMMANAPALLE,164,4,249,417,123,2,56,181,123,6987,47,1978,9012,5007,22,0,2,24
4187,EAST GODAVARI,Thondangi,KOTHAPERUMALAPURAM,34,0,3027,3061,1,0,282,283,249,20,0,3772,3792,2565,0,0,0,0
4188,EAST GODAVARI,Thondangi,KRISHANPURAM,220,0,450,670,108,0,94,202,95,5877,0,2466,8343,3509,16,0,8,24
4189,EAST GODAVARI,Thondangi,P.AGRAHARAM,122,0,234,356,53,0,154,207,88,571,0,4970,5541,1980,0,0,3,3
4190,EAST GODAVARI,Thondangi,P.E.CHINNAYAPALEM,430,0,684,1114,128,0,247,375,364,4554,0,11542,16096,9045,8,0,29,37
4191,EAST GODAVARI,Thondangi,PYDIKONDA,188,2,869,1059,36,0,335,371,149,1218,0,13116,14334,5306,2,0,29,31
4192,EAST GODAVARI,Thondangi,RAVIKAMPADU,260,2,604,866,169,0,218,387,179,5843,0,6438,12281,4884,4,0,9,13
4193,EAST GODAVARI,Thondangi,SE@THARAMPURAM,22,0,576,598,16,0,279,295,247,1115,0,13024,14139,8693,4,0,21,25
4194,EAST GODAVARI,Thondangi,SRUNGAVRUKSHAM,348,6,1247,1601,213,2,449,664,546,10537,104,15231,25872,12832,23,0,19,42
4195,EAST GODAVARI,Thondangi,THONDANGI,532,10,1181,1723,165,1,133,299,221,2624,11,3771,6406,2739,0,0,2,2
4196,EAST GODAVARI,Thondangi,VEMAVARAM,5,0,854,859,0,0,270,270,271,0,0,8639,8639,5579,0,0,4,4
4197,EAST GODAVARI,Thondangi,YERRAYYAPETA,41,0,589,630,7,0,103,110,106,13,0,1985,1998,1607,0,0,0,0
4198,EAST GODAVARI,Tuni,ATIKIVANIPALEM,68,1,152,221,47,0,60,107,86,2214,0,3189,5403,3029,1,0,2,3
4199,EAST GODAVARI,Tuni,CHAMAVARAM,233,0,289,522,126,0,51,177,115,8745,0,1586,10331,6605,39,0,7,46
4200,EAST GODAVARI,Tuni,CHEPURU,60,1,487,548,23,0,185,208,192,906,0,9437,10343,8500,2,0,8,10
4201,EAST GODAVARI,Tuni,D.POLAVARAM,248,0,1291,1539,100,0,302,402,328,3614,0,7380,10994,7175,6,0,3,9
4202,EAST GODAVARI,Tuni,DONDAVAKA,42,0,855,897,19,0,233,252,237,581,0,7076,7657,4580,0,0,13,13
4203,EAST GODAVARI,Tuni,HAMSAVARAM,642,1,1016,1659,269,1,435,705,568,12962,36,14795,27793,16217,37,0,5,42
4204,EAST GODAVARI,Tuni,K.O.MALLAVARAM,32,1,1043,1076,13,1,514,528,426,336,17,9496,9849,5615,0,0,0,0
4205,EAST GODAVARI,Tuni,KOLIMERU,239,35,606,880,124,21,273,418,299,4816,717,10721,16254,8958,8,0,18,26
4206,EAST GODAVARI,Tuni,KOTHURU,453,13,2795,3261,79,0,735,814,657,2566,0,34420,36986,26201,3,0,38,41
4207,EAST GODAVARI,Tuni,KUMMARILOVA,57,0,386,443,27,0,231,258,244,1110,0,9790,10900,7627,1,0,5,6
4208,EAST GODAVARI,Tuni,N.SURAVARAM,248,52,423,723,167,22,168,357,172,8896,569,6158,15623,6057,17,1,4,22
4209,EAST GODAVARI,Tuni,RAPAKA,97,7,432,536,5,2,205,212,192,43,37,6333,6413,4028,0,0,10,10
4210,EAST GODAVARI,Tuni,REKHAVANIPALEM,142,47,423,612,29,22,102,153,101,462,412,3089,3963,2087,0,0,2,2
4211,EAST GODAVARI,Tuni,S.ANNAVARAM,253,0,1068,1321,1,0,0,1,0,14,0,0,14,0,0,0,0,0
4212,EAST GODAVARI,Tuni,TALLURU,135,0,739,874,1,0,306,307,274,8,0,11240,11248,9409,0,0,9,9
4213,EAST GODAVARI,Tuni,TETAGUNTA,390,78,1626,2094,111,32,344,487,334,1871,208,18098,20177,11175,2,0,59,61
4214,EAST GODAVARI,Tuni,TIMMAPURAM,277,1,971,1249,105,0,206,311,100,1510,0,2003,3513,786,0,0,0,0
4215,EAST GODAVARI,Tuni,VALLURU,146,1,700,847,33,0,304,337,224,931,0,13045,13976,9924,0,0,5,5
4216,EAST GODAVARI,Tuni,VENKATANAGARAM,80,43,459,582,14,13,252,279,249,146,505,9017,9668,5203,0,1,14,15
4217,EAST GODAVARI,U.Kothapalli,AMARAVALLI,6,0,367,373,2,0,222,224,213,190,0,18215,18405,15459,0,0,91,91
4218,EAST GODAVARI,U.Kothapalli,AMEENABADA,139,1,775,915,79,0,274,353,336,5304,0,6801,12105,10165,23,0,0,23
4219,EAST GODAVARI,U.Kothapalli,GORSA,87,3,628,718,53,2,267,322,241,2583,51,6277,8911,4550,6,0,6,12
4220,EAST GODAVARI,U.Kothapalli,ISUKAPALLI,281,1,818,1100,164,0,336,500,327,3046,0,5561,8607,4543,0,0,0,0
4221,EAST GODAVARI,U.Kothapalli,KOMARAGIRI,456,18,1428,1902,246,1,721,968,763,8023,47,25229,33299,17053,2,0,14,16
4222,EAST GODAVARI,U.Kothapalli,KONDEVARAM,360,5,965,1330,241,3,460,704,644,10239,96,15196,25531,16035,9,0,7,16
4223,EAST GODAVARI,U.Kothapalli,Kotha Mulapeta,0,0,0,0,0,0,0,0,0,0,0,0,0,0,0,0,0,0
4224,EAST GODAVARI,U.Kothapalli,KOTHAPALLE,284,3,261,548,163,0,37,200,164,8820,0,1737,10557,6913,7,0,1,8
4225,EAST GODAVARI,U.Kothapalli,KUTUKUDUMILLI,6,1,421,428,0,0,285,285,245,0,0,10526,10526,6286,0,0,7,7
4226,EAST GODAVARI,U.Kothapalli,MULAPETA,127,3,1190,1320,82,1,783,866,890,2807,11,8810,11628,7871,0,0,2,2
4227,EAST GODAVARI,U.Kothapalli,NAGULAPALLE,208,5,1399,1612,65,0,499,564,21,2615,0,13654,16269,349,1,0,0,1
4228,EAST GODAVARI,U.Kothapalli,PONNADA,1002,0,2616,3618,529,0,1047,1576,1335,13558,0,25874,39432,28950,3,0,20,23
4229,EAST GODAVARI,U.Kothapalli,RAMANAKKAPETA,215,5,1010,1230,111,0,400,511,142,7502,0,12679,20181,6441,29,0,7,36
4230,EAST GODAVARI,U.Kothapalli,SREERAMPURAM,345,1,1497,1843,210,0,602,812,590,4277,0,37841,42118,21623,9,0,122,131
4231,EAST GODAVARI,U.Kothapalli,UPPADA,102,1,1253,1356,44,0,111,155,133,1675,0,2054,3729,1160,3,0,2,5
4232,EAST GODAVARI,U.Kothapalli,VAKATIPPA,272,2,107,381,195,1,50,246,208,10013,31,1723,11767,6825,14,0,8,22
4233,EAST GODAVARI,U.Kothapalli,YENDAPALLE,571,1,566,1138,366,0,134,500,343,18090,0,5209,23299,12019,26,0,2,28
4234,EAST GODAVARI,Uppalaguptam,BHEEMANAPALLI,443,6,658,1107,270,4,181,455,404,8202,79,3799,12080,8385,3,0,0,3
4235,EAST GODAVARI,Uppalaguptam,CHINAGEDAVILLI,158,0,301,459,126,0,186,312,191,10111,0,10211,20322,9138,54,0,37,91
4236,EAST GODAVARI,Uppalaguptam,GOLLAVALLI,351,3,522,876,211,0,150,361,304,7716,0,4068,11784,7865,4,0,0,4
4237,EAST GODAVARI,Uppalaguptam,GOPAVARAM,394,7,212,613,275,6,43,324,286,7819,169,1063,9051,5800,1,0,0,1
4238,EAST GODAVARI,Uppalaguptam,KITHANACHERUVU,289,0,36,325,198,0,30,228,205,13649,0,2372,16021,10478,57,0,11,68
4239,EAST GODAVARI,Uppalaguptam,KUNAVARAM,368,10,125,503,244,3,55,302,265,8903,108,1325,10336,6627,3,0,0,3
4240,EAST GODAVARI,Uppalaguptam,MUNIPALLE,133,0,184,317,91,0,54,145,101,5105,0,2317,7422,4221,2,0,2,4
4241,EAST GODAVARI,Uppalaguptam,NANGAVARAM,150,3,196,349,99,3,62,164,130,6988,192,3364,10544,6554,27,0,11,38
4242,EAST GODAVARI,Uppalaguptam,NIMMAKAYALAKOTHAPALLE,500,6,663,1169,251,5,337,593,562,11768,127,17096,28991,25116,12,0,15,27
4243,EAST GODAVARI,Uppalaguptam,PEDAGADAVALLI,150,1,146,297,103,0,37,140,103,6972,0,1404,8376,4434,20,0,4,24
4244,EAST GODAVARI,Uppalaguptam,SANNAVILLI,186,0,306,492,126,0,93,219,153,7298,0,3428,10726,6893,15,0,9,24
4245,EAST GODAVARI,Uppalaguptam,SARIPALLI,225,1,61,287,171,0,19,190,144,10318,0,719,11037,5060,16,0,0,16
4246,EAST GODAVARI,Uppalaguptam,SURASANIYANAM,286,1,325,612,194,1,139,334,305,9413,21,4805,14239,10447,11,0,2,13
4247,EAST GODAVARI,Uppalaguptam,T.CHALLAPALLE,1152,13,456,1621,763,10,227,1000,818,19034,216,6727,25977,13612,1,0,3,4
4248,EAST GODAVARI,Uppalaguptam,UPPALAGUPTAM,1080,14,362,1456,652,6,88,746,699,31603,301,2722,34626,24144,32,0,2,34
4249,EAST GODAVARI,Uppalaguptam,VANAPALLIPALEM,192,2,212,406,143,1,98,242,162,7975,31,3511,11517,5947,19,0,6,25
4250,EAST GODAVARI,Uppalaguptam,VILASAVILLI,250,1,388,639,136,1,76,213,169,4292,15,1653,5960,4016,1,0,0,1
4251,EAST GODAVARI,Vararamachandrapuram,Chinnamattapalli,3,600,276,879,0,196,131,327,243,0,1788,849,2637,1282,0,0,0,0
4252,EAST GODAVARI,Vararamachandrapuram,Jeediguppa,7,454,51,512,4,232,27,263,208,49,2581,277,2907,1460,0,0,0,0
4253,EAST GODAVARI,Vararamachandrapuram,Kunduluru,0,480,3,483,0,283,1,284,221,0,3417,12,3429,1743,0,0,0,0
4254,EAST GODAVARI,Vararamachandrapuram,Mulakanapalle,0,588,3,591,0,409,0,409,349,0,3516,0,3516,1712,0,0,0,0
4255,EAST GODAVARI,Vararamachandrapuram,Pedda Mattapalle,4,719,10,733,0,157,2,159,110,0,1904,23,1927,1085,0,0,0,0
4256,EAST GODAVARI,Vararamachandrapuram,Rajupeta,9,165,600,774,0,4,53,57,35,0,25,769,794,265,0,0,0,0
4257,EAST GODAVARI,Vararamachandrapuram,Ramavaram,13,703,78,794,0,69,0,69,52,0,558,0,558,294,0,0,0,0
4258,EAST GODAVARI,Vararamachandrapuram,Rekapalli,45,532,140,717,0,46,6,52,34,0,204,42,246,141,0,0,0,0
4259,EAST GODAVARI,Vararamachandrapuram,Sriramgiri,0,286,128,414,0,76,25,101,71,0,446,260,706,325,0,0,0,0
4260,EAST GODAVARI,Vararamachandrapuram,Thummileru,2,321,9,332,0,0,0,0,0,0,0,0,0,0,0,0,0,0
4261,EAST GODAVARI,Vararamachandrapuram,Waddegudem,105,174,1001,1280,1,0,23,24,10,20,0,143,163,66,0,0,0,0
4262,EAST GODAVARI,Y Ramavaram,BODDAGANDI,24,1368,28,1420,3,611,8,622,611,207,29157,394,29758,15844,0,60,1,61
4263,EAST GODAVARI,Y Ramavaram,CHAMAGADDA,5,539,12,556,0,371,6,377,409,0,28410,325,28735,14969,0,111,1,112
4264,EAST GODAVARI,Y Ramavaram,CHAVITIDIBBALU,2,305,17,324,1,212,10,223,221,8,12962,504,13474,8051,0,41,1,42
4265,EAST GODAVARI,Y Ramavaram,CHINTALAPUDI,0,424,0,424,0,314,0,314,353,0,15880,0,15880,7970,0,35,0,35
4266,EAST GODAVARI,Y Ramavaram,DALI PADU,2,625,1,628,0,338,1,339,320,0,23444,32,23476,12389,0,86,0,86
4267,EAST GODAVARI,Y Ramavaram,DARAGADDA,2,488,0,490,0,235,0,235,273,0,9938,0,9938,5199,0,14,0,14
4268,EAST GODAVARI,Y Ramavaram,DEVARAMADUGULA,0,256,15,271,0,196,7,203,209,0,12760,327,13087,7541,0,38,1,39
4269,EAST GODAVARI,Y Ramavaram,GURTHEDU,1,552,1,554,0,300,1,301,273,0,11836,18,11854,6291,0,8,0,8
4270,EAST GODAVARI,Y Ramavaram,K. YERRA GONDA,3,497,3,503,0,340,1,341,332,0,18221,35,18256,8803,0,50,0,50
4271,EAST GODAVARI,Y Ramavaram,KANIWADA,0,505,1,506,0,287,0,287,347,0,20632,0,20632,11784,0,72,0,72
4272,EAST GODAVARI,Y Ramavaram,KOTA,0,413,11,424,0,214,8,222,210,0,15153,636,15789,8338,0,51,3,54
4273,EAST GODAVARI,Y Ramavaram,P.YERRAGONDA,1,345,5,351,0,198,2,200,208,0,13301,80,13381,6759,0,49,0,49
4274,EAST GODAVARI,Y Ramavaram,PANASALA PALEM,3,365,9,377,0,228,2,230,255,0,17350,83,17433,9821,0,69,0,69
4275,EAST GODAVARI,Y Ramavaram,PATHAKOTA,4,981,1,986,0,411,1,412,404,0,15242,17,15259,6861,0,18,0,18
4276,EAST GODAVARI,Y Ramavaram,Y.RAMAVARAM,8,526,40,574,0,290,11,301,293,0,23624,813,24437,14351,0,113,3,116
4277,EAST GODAVARI,Y Ramavaram,YARLAGADDA,3,288,10,301,2,143,3,148,158,34,10180,65,10279,5205,0,40,0,40
4278,EAST GODAVARI,Y Ramavaram,YERRAMAREDDIPALEM,5,385,2,392,0,250,1,251,236,0,13173,6,13179,7050,0,28,0,28
4279,EAST GODAVARI,Yeleswaram,BHADRAVARAM,211,2,498,711,157,0,337,494,171,8868,0,14666,23534,5111,16,0,20,36
4280,EAST GODAVARI,Yeleswaram,C.RAYAVARAM,14,4,291,309,5,0,111,116,94,80,0,2229,2309,1422,0,0,0,0
4281,EAST GODAVARI,Yeleswaram,EAST LAKSHMIPURAM,178,69,330,577,151,49,243,443,254,12784,4020,15583,32387,13262,62,16,35,113
4282,EAST GODAVARI,Yeleswaram,JEDDANGI ANNAVARAM,198,83,457,738,114,66,225,405,299,5663,3055,9764,18482,11474,11,2,16,29
4283,EAST GODAVARI,Yeleswaram,LINGAMPARTHI,625,167,1076,1868,259,66,191,516,310,5398,427,3150,8975,4035,0,0,0,0
4284,EAST GODAVARI,Yeleswaram,MARRIVEEDU,209,265,513,987,108,175,221,504,450,4232,9292,13156,26680,14372,5,18,42,65
4285,EAST GODAVARI,Yeleswaram,PEDDANAPALLE,298,2,1095,1395,150,1,424,575,126,5516,35,8259,13810,3343,3,0,0,3
4286,EAST GODAVARI,Yeleswaram,PERAVARAM,516,7,549,1072,227,0,63,290,237,6138,0,1365,7503,3302,5,0,2,7
4287,EAST GODAVARI,Yeleswaram,RAMANAYYA PETA,177,152,135,464,100,106,40,246,232,5892,5810,1656,13358,7131,18,17,2,37
4288,EAST GODAVARI,Yeleswaram,SIRIPURAM,452,1,596,1049,245,1,258,504,236,9561,104,11578,21243,6950,12,1,25,38
4289,EAST GODAVARI,Yeleswaram,THIRUMALI,168,1,526,695,70,0,126,196,131,1865,0,3908,5773,3015,2,0,4,6
4290,EAST GODAVARI,Yeleswaram,YELESWARAM,1380,75,2152,3607,107,15,79,201,164,5458,1360,5545,12363,7990,28,7,29,64
4291,EAST GODAVARI,Yeleswaram,YERRAVARAM,227,2,937,1166,130,0,204,334,201,9333,0,9312,18645,8880,27,0,13,40
4292,GUNTUR,Achampeta,AMBADIPUDI,176,1,225,402,83,1,66,150,92,3290,9,2090,5389,2155,0,0,2,2
4293,GUNTUR,Achampeta,ATCHAMPET,357,231,1441,2029,28,47,233,308,304,465,1159,5160,6784,4160,0,0,2,2
4294,GUNTUR,Achampeta,CHALLAGARIGA,190,29,69,288,51,5,3,59,50,802,68,112,982,453,0,0,0,0
4295,GUNTUR,Achampeta,CHERUKUPALEM,55,63,237,355,0,0,28,28,39,0,0,778,778,453,0,0,0,0
4296,GUNTUR,Achampeta,CHIGURUPADU,135,44,685,864,2,2,99,103,86,6,21,1106,1133,659,0,0,0,0
4297,GUNTUR,Achampeta,CHINTAPALLI,162,0,274,436,20,0,46,66,36,54,0,170,224,85,0,0,0,0
4298,GUNTUR,Achampeta,GRANDHISIRI,184,19,270,473,0,0,0,0,0,0,0,0,0,0,0,0,0,0
4299,GUNTUR,Achampeta,KASTALA AGRAHARAM,177,12,268,457,53,0,27,80,23,1725,0,956,2681,548,2,0,0,2
4300,GUNTUR,Achampeta,KOGANTIVARIPALEM,64,35,181,280,25,1,54,80,62,753,20,960,1733,804,0,0,0,0
4301,GUNTUR,Achampeta,KONDURU,208,85,486,779,47,1,137,185,178,1151,13,3912,5076,2481,1,0,1,2
4302,GUNTUR,Achampeta,KONUR,331,10,195,536,94,0,74,168,89,1559,0,1688,3247,1177,0,0,1,1
4303,GUNTUR,Achampeta,KOTHAPALLI,127,6,379,512,33,0,118,151,88,1182,0,4309,5491,2233,3,0,4,7
4304,GUNTUR,Achampeta,MADIPADU AGRAHARAM,338,328,382,1048,33,0,1,34,37,554,0,3,557,302,0,0,0,0
4305,GUNTUR,Achampeta,MITTAPALEM,18,29,522,569,2,4,190,196,192,131,201,10227,10559,5483,0,0,15,15
4306,GUNTUR,Achampeta,NEELESWARAPALEM,1,163,132,296,1,30,2,33,22,37,552,49,638,293,0,0,0,0
4307,GUNTUR,Achampeta,ORVAKALLU,150,0,251,401,105,0,125,230,246,2550,0,2322,4872,2546,0,0,0,0
4308,GUNTUR,Achampeta,PEDAPALEM,306,204,334,844,12,5,15,32,23,238,88,280,606,260,0,0,0,0
4309,GUNTUR,Achampeta,PUTTAGUDEM,1,51,203,255,0,0,0,0,0,0,0,0,0,0,0,0,0,0
4310,GUNTUR,Achampeta,RUDRAVARAM,0,2,293,295,0,0,60,60,3,0,0,1568,1568,60,0,0,2,2
4311,GUNTUR,Achampeta,TADUVOY,192,166,94,452,65,17,1,83,87,1482,312,34,1828,925,0,0,0,0
4312,GUNTUR,Achampeta,TALLACHERUVU,373,106,391,870,52,0,11,63,20,938,0,108,1046,181,0,0,0,0
4313,GUNTUR,Achampeta,VELPURU,320,4,158,482,88,0,1,89,79,1224,0,66,1290,619,0,0,0,0
4314,GUNTUR,Amaravathi,AMARAVATHI,601,60,1831,2492,74,0,10,84,83,1656,0,298,1954,1654,0,0,0,0
4315,GUNTUR,Amaravathi,ATTALUR,518,130,793,1441,267,38,327,632,576,5574,421,4874,10869,5214,0,0,0,0
4316,GUNTUR,Amaravathi,DHARANIKOTA,313,99,738,1150,37,3,41,81,70,869,20,2107,2996,1762,0,0,3,3
4317,GUNTUR,Amaravathi,DIDUGU,346,89,356,791,90,6,71,167,154,4468,108,2131,6707,3448,10,0,0,10
4318,GUNTUR,Amaravathi,ENDROY,460,2,352,814,124,0,17,141,133,4722,0,340,5062,2853,6,0,0,6
4319,GUNTUR,Amaravathi,ENIKEPADU,90,0,58,148,42,0,19,61,51,2336,0,605,2941,1362,6,0,0,6
4320,GUNTUR,Amaravathi,JUPUDI,401,15,291,707,180,0,68,248,219,7718,0,2167,9885,4439,3,0,2,5
4321,GUNTUR,Amaravathi,KARLAPUDI,185,80,335,600,0,0,0,0,0,0,0,0,0,0,0,0,0,0
4322,GUNTUR,Amaravathi,LEMALLE,225,31,596,852,41,4,41,86,75,1079,80,765,1924,929,1,0,0,1
4323,GUNTUR,Amaravathi,LINGAPURAM,346,25,647,1018,71,12,23,106,87,2815,301,669,3785,1649,2,0,0,2
4324,GUNTUR,Amaravathi,MALLADI,240,16,627,883,43,0,18,61,44,1451,0,399,1850,600,1,0,0,1
4325,GUNTUR,Amaravathi,MANDEPUDI,316,43,448,807,72,15,55,142,111,2622,824,2709,6155,2923,4,1,3,8
4326,GUNTUR,Amaravathi,MUNUGODU,303,67,728,1098,68,18,151,237,208,1603,255,3717,5575,2776,0,0,0,0
4327,GUNTUR,Amaravathi,MUTHAYAPALEM,2,19,195,216,0,3,8,11,11,0,60,160,220,110,0,0,0,0
4328,GUNTUR,Amaravathi,NARUKULLAPADU,194,59,455,708,109,19,191,319,295,3897,297,8077,12271,6101,3,0,3,6
4329,GUNTUR,Amaravathi,NEMALIKALLU,253,11,426,690,96,6,53,155,106,3821,143,1550,5514,2324,4,0,2,6
4330,GUNTUR,Amaravathi,PEDDA MADDURU,146,46,246,438,63,20,108,191,120,2080,869,4066,7015,2652,2,1,4,7
4331,GUNTUR,Amaravathi,UNGUTURU,364,49,312,725,118,7,31,156,98,5216,140,680,6036,2433,10,0,0,10
4332,GUNTUR,Amaravathi,VYKUNTAPURAM,610,26,300,936,223,7,43,273,246,7651,413,2123,10187,5965,9,2,3,14
4333,GUNTUR,Amruthalur,AMRUTHALURU,669,119,371,1159,452,29,91,572,542,14960,844,2870,18674,9543,5,0,1,6
4334,GUNTUR,Amruthalur,BODAPADU,272,9,98,379,217,8,70,295,279,6704,129,1476,8309,3913,0,0,0,0
4335,GUNTUR,Amruthalur,GOVADA,337,40,271,648,268,15,112,395,350,10390,177,1976,12543,6181,6,0,0,6
4336,GUNTUR,Amruthalur,INTUR,893,73,408,1374,559,37,225,821,728,12118,353,3504,15975,8805,0,0,0,0
4337,GUNTUR,Amruthalur,KORU TADIPARRU,35,6,111,152,20,5,53,78,62,432,113,792,1337,621,0,0,0,0
4338,GUNTUR,Amruthalur,KUCHIPUDI,308,10,173,491,202,5,62,269,263,6335,202,1244,7781,3761,0,0,0,0
4339,GUNTUR,Amruthalur,MOPARRU,406,1,136,543,195,0,13,208,207,5960,0,358,6318,3068,0,0,0,0
4340,GUNTUR,Amruthalur,MULPUR,658,8,268,934,339,6,114,459,446,6882,199,2963,10044,4683,0,0,0,0
4341,GUNTUR,Amruthalur,PANCHALAVARAM,302,1,36,339,174,0,2,176,149,4241,0,35,4276,1910,0,0,0,0
4342,GUNTUR,Amruthalur,PEDDAPUDI,230,21,65,316,19,0,2,21,21,266,0,40,306,165,0,0,0,0
4343,GUNTUR,Amruthalur,PYAPARRU,293,3,172,468,118,2,86,206,169,1293,40,765,2098,939,0,0,0,0
4344,GUNTUR,Amruthalur,THURUMELLA,205,5,110,320,145,2,66,213,179,4322,55,1888,6265,2620,0,0,0,0
4345,GUNTUR,Amruthalur,VAMANAGUNTA PALEM,99,0,56,155,81,0,24,105,81,4127,0,1173,5300,2775,6,0,2,8
4346,GUNTUR,Amruthalur,YADAVURU,202,0,257,459,152,0,203,355,299,3924,0,4969,8893,4082,0,0,0,0
4347,GUNTUR,Amruthalur,YELAVARRU,320,5,93,418,247,1,56,304,270,8092,20,1244,9356,3977,0,0,0,0
4348,GUNTUR,Bapatla,APPIKATLA,85,0,247,332,37,0,135,172,149,1242,0,4317,5559,2900,0,0,0,0
4349,GUNTUR,Bapatla,ASODIVARIPALEM,1,0,837,838,0,0,510,510,481,0,0,9959,9959,4941,0,0,0,0
4350,GUNTUR,Bapatla,BETHAPUDI,88,1,773,862,54,0,514,568,298,1941,0,15539,17480,4854,1,0,3,4
4351,GUNTUR,Bapatla,BHARTHIPUDI,66,28,195,289,46,5,108,159,155,1982,145,5014,7141,4188,0,0,1,1
4352,GUNTUR,Bapatla,CHERUVU JAMMULAPALEM,539,58,670,1267,271,17,238,526,496,4303,580,5134,10017,5446,0,0,0,0
4353,GUNTUR,Bapatla,CHUNDURUPALLI,71,24,56,151,4,3,2,9,9,80,60,40,180,86,0,0,0,0
4354,GUNTUR,Bapatla,EAST BAPTLA,249,19,602,870,131,9,218,358,304,3462,224,4400,8086,4383,0,0,0,0
4355,GUNTUR,Bapatla,ETHERU,309,15,45,369,217,0,26,243,216,6777,0,813,7590,4227,0,0,0,0
4356,GUNTUR,Bapatla,GOPAPURAM,239,0,37,276,194,0,30,224,222,7283,0,1059,8342,5151,2,0,1,3
4357,GUNTUR,Bapatla,GUDIPUDI,115,23,240,378,91,16,137,244,203,4152,1000,3156,8308,4172,0,0,0,0
4358,GUNTUR,Bapatla,JILLELLAMUDI,6,0,203,209,2,0,133,135,124,69,0,7234,7303,3859,0,0,12,12
4359,GUNTUR,Bapatla,KANKATAPALEM,322,86,401,809,216,22,126,364,323,7834,698,3364,11896,6086,0,0,0,0
4360,GUNTUR,Bapatla,KONDUBOTLAVARIPALEM,265,0,440,705,139,0,170,309,264,6315,0,4063,10378,5726,0,0,0,0
4361,GUNTUR,Bapatla,MARRIPUDI,169,14,220,403,118,11,144,273,261,3387,333,3550,7270,3790,0,0,0,0
4362,GUNTUR,Bapatla,MARUPROLUVARIPALEM,98,2,557,657,47,0,323,370,263,493,0,3378,3871,2509,0,0,0,0
4363,GUNTUR,Bapatla,MULAPALEM,395,0,0,395,339,0,0,339,329,10883,0,0,10883,6040,0,0,0,0
4364,GUNTUR,Bapatla,MURUKONDAPADU,218,8,25,251,164,8,13,185,156,5179,225,384,5788,2703,0,0,0,0
4365,GUNTUR,Bapatla,MUTHAYAPALEM,236,103,756,1095,70,22,387,479,399,969,395,6462,7826,3995,0,0,0,0
4366,GUNTUR,Bapatla,NARASAYAPALEM,646,18,149,813,447,0,17,464,448,8252,0,340,8592,4827,0,0,0,0
4367,GUNTUR,Bapatla,PANDURANGAPURAM,6,2,803,811,1,1,155,157,152,58,18,3149,3225,1828,0,0,0,0
4368,GUNTUR,Bapatla,PINNIBOINAVARIPALEM,86,13,654,753,36,4,327,367,292,593,15,4331,4939,2642,0,0,0,0
4369,GUNTUR,Bapatla,POONDLA,291,48,290,629,225,35,204,464,428,4874,481,4151,9506,4979,0,0,0,0
4370,GUNTUR,Bapatla,STUVARTPURAM,39,402,8,449,17,145,3,165,155,819,4809,60,5688,3545,1,6,0,7
4371,GUNTUR,Bapatla,VEDULLAPALLI,19,137,625,781,17,68,340,425,383,328,1304,10384,12016,6888,0,0,0,0
4372,GUNTUR,Bapatla,WEST BAPATLA,7,58,333,398,2,16,170,188,158,40,460,3825,4325,2302,0,0,0,0
4373,GUNTUR,Bellamkonda,BELLAMKONDA,281,45,966,1292,116,22,466,604,575,4614,831,16109,21554,11739,2,0,17,19
4374,GUNTUR,Bellamkonda,BODANAM,210,335,244,789,103,67,76,246,212,2795,1872,1772,6439,3052,2,1,1,4
4375,GUNTUR,Bellamkonda,CHANDRAJUPALEM,285,36,1207,1528,107,10,469,586,533,3372,286,13241,16899,9224,2,0,10,12
4376,GUNTUR,Bellamkonda,CHITYALA,89,601,195,885,24,301,73,398,347,429,9948,2189,12566,5984,0,5,2,7
4377,GUNTUR,Bellamkonda,EMMAJIGUDEM,114,14,238,366,53,8,141,202,187,2321,316,6642,9279,4838,4,0,10,14
4378,GUNTUR,Bellamkonda,GANGIREDDIPALEM,4,0,433,437,0,0,183,183,175,0,0,4490,4490,2287,0,0,0,0
4379,GUNTUR,Bellamkonda,KANDIPADU,65,5,471,541,34,2,292,328,300,1052,15,5683,6750,3451,0,0,0,0
4380,GUNTUR,Bellamkonda,KOLLURU,196,170,554,920,45,9,53,107,93,497,68,592,1157,562,0,0,0,0
4381,GUNTUR,Bellamkonda,MACHAYAPALEM,152,54,473,679,49,8,123,180,167,2831,606,3318,6755,3067,11,2,3,16
4382,GUNTUR,Bellamkonda,MANNESULTANPALEM,153,224,168,545,55,50,44,149,147,966,1141,817,2924,1527,0,0,0,0
4383,GUNTUR,Bellamkonda,NAGIREDDIPALEM,81,140,561,782,55,18,224,297,281,2728,424,9438,12590,7421,6,0,6,12
4384,GUNTUR,Bellamkonda,NANDIRAJUPALEM,306,3,347,656,151,0,219,370,357,3984,0,6353,10337,5301,0,0,2,2
4385,GUNTUR,Bellamkonda,PAPAYAPALEM,218,20,878,1116,116,10,442,568,519,3220,180,10001,13401,6763,1,0,1,2
4386,GUNTUR,Bellamkonda,VANNAYAPALEM,111,7,637,755,53,0,301,354,320,1008,0,5182,6190,2916,0,0,0,0
4387,GUNTUR,Bellamkonda,VENKTAYAPALEM,60,277,295,632,7,126,100,233,236,112,2666,1313,4091,2559,0,1,0,1
4388,GUNTUR,Bhattiprolu,ALLAMUDI,152,10,134,296,83,1,26,110,89,1677,4,292,1973,880,0,0,0,0
4389,GUNTUR,Bhattiprolu,BHATTIPROLU,640,119,656,1415,264,6,137,407,351,10029,120,3762,13911,8882,3,0,1,4
4390,GUNTUR,Bhattiprolu,CHINTAMOTU,128,3,296,427,84,1,137,222,198,2519,32,4738,7289,4744,0,0,0,0
4391,GUNTUR,Bhattiprolu,GORIGAPUDI,259,6,396,661,20,0,37,57,51,400,0,728,1128,556,0,0,0,0
4392,GUNTUR,Bhattiprolu,ILAVARAM,320,28,424,772,97,2,26,125,72,2999,40,564,3603,1319,0,0,0,0
4393,GUNTUR,Bhattiprolu,KANNEGANTIVARIPALEM,10,0,101,111,0,0,13,13,2,0,0,100,100,9,0,0,0,0
4394,GUNTUR,Bhattiprolu,KONETIPURAM,63,1,355,419,37,1,135,173,157,405,6,1529,1940,1101,0,0,0,0
4395,GUNTUR,Bhattiprolu,OLERU,360,12,303,675,249,1,119,369,323,5063,20,2257,7340,3720,0,0,0,0
4396,GUNTUR,Bhattiprolu,PALLEKONA,474,12,276,762,53,1,11,65,63,1060,20,220,1300,704,0,0,0,0
4397,GUNTUR,Bhattiprolu,PEDDALANKA,263,2,183,448,59,0,2,61,29,655,0,40,695,267,0,0,0,0
4398,GUNTUR,Bhattiprolu,PEDDAPULIVARRU,1077,20,697,1794,425,2,159,586,509,6848,37,3097,9982,5678,0,0,0,0
4399,GUNTUR,Bhattiprolu,PESARLANKA,256,0,133,389,70,0,5,75,63,620,0,76,696,435,0,0,0,0
4400,GUNTUR,Bhattiprolu,RECHERU,195,6,129,330,136,1,58,195,168,2025,20,996,3041,1485,0,0,0,0
4401,GUNTUR,Bhattiprolu,SUREPALLE,195,24,493,712,113,1,121,235,216,4331,8,2748,7087,4014,1,0,0,1
4402,GUNTUR,Bhattiprolu,VELLATURU,398,207,416,1021,132,32,57,221,210,3506,520,1066,5092,3382,0,0,0,0
4403,GUNTUR,Bollapalle,AYYANNAPALEM,237,631,261,1129,83,59,107,249,273,1145,4767,3367,9279,4305,0,16,4,20
4404,GUNTUR,Bollapalle,BANDLAMOTTU,196,153,48,397,7,32,0,39,32,60,473,0,533,236,0,0,0,0
4405,GUNTUR,Bollapalle,BOLLAPALLI,158,42,562,762,104,26,375,505,446,3737,1114,9497,14348,8417,1,1,2,4
4406,GUNTUR,Bollapalle,DOMALAGUNDAM,67,151,161,379,40,52,23,115,108,1668,754,220,2642,1426,0,0,0,0
4407,GUNTUR,Bollapalle,GANDI GANUMALA,100,778,287,1165,39,258,57,354,345,494,4048,1376,5918,3153,0,0,0,0
4408,GUNTUR,Bollapalle,GARIKAPADU,149,941,430,1520,67,204,227,498,455,1158,3760,3727,8645,4550,0,0,0,0
4409,GUNTUR,Bollapalle,GUMMANAMPADU,334,323,553,1210,0,35,31,66,57,0,486,595,1081,483,0,0,0,0
4410,GUNTUR,Bollapalle,GUTLAPALLI,363,359,545,1267,60,0,134,194,215,2568,0,1283,3851,1901,5,0,1,6
4411,GUNTUR,Bollapalle,JAYANTHI RAMA PURAM,119,246,261,626,64,139,208,411,376,2682,5193,9335,17210,9091,4,1,11,16
4412,GUNTUR,Bollapalle,KANUMALA CHERUVU,93,604,266,963,62,53,138,253,268,606,748,2934,4288,2034,0,0,3,3
4413,GUNTUR,Bollapalle,MARRIPALEM,33,41,277,351,32,30,223,285,280,725,756,7045,8526,4482,0,1,9,10
4414,GUNTUR,Bollapalle,MELLAVAGU,123,22,763,908,59,5,369,433,376,2453,148,13565,16166,8329,3,0,7,10
4415,GUNTUR,Bollapalle,MUGA CHINTALA PALEM,351,3,451,805,120,3,242,365,311,4038,98,12227,16363,8311,3,0,19,22
4416,GUNTUR,Bollapalle,NAIDU PALEM,66,32,472,570,28,20,201,249,219,1132,917,4928,6977,3141,0,2,3,5
4417,GUNTUR,Bollapalle,PALUKURU,61,309,528,898,21,168,278,467,491,430,2032,8083,10545,5827,1,0,7,8
4418,GUNTUR,Bollapalle,PAMIDIPADU,202,0,369,571,120,0,172,292,298,7369,0,7387,14756,7800,27,0,6,33
4419,GUNTUR,Bollapalle,PERURUPADU,204,36,731,971,94,1,368,463,351,2266,45,10737,13048,6152,2,0,14,16
4420,GUNTUR,Bollapalle,RAVULAPURAM,327,393,718,1438,51,218,184,453,425,1176,5044,2874,9094,4404,0,1,0,1
4421,GUNTUR,Bollapalle,REDDIPALEM,140,416,135,691,41,56,19,116,126,2730,4551,600,7881,5503,10,20,1,31
4422,GUNTUR,Bollapalle,REMIDICHERLA,200,522,553,1275,41,39,206,286,285,1386,3951,12341,17678,8940,1,17,47,65
4423,GUNTUR,Bollapalle,SARIKONDA PALEM,186,102,197,485,114,73,146,333,300,2126,1227,3942,7295,3997,0,0,0,0
4424,GUNTUR,Bollapalle,VADDEMGUNTA,39,2,513,554,27,1,295,323,324,530,20,10252,10802,5813,0,0,4,4
4425,GUNTUR,Bollapalle,VELLATURU,248,334,1170,1752,38,91,458,587,496,478,3700,12154,16332,8888,0,2,4,6
4426,GUNTUR,Chebrole,CHEBROLE,1285,91,1334,2710,539,21,291,851,830,15689,313,7392,23394,15689,2,0,0,2
4427,GUNTUR,Chebrole,GODAVARRU,108,23,286,417,29,0,55,84,77,580,0,1767,2347,1353,0,0,0,0
4428,GUNTUR,Chebrole,GUNDAVARAM,3,8,444,455,0,3,207,210,202,0,137,4767,4904,3670,0,0,1,1
4429,GUNTUR,Chebrole,MANCHALA,0,76,518,594,0,12,227,239,211,0,222,7017,7239,4484,0,0,2,2
4430,GUNTUR,Chebrole,NARAKODUR,485,8,354,847,206,0,44,250,230,7209,0,860,8069,5671,6,0,0,6
4431,GUNTUR,Chebrole,SEKUR,447,39,555,1041,248,14,268,530,511,7119,574,8945,16638,11980,0,1,5,6
4432,GUNTUR,Chebrole,SELAPADU,224,8,596,828,102,2,279,383,348,2665,71,11732,14468,7838,0,0,19,19
4433,GUNTUR,Chebrole,SREERANGAPURAM,87,20,227,334,58,14,113,185,173,2761,506,5452,8719,5384,4,0,0,4
4434,GUNTUR,Chebrole,SUDDAPALLI,300,2,760,1062,167,1,291,459,415,6649,42,8529,15220,10441,10,0,5,15
4435,GUNTUR,Chebrole,TOTLAPALEM,125,33,51,209,68,7,8,83,72,1771,140,160,2071,1013,0,0,0,0
4436,GUNTUR,Chebrole,VADLAMUDI,426,39,963,1428,116,2,275,393,367,3206,44,9454,12704,10034,0,0,4,4
4437,GUNTUR,Chebrole,VEERANAYAKUNIPALEM,86,1,235,322,43,1,134,178,169,1303,20,5576,6899,4941,3,0,3,6
4438,GUNTUR,Chebrole,VEJENDLA,365,10,1189,1564,73,0,299,372,333,1993,0,12690,14683,10940,0,0,23,23
4439,GUNTUR,Cherukupalle,ALLAVARIPALEM,37,3,387,427,13,0,43,56,47,121,0,445,566,324,0,0,0,0
4440,GUNTUR,Cherukupalle,AREPALLI,47,0,640,687,31,0,386,417,340,681,0,7304,7985,3863,0,0,0,0
4441,GUNTUR,Cherukupalle,ARUMBAKA,160,55,559,774,131,4,342,477,414,1399,64,7762,9225,4809,0,0,0,0
4442,GUNTUR,Cherukupalle,BALUSULAPALEM,109,0,653,762,79,0,407,486,445,3308,0,13669,16977,8820,3,0,10,13
4443,GUNTUR,Cherukupalle,CHERUKUPALLI,164,129,634,927,73,33,48,154,154,4407,894,1055,6356,4696,7,0,0,7
4444,GUNTUR,Cherukupalle,GUDAVALLI,318,44,348,710,137,11,130,278,254,2757,200,5370,8327,4132,0,0,9,9
4445,GUNTUR,Cherukupalle,GULLAPALLI,254,97,368,719,93,0,68,161,137,3375,0,2712,6087,3653,0,0,1,1
4446,GUNTUR,Cherukupalle,KANAGALA,50,43,1049,1142,0,0,47,47,44,0,0,645,645,354,0,0,0,0
4447,GUNTUR,Cherukupalle,KAVURU,378,73,228,679,274,18,72,364,354,7494,661,1677,9832,5021,0,0,0,0
4448,GUNTUR,Cherukupalle,KUNCHALAVARIPALEM,1,0,374,375,0,0,74,74,59,0,0,837,837,369,0,0,0,0
4449,GUNTUR,Cherukupalle,NADIMPALLI,80,0,486,566,47,0,282,329,264,1375,0,10377,11752,5621,0,0,12,12
4450,GUNTUR,Cherukupalle,PONNAPALLI,1,32,543,576,0,16,318,334,108,0,269,10242,10511,1238,0,0,6,6
4451,GUNTUR,Cherukupalle,RAJAVOLU,60,8,661,729,35,0,43,78,74,662,0,878,1540,847,0,0,0,0
4452,GUNTUR,Cherukupalle,RAMBHOTLAPALEM,33,15,617,665,15,2,168,185,178,406,12,5653,6071,3449,0,0,3,3
4453,GUNTUR,Cherukupalle,THUMMALAPALEM,1,0,747,748,1,0,488,489,350,20,0,13848,13868,5587,0,0,1,1
4454,GUNTUR,Cherukupalle,THURPUPALEM,183,15,411,609,112,5,114,231,193,7162,140,3219,10521,4971,15,0,0,15
4455,GUNTUR,Chilakaluripet,BOPPUDI,258,81,734,1073,175,11,264,450,438,6173,230,10102,16505,13834,4,0,6,10
4456,GUNTUR,Chilakaluripet,DANDAMUDI,113,28,93,234,37,1,17,55,53,495,4,247,746,582,0,0,0,0
4457,GUNTUR,Chilakaluripet,EDAVALLI,227,38,302,567,70,1,90,161,155,1511,8,3441,4960,3775,1,0,1,2
4458,GUNTUR,Chilakaluripet,GANGANNAPALEM,251,29,658,938,68,8,154,230,209,2080,424,6060,8564,5793,0,1,4,5
4459,GUNTUR,Chilakaluripet,GOPALAMVARIPALEM,315,18,152,485,124,17,31,172,147,4587,947,1008,6542,3659,6,3,1,10
4460,GUNTUR,Chilakaluripet,GOTTIPADU,231,84,322,637,153,7,47,207,185,7427,123,2283,9833,7278,8,0,3,11
4461,GUNTUR,Chilakaluripet,GOVINDAPURAM,333,31,199,563,206,6,40,252,243,6362,50,1745,8157,5397,2,0,0,2
4462,GUNTUR,Chilakaluripet,KAMMARIPALEM,76,0,225,301,0,0,24,24,10,0,0,602,602,199,0,0,0,0
4463,GUNTUR,Chilakaluripet,KATTUBADIVARIPALEM,2,12,642,656,0,3,143,146,120,0,11,1493,1504,793,0,0,1,1
4464,GUNTUR,Chilakaluripet,KAVURU,613,142,919,1674,184,21,200,405,357,3231,420,5192,8843,5925,0,0,0,0
4465,GUNTUR,Chilakaluripet,KUKKAPALLIVARIPAELM,10,0,122,132,0,0,1,1,0,0,0,20,20,0,0,0,0,0
4466,GUNTUR,Chilakaluripet,LINGAMGUNTLA,22,11,562,595,13,1,179,193,170,550,77,7357,7984,4986,0,0,7,7
4467,GUNTUR,Chilakaluripet,MADDIRALA,0,0,291,291,0,0,193,193,174,0,0,6828,6828,5228,0,0,3,3
4468,GUNTUR,Chilakaluripet,MANUKONDAVARIPALEM,7,21,367,395,3,0,121,124,118,28,0,2113,2141,1583,0,0,1,1
4469,GUNTUR,Chilakaluripet,MURIKIPUDI,430,211,806,1447,198,53,153,404,398,3232,1042,2802,7076,6249,0,0,0,0
4470,GUNTUR,Chilakaluripet,PASUMARRU,394,94,555,1043,188,28,123,339,331,6763,925,2717,10405,9038,6,0,1,7
4471,GUNTUR,Chilakaluripet,POTHAVARAM,2,24,428,454,1,1,152,154,143,43,8,4987,5038,3951,0,0,2,2
4472,GUNTUR,Chilakaluripet,RAJAPETA,45,19,226,290,28,4,30,62,63,1342,47,754,2143,1414,0,0,0,0
4473,GUNTUR,Chilakaluripet,RAMACHANDRAPURAM,89,2,94,185,37,0,12,49,49,682,0,240,922,555,0,0,0,0
4474,GUNTUR,Chilakaluripet,THATAPUDI,78,0,65,143,4,0,0,4,4,8,0,0,8,8,0,0,0,0
4475,GUNTUR,Chilakaluripet,VALLURU,608,41,214,863,389,20,35,444,458,8637,86,673,9396,7320,0,0,0,0
4476,GUNTUR,Dachepalle,BHATRUPALAM,11,432,11,454,2,328,1,331,317,74,11492,46,11612,5707,0,5,0,5
4477,GUNTUR,Dachepalle,DACHEPALLI,598,81,1849,2528,208,27,262,497,470,5724,888,5667,12279,8155,1,0,0,1
4478,GUNTUR,Dachepalle,GAMALAPADU,114,87,886,1087,73,16,500,589,555,1493,327,8393,10213,5272,0,0,1,1
4479,GUNTUR,Dachepalle,KATRAPADU,51,48,152,251,41,41,107,189,179,2813,3303,7908,14024,7150,11,13,32,56
4480,GUNTUR,Dachepalle,KESANAPALLI,318,40,336,694,147,4,116,267,254,4849,80,3486,8415,4853,3,0,4,7
4481,GUNTUR,Dachepalle,KOTHUR,26,172,129,327,9,142,109,260,235,454,8034,6032,14520,7594,0,15,11,26
4482,GUNTUR,Dachepalle,MADINAPADU,256,22,455,733,129,2,142,273,255,4472,15,2343,6830,4242,5,0,0,5
4483,GUNTUR,Dachepalle,MUTYALAMPADU,228,94,644,966,52,7,174,233,221,1260,140,4560,5960,3194,0,0,1,1
4484,GUNTUR,Dachepalle,NADIKUDI,644,173,2286,3103,85,20,635,740,696,1491,472,13379,15342,8483,0,0,0,0
4485,GUNTUR,Dachepalle,PEDAGARLAPADU,283,1,939,1223,177,0,518,695,722,3469,0,5635,9104,4809,1,0,0,1
4486,GUNTUR,Dachepalle,PONDUGALA,90,7,649,746,35,1,184,220,185,1957,47,5829,7833,4912,5,0,2,7
4487,GUNTUR,Dachepalle,RAMAPURAM,192,8,520,720,126,3,248,377,336,2854,141,3844,6839,3958,0,0,0,0
4488,GUNTUR,Dachepalle,SARANGAPALLI,152,0,265,417,110,0,151,261,232,2858,0,4271,7129,4167,0,0,0,0
4489,GUNTUR,Dachepalle,SRINAGAR,186,34,294,514,97,16,140,253,246,2606,477,3582,6665,3741,1,0,0,1
4490,GUNTUR,Dachepalle,TAKKELLAPADU,86,13,507,606,40,2,267,309,290,1097,40,5263,6400,3451,1,0,0,1
4491,GUNTUR,Dachepalle,TANGEDA,351,3,884,1238,156,1,114,271,252,4877,36,2169,7082,3522,10,0,0,10
4492,GUNTUR,Duggirala,CHILUVURU,813,64,685,1562,220,5,2,227,202,6853,62,24,6939,4580,2,0,0,2
4493,GUNTUR,Duggirala,CHINAPALEM,52,0,201,253,40,0,115,155,113,1932,0,5526,7458,3614,2,0,4,6
4494,GUNTUR,Duggirala,CHINTALAPUDI,14,9,336,359,8,8,248,264,196,270,276,12393,12939,3720,0,0,6,6
4495,GUNTUR,Duggirala,CHUKKAPALLIVARIPALEM,308,0,84,392,190,0,52,242,221,5487,0,1247,6734,3835,0,0,0,0
4496,GUNTUR,Duggirala,DUGGIRALA,399,83,495,977,106,8,109,223,219,3351,133,2392,5876,3662,3,0,1,4
4497,GUNTUR,Duggirala,EMANI,757,38,616,1411,415,0,49,464,386,12136,0,3362,15498,7500,0,0,7,7
4498,GUNTUR,Duggirala,GODAVARRU,185,1,292,478,106,0,214,320,287,2136,0,7831,9967,5928,0,0,6,6
4499,GUNTUR,Duggirala,K.R.KONDURU,326,7,387,720,109,0,56,165,131,2917,0,1178,4095,2334,0,0,0,0
4500,GUNTUR,Duggirala,MANCHIKALAPUDI,178,0,285,463,123,0,12,135,117,3136,0,296,3432,1830,0,0,0,0
4501,GUNTUR,Duggirala,MORAMPUDI,417,25,197,639,215,3,29,247,229,5713,47,919,6679,4117,1,0,0,1
4502,GUNTUR,Duggirala,PEDA KONDURU,401,3,383,787,216,0,66,282,245,5710,0,1333,7043,3689,1,0,0,1
4503,GUNTUR,Duggirala,PEDA PALEM,268,2,294,564,161,0,97,258,218,2917,0,512,3429,2028,0,0,0,0
4504,GUNTUR,Duggirala,PENUMULI,233,81,332,646,151,0,1,152,140,7007,0,53,7060,3691,0,0,0,0
4505,GUNTUR,Duggirala,PERAKALA PUDI,54,16,769,839,33,11,369,413,259,1002,332,9123,10457,4534,0,0,0,0
4506,GUNTUR,Duggirala,REVENDRAPADU,314,35,293,642,33,0,0,33,29,263,0,0,263,202,0,0,0,0
4507,GUNTUR,Duggirala,SRUNGARA PURAM,288,3,153,444,165,2,53,220,207,4064,29,647,4740,3420,0,0,0,0
4508,GUNTUR,Duggirala,THUMMOPUDI,184,23,119,326,87,1,15,103,87,706,20,158,884,513,0,0,0,0
4509,GUNTUR,Duggirala,VEERLA PALEM,163,13,133,309,32,7,16,55,39,678,67,436,1181,501,0,0,0,0
4510,GUNTUR,Durgi,ADIGOPPULA,396,164,1515,2075,48,38,411,497,473,758,1435,11490,13683,7577,0,2,11,13
4511,GUNTUR,Durgi,ATMAKURU,187,0,674,861,58,0,351,409,380,942,0,9544,10486,6113,0,0,3,3
4512,GUNTUR,Durgi,DHARMAVARAM,293,1,650,944,103,0,88,191,176,2807,0,1713,4520,2376,0,0,0,0
4513,GUNTUR,Durgi,DURGI,295,53,1341,1689,17,9,272,298,288,518,54,5179,5751,4656,1,0,2,3
4514,GUNTUR,Durgi,JANGAMAHESWARAPADU,60,4,306,370,32,1,16,49,43,1504,24,248,1776,799,2,0,0,2
4515,GUNTUR,Durgi,KAKIRALA,109,130,329,568,51,35,189,275,283,1883,3459,8883,14225,7996,5,17,6,28
4516,GUNTUR,Durgi,KANCHARAGUNTA,296,161,312,769,178,97,218,493,463,7942,5453,9700,23095,12699,5,17,1,23
4517,GUNTUR,Durgi,KOLAGUTLA,161,83,521,765,50,4,298,352,397,1260,158,11176,12594,7515,0,0,13,13
4518,GUNTUR,Durgi,MUTUKURU,597,524,982,2103,195,67,226,488,511,4159,3485,6208,13852,7802,2,10,3,15
4519,GUNTUR,Durgi,OBULESUNIPALLI,264,177,864,1305,38,27,332,397,398,663,579,7646,8888,5428,0,0,0,0
4520,GUNTUR,Durgi,POLEPALLI,249,15,931,1195,131,2,447,580,556,5369,92,17271,22732,15593,7,0,9,16
4521,GUNTUR,Durgi,RAJANAGAR,7,567,99,673,0,216,53,269,236,0,14291,2046,16337,9172,0,47,0,47
4522,GUNTUR,Durgi,SYAMARAJUPURAM,80,0,326,406,12,0,55,67,56,136,0,639,775,369,0,0,0,0
4523,GUNTUR,Durgi,TERALA,169,186,285,640,106,45,162,313,305,5278,9293,6957,21528,11287,15,39,25,79
4524,GUNTUR,Edlapadu,CHANGISKHANPET,30,181,386,597,2,4,91,97,14,25,25,2342,2392,387,0,0,1,1
4525,GUNTUR,Edlapadu,DINTENAPADU,186,22,249,457,79,2,100,181,166,2581,59,4748,7388,4383,2,0,9,11
4526,GUNTUR,Edlapadu,EDLAPADU,786,130,857,1773,430,26,216,672,635,10622,243,3167,14032,8620,1,0,0,1
4527,GUNTUR,Edlapadu,GUTTAVARIPALEM,4,5,96,105,0,1,49,50,48,0,127,2900,3027,1704,0,1,7,8
4528,GUNTUR,Edlapadu,JAGGAPURAM,220,100,239,559,112,9,17,138,117,6918,402,760,8080,4153,19,1,1,21
4529,GUNTUR,Edlapadu,JALADI,436,2,236,674,249,0,57,306,272,9668,0,1580,11248,7323,2,0,0,2
4530,GUNTUR,Edlapadu,KARUCHOLA,202,24,347,573,126,0,38,164,129,5434,0,490,5924,3633,4,0,0,4
4531,GUNTUR,Edlapadu,KONDAVEEDU,311,0,387,698,105,0,133,238,223,3610,0,4718,8328,4683,0,0,2,2
4532,GUNTUR,Edlapadu,KOTA,124,0,204,328,61,0,87,148,123,1435,0,5382,6817,3527,0,0,21,21
4533,GUNTUR,Edlapadu,KOTTAPALEM,9,0,255,264,2,0,55,57,41,183,0,3372,3555,1518,0,0,5,5
4534,GUNTUR,Edlapadu,LINGARAOPALEM,281,3,304,588,213,0,119,332,305,9311,0,1855,11166,5330,1,0,0,1
4535,GUNTUR,Edlapadu,MYDAVOLU,129,0,289,418,64,0,173,237,230,2412,0,7584,9996,6019,4,0,9,13
4536,GUNTUR,Edlapadu,SANDEPUDI,183,12,218,413,107,9,18,134,142,6831,170,1159,8160,4559,24,0,5,29
4537,GUNTUR,Edlapadu,SOLASA,307,150,618,1075,149,66,353,568,439,4657,2045,9830,16532,7477,1,0,0,1
4538,GUNTUR,Edlapadu,THIMMAPURAM,826,8,234,1068,391,3,70,464,493,11407,18,943,12368,7391,9,0,0,9
4539,GUNTUR,Edlapadu,THURLAPADU,212,5,309,526,116,1,81,198,171,4510,72,3193,7775,4672,6,0,1,7
4540,GUNTUR,Edlapadu,UNNAVA,536,74,457,1067,125,1,74,200,183,6343,67,1916,8326,5589,11,0,0,11
4541,GUNTUR,Edlapadu,VANKAYALAPADU,357,90,753,1200,111,0,214,325,301,6925,0,10114,17039,11586,20,0,10,30
4542,GUNTUR,Guntur,ADAVI TAKKELLAPADU,412,54,933,1399,0,0,0,0,0,0,0,0,0,0,0,0,0,0
4543,GUNTUR,Guntur,ANKIREDDYPALEM,204,42,107,353,0,0,0,0,0,0,0,0,0,0,0,0,0,0
4544,GUNTUR,Guntur,BUDAMPADU,192,60,351,603,0,0,0,0,0,0,0,0,0,0,0,0,0,0
4545,GUNTUR,Guntur,CHALLAVARI PALEM,67,20,442,529,8,2,19,29,23,88,40,234,362,196,0,0,0,0
4546,GUNTUR,Guntur,CHINAPALAKALURU,197,167,253,617,120,76,75,271,265,4385,2866,1884,9135,6792,2,3,0,5
4547,GUNTUR,Guntur,CHOWDAVARAM,407,15,467,889,0,0,0,0,0,0,0,0,0,0,0,0,0,0
4548,GUNTUR,Guntur,DASUPALEM,54,0,94,148,38,0,18,56,48,1383,0,132,1515,1057,0,0,0,0
4549,GUNTUR,Guntur,ETUKURU,319,21,433,773,0,0,0,0,0,0,0,0,0,0,0,0,0,0
4550,GUNTUR,Guntur,GORANTLA,432,34,215,681,0,0,0,0,0,0,0,0,0,0,0,0,0,0
4551,GUNTUR,Guntur,GORLA VARI PALEM,157,12,149,318,88,7,73,168,161,2050,202,2064,4316,3265,0,0,0,0
4552,GUNTUR,Guntur,JONNALAGADDA,306,82,772,1160,160,26,168,354,314,4493,733,4094,9320,6576,3,0,0,3
4553,GUNTUR,Guntur,LAL PURAM,163,25,610,798,91,0,92,183,178,3811,0,3014,6825,5071,3,0,2,5
4554,GUNTUR,Guntur,MALLAVARAM,23,15,321,359,0,1,43,44,43,0,30,1979,2009,1308,0,0,1,1
4555,GUNTUR,Guntur,NALLAPADU,256,4,304,564,0,0,0,0,0,0,0,0,0,0,0,0,0,0
4556,GUNTUR,Guntur,OBUL NAIDU PALEM,123,20,343,486,0,0,0,0,0,0,0,0,0,0,0,0,0,0
4557,GUNTUR,Guntur,PEDAPALAKALURU,214,62,248,524,0,0,0,0,0,0,0,0,0,0,0,0,0,0
4558,GUNTUR,Guntur,POTTURU,138,19,608,765,0,0,0,0,0,0,0,0,0,0,0,0,0,0
4559,GUNTUR,Guntur,REDDIPALEM,102,55,557,714,0,0,0,0,0,0,0,0,0,0,0,0,0,0
4560,GUNTUR,Guntur,THOKA VARI PALEM,192,0,90,282,0,0,0,0,0,0,0,0,0,0,0,0,0,0
4561,GUNTUR,Guntur,THURAKA PALEM,262,0,142,404,0,0,0,0,0,0,0,0,0,0,0,0,0,0
4562,GUNTUR,Guntur,VENGALAYA PALEM,400,52,213,665,192,14,9,215,224,3740,257,147,4144,3538,0,0,0,0
4563,GUNTUR,Gurazala,AMBAPURAM,235,6,506,747,55,1,159,215,181,747,5,2072,2824,1398,0,0,0,0
4564,GUNTUR,Gurazala,BUDAWADA,91,7,96,194,33,6,61,100,94,414,200,1205,1819,912,0,0,0,0
4565,GUNTUR,Gurazala,CHERLAGUDIPADU,348,44,1128,1520,39,2,207,248,229,763,2,3639,4404,2650,0,0,0,0
4566,GUNTUR,Gurazala,DAIDA,378,169,698,1245,217,77,203,497,493,6020,1731,4229,11980,6401,0,0,0,0
4567,GUNTUR,Gurazala,GANGAVARAM,150,16,490,656,17,1,169,187,181,361,21,3068,3450,1901,0,0,0,0
4568,GUNTUR,Gurazala,GOGULAPADU,146,14,477,637,84,2,335,421,420,2072,26,7249,9347,5221,1,0,0,1
4569,GUNTUR,Gurazala,GOTTIMUKKALA,306,138,632,1076,62,12,206,280,259,900,236,3161,4297,2218,0,0,1,1
4570,GUNTUR,Gurazala,GURAZALA,1149,134,2634,3917,138,5,516,659,592,2355,70,6435,8860,5472,0,0,0,0
4571,GUNTUR,Gurazala,JANGAMESWARA PURAM,126,125,1274,1525,48,30,321,399,383,1229,403,7704,9336,5233,0,0,0,0
4572,GUNTUR,Gurazala,KOTHA AMBAPURAM,41,71,228,340,13,45,127,185,161,246,760,5261,6267,3060,0,0,2,2
4573,GUNTUR,Gurazala,MADUGULA,527,89,1304,1920,161,9,365,535,483,1927,108,8854,10889,5813,0,0,3,3
4574,GUNTUR,Gurazala,PALLEGUNTA,143,0,395,538,68,0,40,108,108,1301,0,734,2035,1130,0,0,0,0
4575,GUNTUR,Gurazala,PULIPADU,419,15,1033,1467,122,3,116,241,170,618,46,1796,2460,1126,0,0,0,0
4576,GUNTUR,Gurazala,TELUKUTLA,73,88,940,1101,28,35,462,525,509,652,403,16631,17686,9503,0,0,12,12
4577,GUNTUR,Ipuru,AGNIGUNDALA,205,52,465,722,75,40,224,339,321,1141,1295,5614,8050,4935,0,0,1,1
4578,GUNTUR,Ipuru,ANGALURU,223,64,499,786,138,12,197,347,297,3831,721,5785,10337,5557,5,2,0,7
4579,GUNTUR,Ipuru,BHADRUPALEM,93,3,194,290,73,1,152,226,221,3836,66,7530,11432,6637,11,0,12,23
4580,GUNTUR,Ipuru,BODEPUDI VARI PALEM,125,9,226,360,72,4,166,242,233,2257,170,7709,10136,6209,1,0,9,10
4581,GUNTUR,Ipuru,BOGGARAM,121,26,466,613,75,14,272,361,353,3551,307,6644,10502,5918,8,0,7,15
4582,GUNTUR,Ipuru,BOMMARAJUPALLI,9,86,322,417,3,62,224,289,294,326,4814,10114,15254,8141,2,16,18,36
4583,GUNTUR,Ipuru,CHITTAPURAM,3,11,442,456,1,2,74,77,63,6,32,1143,1181,572,0,0,0,0
4584,GUNTUR,Ipuru,GOPUVARIPALEM,101,0,246,347,87,0,133,220,205,4785,0,6678,11463,5824,6,0,15,21
4585,GUNTUR,Ipuru,INUMELLA,291,13,775,1079,141,2,405,548,510,3087,17,8887,11991,6496,0,0,0,0
4586,GUNTUR,Ipuru,IPURU,197,130,875,1202,84,5,460,549,510,1779,184,11401,13364,7739,0,0,2,2
4587,GUNTUR,Ipuru,KONDAYAPALEM,120,3,224,347,41,0,100,141,134,1222,0,3910,5132,2508,2,0,5,7
4588,GUNTUR,Ipuru,KONDRAMUTLA,228,147,597,972,67,42,333,442,430,1283,1349,14612,17244,11647,0,0,20,20
4589,GUNTUR,Ipuru,KOTCHERLA,254,111,963,1328,167,89,568,824,855,5005,4136,22665,31806,20757,0,1,13,14
4590,GUNTUR,Ipuru,MUPPALLA,298,78,1062,1438,30,9,385,424,377,719,107,8765,9591,5438,0,0,3,3
4591,GUNTUR,Ipuru,UDIZERLA,301,147,350,798,144,103,201,448,455,3882,2214,5406,11502,6626,3,0,8,11
4592,GUNTUR,Ipuru,UPPARAPALEM,73,6,306,385,43,2,214,259,268,1205,150,10865,12220,7237,1,0,22,23
4593,GUNTUR,Ipuru,VANIKUNTA,178,0,434,612,97,0,196,293,288,2949,0,8018,10967,6435,0,0,14,14
4594,GUNTUR,Kakumanu,APPAPURAM,245,17,235,497,152,11,130,293,273,4595,445,5345,10385,6787,0,0,1,1
4595,GUNTUR,Kakumanu,BHALLUKANUDU PALEM,285,42,143,470,192,12,60,264,260,8162,417,2481,11060,5638,1,0,0,1
4596,GUNTUR,Kakumanu,BODIPALEM,321,5,156,482,224,1,77,302,262,8312,82,4248,12642,6170,6,0,5,11
4597,GUNTUR,Kakumanu,CHINALINGAYAPALEM,319,5,221,545,208,2,86,296,281,10177,60,2745,12982,6822,10,0,1,11
4598,GUNTUR,Kakumanu,GARIKAPADU,232,86,177,495,168,51,102,321,286,8269,2288,5011,15568,8342,4,0,2,6
4599,GUNTUR,Kakumanu,GARLAPADU,5,3,376,384,4,0,176,180,157,251,0,7109,7360,3700,0,0,2,2
4600,GUNTUR,Kakumanu,KAKUMANU,454,286,980,1720,258,49,333,640,608,9498,1211,11561,22270,11554,3,0,2,5
4601,GUNTUR,Kakumanu,KOLLIMARLA,92,28,141,261,72,21,120,213,215,4658,685,6195,11538,5801,11,0,3,14
4602,GUNTUR,Kakumanu,KOMMURU,317,29,746,1092,238,20,500,758,673,5537,409,12941,18887,10313,0,0,0,0
4603,GUNTUR,Kakumanu,KONDABALAVARIPALEM,138,23,165,326,109,16,54,179,154,7405,586,1844,9835,5435,13,0,0,13
4604,GUNTUR,Kakumanu,KONDAPATURU,242,54,418,714,179,33,301,513,495,6919,828,7705,15452,8096,0,0,0,0
4605,GUNTUR,Kakumanu,KOTHIVANIPALEM,4,58,130,192,3,33,102,138,103,168,1102,6253,7523,3659,0,1,9,10
4606,GUNTUR,Kakumanu,LINGAMGUNTAPALEM,114,4,300,418,64,0,0,64,62,1957,0,0,1957,918,0,0,0,0
4607,GUNTUR,Kakumanu,PANDRAPADU,88,13,303,404,44,0,168,212,209,1098,0,3157,4255,2215,0,0,0,0
4608,GUNTUR,Kakumanu,PEDDIVARIPALEM,197,0,147,344,168,0,91,259,246,9568,0,3526,13094,7002,17,0,0,17
4609,GUNTUR,Kakumanu,RETUR,223,35,377,635,163,5,115,283,259,5522,130,3379,9031,5228,0,0,1,1
4610,GUNTUR,Kakumanu,TELAGAYAPALEM,221,54,304,579,164,3,157,324,322,9256,112,5254,14622,8433,14,0,4,18
4611,GUNTUR,Kakumanu,VALLUR,3,13,419,435,0,1,214,215,199,0,10,7467,7477,3874,0,0,0,0
4612,GUNTUR,Karempudi,BHATTUVARIPALLI,28,2,320,350,12,0,140,152,139,555,0,4385,4940,2511,1,0,0,1
4613,GUNTUR,Karempudi,CHINAGARLAPADU,104,0,602,706,24,0,191,215,195,438,0,6376,6814,2989,0,0,1,1
4614,GUNTUR,Karempudi,CHINAKODAMAGUNDLA,81,1,369,451,39,0,75,114,111,2580,0,1346,3926,2083,8,0,0,8
4615,GUNTUR,Karempudi,CHINTAPALLI,334,10,573,917,60,2,185,247,249,1024,30,3560,4614,2566,0,0,0,0
4616,GUNTUR,Karempudi,GADEVARIPALLE,96,1,560,657,55,0,279,334,319,1670,0,5255,6925,3654,0,0,0,0
4617,GUNTUR,Karempudi,INAPARAJUPALLI,36,2,253,291,3,0,38,41,41,52,0,579,631,437,0,0,0,0
4618,GUNTUR,Karempudi,KACHAVARAM,61,0,166,227,44,0,45,89,80,3505,0,1619,5124,2798,17,0,7,24
4619,GUNTUR,Karempudi,KAREMPUDI,162,232,1057,1451,24,31,429,484,454,253,660,13049,13962,8539,0,0,10,10
4620,GUNTUR,Karempudi,LAKSHMIPURAM,11,8,252,271,10,7,190,207,216,273,134,4801,5208,2608,0,0,0,0
4621,GUNTUR,Karempudi,MIRIYALA,182,8,808,998,61,2,367,430,386,1353,10,9631,10994,5870,0,0,2,2
4622,GUNTUR,Karempudi,NARMALAPADU,96,226,313,635,24,21,36,81,71,462,180,547,1189,602,0,0,0,0
4623,GUNTUR,Karempudi,PEDAKODAMAGUNDLA,296,86,698,1080,98,46,144,288,306,1675,1989,3494,7158,3578,1,1,4,6
4624,GUNTUR,Karempudi,PETASANNIGANDLA,274,103,652,1029,2,18,173,193,179,34,332,3136,3502,1973,0,0,1,1
4625,GUNTUR,Karempudi,VEPAKAMPALLI,53,23,244,320,47,19,159,225,247,1898,559,5330,7787,4488,0,0,0,0
4626,GUNTUR,Karempudi,VOPPICHERLA,411,171,1417,1999,48,55,272,375,337,457,1698,5042,7197,3944,0,0,1,1
4627,GUNTUR,Karlapalem,BOLAYAPALEM,0,0,207,207,0,0,170,170,163,0,0,5394,5394,2833,0,0,0,0
4628,GUNTUR,Karlapalem,BUDDAM,20,25,312,357,13,3,263,279,271,190,44,4259,4493,2451,0,0,0,0
4629,GUNTUR,Karlapalem,CHINTAYAPALEM,136,58,395,589,105,33,286,424,402,2765,1955,3776,8496,4463,0,6,0,6
4630,GUNTUR,Karlapalem,DAMMANAVARIPALEM,0,6,370,376,0,2,244,246,225,0,46,6049,6095,3181,0,0,0,0
4631,GUNTUR,Karlapalem,DUNDIVARIPALEM,131,1,382,514,77,0,168,245,235,1973,0,5416,7389,4141,0,0,0,0
4632,GUNTUR,Karlapalem,GANAPAVARAM,189,222,361,772,129,59,197,385,374,3408,1436,4471,9315,5298,0,0,0,0
4633,GUNTUR,Karlapalem,KARLAPALEM,247,69,1258,1574,64,24,448,536,468,603,898,7558,9059,4901,0,0,0,0
4634,GUNTUR,Karlapalem,KOTHANANDAYAPALEM,2,34,416,452,1,13,275,289,283,24,358,5311,5693,3202,0,0,0,0
4635,GUNTUR,Karlapalem,NAGARAJUPALEM,0,0,156,156,0,0,117,117,109,0,0,2141,2141,1236,0,0,0,0
4636,GUNTUR,Karlapalem,NALLAMOTHUVARIPALEM,86,67,356,509,51,28,136,215,208,1388,771,2562,4721,2612,0,0,0,0
4637,GUNTUR,Karlapalem,NARRAVARIPALEM,189,38,176,403,124,24,132,280,262,1647,1433,1926,5006,2808,0,3,0,3
4638,GUNTUR,Karlapalem,PATHANANDAYAPALEM,1,16,348,365,0,4,193,197,173,0,80,1853,1933,1061,0,0,0,0
4639,GUNTUR,Karlapalem,PEDAGOLLAPALEM,293,70,798,1161,195,27,590,812,745,3359,522,5563,9444,4874,0,0,0,0
4640,GUNTUR,Karlapalem,PEDAPULUGUVARIPALEM,5,10,629,644,1,0,287,288,261,12,0,3977,3989,2033,0,0,1,1
4641,GUNTUR,Karlapalem,PERALI,790,4,509,1303,480,2,359,841,771,5885,10,5461,11356,6510,0,0,0,0
4642,GUNTUR,Karlapalem,PERALIPADU,308,6,55,369,226,0,17,243,224,4134,0,296,4430,2608,0,0,0,0
4643,GUNTUR,Karlapalem,SAMMETAVARIPALEM,0,0,567,567,0,0,431,431,336,0,0,8879,8879,4126,0,0,0,0
4644,GUNTUR,Karlapalem,TUMMALAPALLI,0,30,455,485,0,9,384,393,404,0,276,5733,6009,3514,0,0,0,0
4645,GUNTUR,Karlapalem,YAZALI,294,50,468,812,67,2,284,353,332,1378,44,8506,9928,5084,0,0,1,1
4646,GUNTUR,Karlapalem,YETRAVARIPALEM,3,1,506,510,0,0,256,256,238,0,0,5840,5840,3300,0,0,0,0
4647,GUNTUR,Kollipara,ANNAVARAM,121,0,445,566,82,0,245,327,304,2015,0,4862,6877,4184,0,0,0,0
4648,GUNTUR,Kollipara,ANNAVARAPU LANKA,249,0,39,288,12,0,0,12,12,240,0,0,240,130,0,0,0,0
4649,GUNTUR,Kollipara,ATHALURIVARIPALEM,44,0,32,76,3,0,1,4,1,28,0,20,48,4,0,0,0,0
4650,GUNTUR,Kollipara,ATHOTA,290,10,672,972,150,0,167,317,301,4609,0,5047,9656,6114,0,0,1,1
4651,GUNTUR,Kollipara,BOMMUVARIPALEM,88,7,165,260,12,0,2,14,13,222,0,40,262,146,0,0,0,0
4652,GUNTUR,Kollipara,CHAKRAYA PALEM,0,0,779,779,0,0,369,369,320,0,0,7574,7574,3924,0,0,0,0
4653,GUNTUR,Kollipara,CHEMUDUPADU,299,2,138,439,152,1,1,154,147,6648,68,15,6731,3526,2,0,0,2
4654,GUNTUR,Kollipara,CHIVALUR,295,18,234,547,193,12,139,344,316,7028,247,2549,9824,5712,2,0,0,2
4655,GUNTUR,Kollipara,DANTHALUR,234,2,137,373,166,1,80,247,225,7781,48,3348,11177,6080,5,0,1,6
4656,GUNTUR,Kollipara,DAVULURU,268,20,330,618,160,0,59,219,186,5983,0,1741,7724,4465,2,0,1,3
4657,GUNTUR,Kollipara,DAVULURUPALEM,38,3,418,459,28,0,159,187,175,995,0,4954,5949,3831,0,0,1,1
4658,GUNTUR,Kollipara,HANUMAN PALEM,58,0,253,311,2,0,1,3,2,16,0,20,36,18,0,0,0,0
4659,GUNTUR,Kollipara,KOLLIPARA,1175,48,1085,2308,439,5,194,638,600,8288,100,4377,12765,8614,0,0,0,0
4660,GUNTUR,Kollipara,KUNCHAVARAM,3,4,103,110,0,0,56,56,52,0,0,1769,1769,1168,0,0,1,1
4661,GUNTUR,Kollipara,MUNNANGI,569,44,249,862,354,1,31,386,387,8028,14,1163,9205,5371,0,0,0,0
4662,GUNTUR,Kollipara,PIDAPARRU,286,3,56,345,179,2,19,200,157,6033,40,395,6468,3262,0,0,0,0
4663,GUNTUR,Kollipara,PIDAPARTHIPALEM,161,0,96,257,111,0,36,147,146,2075,0,611,2686,1488,0,0,0,0
4664,GUNTUR,Kollipara,SIRIPURAM,248,6,50,304,170,0,4,174,162,3081,0,80,3161,1621,0,0,0,0
4665,GUNTUR,Kollipara,THUMULURU,599,151,296,1046,364,7,57,428,401,8871,99,1567,10537,5993,0,0,0,0
4666,GUNTUR,Kollipara,VALLABHAPURAM,615,27,936,1578,264,0,34,298,260,10810,0,1243,12053,6565,4,0,0,4
4667,GUNTUR,Kollur,ANANTHAVARAM,425,68,271,764,263,46,108,417,388,9600,1433,3199,14232,7657,4,0,0,4
4668,GUNTUR,Kollur,AVULA VARI PALEM,208,0,154,362,106,0,16,122,119,1473,0,267,1740,1178,0,0,0,0
4669,GUNTUR,Kollur,BODDULURIPADU,63,1,209,273,42,0,88,130,111,1724,0,2875,4599,2650,0,0,0,0
4670,GUNTUR,Kollur,CHILUMURU,355,3,432,790,174,1,80,255,234,5147,20,1755,6922,3807,0,0,0,0
4671,GUNTUR,Kollur,CHINAPULIVARRU,185,1,217,403,128,1,96,225,196,4810,15,1895,6720,3200,0,0,0,0
4672,GUNTUR,Kollur,CHINTHALLANKA,240,0,83,323,165,0,11,176,157,2949,0,124,3073,1507,0,0,0,0
4673,GUNTUR,Kollur,DONEPUDI,819,10,178,1007,392,1,39,432,379,9289,20,685,9994,5988,0,0,0,0
4674,GUNTUR,Kollur,GAJULLANKA,0,0,412,412,0,0,36,36,36,0,0,760,760,400,0,0,0,0
4675,GUNTUR,Kollur,IPURU,361,3,105,469,152,2,27,181,157,2832,40,540,3412,1841,0,0,0,0
4676,GUNTUR,Kollur,IPURU LANKA,207,0,108,315,44,0,16,60,55,870,0,310,1180,760,0,0,0,0
4677,GUNTUR,Kollur,JUVVALA PALEM,493,0,102,595,143,0,12,155,120,1924,0,226,2150,1057,0,0,0,0
4678,GUNTUR,Kollur,KISHKINDAPALEM,344,8,191,543,227,2,22,251,226,5570,34,463,6067,3473,0,0,0,0
4679,GUNTUR,Kollur,KOLLURU,1205,296,437,1938,741,86,96,923,854,12257,1523,1789,15569,9952,0,0,0,0
4680,GUNTUR,Kollur,KRAPA,253,10,324,587,135,6,153,294,244,3629,125,4012,7766,3534,0,0,0,0
4681,GUNTUR,Kollur,MOSALIPADU,119,0,15,134,74,0,3,77,86,4434,0,60,4494,2515,9,0,0,9
4682,GUNTUR,Kollur,PEDA LANKA,92,0,227,319,41,0,47,88,82,482,0,751,1233,629,0,0,0,0
4683,GUNTUR,Kollur,PESARLLANKA,0,0,208,208,0,0,52,52,45,0,0,1038,1038,565,0,0,0,0
4684,GUNTUR,Kollur,POTHARLANKA,158,6,501,665,109,3,288,400,378,2034,56,5014,7104,4625,0,0,0,0
4685,GUNTUR,Kollur,RAVIKAMPADU,216,34,58,308,127,11,19,157,147,2829,214,329,3372,1850,0,0,0,0
4686,GUNTUR,Kollur,SUGGUNA LANKA,0,5,230,235,0,4,33,37,30,0,80,648,728,340,0,0,0,0
4687,GUNTUR,Kollur,TADIGIRI PADU,187,1,79,267,132,0,47,179,189,7650,0,2339,9989,5847,12,0,2,14
4688,GUNTUR,Kollur,THADIKALAPUDI,83,3,106,192,63,1,30,94,86,789,20,471,1280,782,0,0,0,0
4689,GUNTUR,Kollur,THIPPALA KATTA,127,3,186,316,4,0,7,11,11,80,0,134,214,134,0,0,0,0
4690,GUNTUR,Kollur,THOKALAVANIPALEM,489,0,40,529,185,0,0,185,165,3047,0,0,3047,1810,0,0,0,0
4691,GUNTUR,Krosuru,ANANTHAVARAM,114,75,651,840,66,51,323,440,424,2422,1830,9969,14221,7257,1,1,12,14
4692,GUNTUR,Krosuru,ANDUKURU,416,48,342,806,236,22,87,345,306,10870,381,2405,13656,6851,15,0,2,17
4693,GUNTUR,Krosuru,AVULAVARIPALEM,94,14,367,475,72,11,196,279,221,4253,614,7861,12728,6149,15,1,9,25
4694,GUNTUR,Krosuru,BALEMARRU,220,9,162,391,133,0,71,204,189,6834,0,1977,8811,4232,11,0,3,14
4695,GUNTUR,Krosuru,BAYYAVARAM,264,1,863,1128,106,0,356,462,225,2896,0,14369,17265,3395,1,0,13,14
4696,GUNTUR,Krosuru,DODLERU,540,113,1168,1821,163,10,299,472,439,3036,200,7047,10283,5773,2,0,3,5
4697,GUNTUR,Krosuru,GADIVARIPALEM,12,5,248,265,1,1,129,131,112,20,6,4235,4261,2065,0,0,1,1
4698,GUNTUR,Krosuru,GARIKAPADU,10,38,190,238,3,14,84,101,86,57,257,3698,4012,2199,0,0,4,4
4699,GUNTUR,Krosuru,GUDIPADU,222,13,333,568,133,7,119,259,232,5540,293,3086,8919,4783,7,1,2,10
4700,GUNTUR,Krosuru,HASSANBADA,39,0,472,511,15,0,109,124,124,341,0,1796,2137,1149,0,0,0,0
4701,GUNTUR,Krosuru,KROSURU,881,281,1363,2525,133,54,168,355,188,2014,926,3233,6173,2912,0,0,0,0
4702,GUNTUR,Krosuru,NAGAVARAM,173,0,492,665,79,0,141,220,222,1303,0,5570,6873,3494,0,0,10,10
4703,GUNTUR,Krosuru,PEESAPADU,353,22,256,631,191,18,66,275,247,8250,851,2640,11741,5505,10,2,5,17
4704,GUNTUR,Krosuru,PERIKAPADU,121,340,184,645,46,159,47,252,248,1138,3126,646,4910,2514,0,0,0,0
4705,GUNTUR,Krosuru,THALLURU,406,113,659,1178,196,51,248,495,425,4402,797,6295,11494,5309,5,0,4,9
4706,GUNTUR,Krosuru,VIPPARLA,327,22,164,513,145,4,35,184,178,6342,61,1350,7753,4053,8,0,1,9
4707,GUNTUR,Krosuru,VUTUKURU,466,42,363,871,220,5,105,330,282,8283,149,2911,11343,5476,3,0,1,4
4708,GUNTUR,Krosuru,VUYYANDANA,3,0,596,599,1,0,259,260,236,31,0,8538,8569,3498,0,0,8,8
4709,GUNTUR,Machavaram,CHENNAYAPALEM,99,147,307,553,53,117,175,345,370,1163,3267,4366,8796,4859,0,2,1,3
4710,GUNTUR,Machavaram,GANGIREDDIPALEM,130,10,859,999,28,3,77,108,99,459,60,1295,1814,874,0,0,0,0
4711,GUNTUR,Machavaram,GOVINDAPURAM,42,0,118,160,29,0,81,110,114,880,0,3140,4020,2159,0,0,0,0
4712,GUNTUR,Machavaram,KOTHAAGAANESHUNIPADU,94,69,368,531,46,28,142,216,180,1203,586,4981,6770,3806,1,0,0,1
4713,GUNTUR,Machavaram,KOTHAPALEM,262,3,421,686,131,0,47,178,174,5266,0,1081,6347,3077,2,0,1,3
4714,GUNTUR,Machavaram,MACHAVARAM,876,69,1304,2249,166,3,121,290,263,3017,52,2263,5332,3534,0,0,0,0
4715,GUNTUR,Machavaram,MALLAVOLU,446,18,405,869,159,9,263,431,422,3209,105,4780,8094,4757,0,0,0,0
4716,GUNTUR,Machavaram,MORJAMPADU,166,103,583,852,59,22,67,148,140,1627,400,1203,3230,1705,0,0,0,0
4717,GUNTUR,Machavaram,PILLUTLA,160,620,502,1282,65,252,206,523,460,1299,3977,4477,9753,5265,0,0,0,0
4718,GUNTUR,Machavaram,PINNELLI,482,211,1710,2403,83,36,407,526,475,1284,594,9345,11223,5852,0,0,0,0
4719,GUNTUR,Machavaram,REGULAGADDA,103,12,253,368,68,5,141,214,186,1716,51,3085,4852,2379,0,0,1,1
4720,GUNTUR,Machavaram,SRIRUKMINIPURAM,49,44,292,385,9,19,99,127,112,148,220,1183,1551,684,0,0,0,0
4721,GUNTUR,Machavaram,TURAKAPALEM,2,0,712,714,0,0,116,116,117,0,0,1815,1815,953,0,0,0,0
4722,GUNTUR,Machavaram,VELLAMPALLI,64,0,163,227,27,0,67,94,103,121,0,207,328,188,0,0,0,0
4723,GUNTUR,Machavaram,VEMAVARAM,368,5,846,1219,116,0,248,364,367,2037,0,5139,7176,3772,0,0,0,0
4724,GUNTUR,Macherla,A.J.MEDAKA,181,83,1053,1317,72,19,541,632,635,1264,586,17292,19142,10808,0,0,14,14
4725,GUNTUR,Macherla,BYRAVUNIPADU,89,6,367,462,49,1,194,244,232,1768,17,4703,6488,4292,3,0,2,5
4726,GUNTUR,Macherla,CHINTALA THANDA,8,1112,25,1145,2,725,16,743,723,96,44708,596,45400,23278,0,133,2,135
4727,GUNTUR,Macherla,ECONAMPET,11,132,191,334,5,113,130,248,240,283,8130,7267,15680,9205,1,31,7,39
4728,GUNTUR,Macherla,GANNAVARAM,153,23,711,887,84,10,362,456,464,3073,214,10911,14198,8251,1,0,0,1
4729,GUNTUR,Macherla,KAMBHAMPADU,201,83,1743,2027,43,2,245,290,294,774,38,3332,4144,2502,0,0,0,0
4730,GUNTUR,Macherla,KOPPUNURU,422,302,1076,1800,179,198,607,984,985,8771,8271,31209,48251,26110,21,10,58,89
4731,GUNTUR,Macherla,KOTHAPALLI,390,216,972,1578,47,24,143,214,208,734,2557,4097,7388,4263,0,14,5,19
4732,GUNTUR,Macherla,KOTTURU,66,171,365,602,45,121,191,357,340,2493,4823,5599,12915,7689,4,4,0,8
4733,GUNTUR,Macherla,LATCHAMMABHAVI,158,717,569,1444,69,478,225,772,929,3591,21553,12002,37146,20400,5,33,11,49
4734,GUNTUR,Macherla,LINGAPURAM,17,0,127,144,11,0,72,83,78,321,0,1884,2205,1537,0,0,2,2
4735,GUNTUR,Macherla,M.GANNAVARAM,1,3,58,62,1,1,25,27,29,65,43,643,751,452,0,0,0,0
4736,GUNTUR,Macherla,NAGULAVARAM,540,863,1585,2988,175,197,460,832,830,8239,12260,19673,40172,22634,17,32,23,72
4737,GUNTUR,Macherla,PASUVEMULA,73,156,459,688,21,3,231,255,248,471,111,5483,6065,3350,0,0,0,0
4738,GUNTUR,Macherla,RAYAVARAM,223,4,1196,1423,116,1,477,594,620,4454,34,10816,15304,9240,5,0,2,7
4739,GUNTUR,Macherla,THALLAPALLI,109,250,1062,1421,24,106,406,536,539,507,4524,10754,15785,10077,1,10,5,16
4740,GUNTUR,Mangalagiri,ATMAKUR,328,16,504,848,66,0,7,73,68,1293,0,126,1419,928,0,0,0,0
4741,GUNTUR,Mangalagiri,BETHAPUDI,202,0,275,477,14,0,10,24,19,310,0,227,537,250,0,0,0,0
4742,GUNTUR,Mangalagiri,CHINAKAKANI,261,9,681,951,34,1,116,151,140,663,20,2098,2781,1677,0,0,0,0
4743,GUNTUR,Mangalagiri,CHINAVADLAPUDI,0,0,103,103,0,0,0,0,0,0,0,0,0,0,0,0,0,0
4744,GUNTUR,Mangalagiri,KAZA,121,27,549,697,0,0,143,143,20,0,0,6904,6904,704,0,0,4,4
4745,GUNTUR,Mangalagiri,KRISHNAYAPALEM,186,0,107,293,57,0,30,87,78,1427,0,800,2227,1096,0,0,0,0
4746,GUNTUR,Mangalagiri,KURAGALLU,184,28,418,630,13,2,80,95,53,259,14,2681,2954,906,0,0,0,0
4747,GUNTUR,Mangalagiri,NEERUKONDA,165,14,211,390,69,7,114,190,103,2397,257,4320,6974,1965,1,0,8,9
4748,GUNTUR,Mangalagiri,NIDAMARRU,440,3,244,687,29,0,10,39,1,869,0,92,961,5,0,0,0,0
4749,GUNTUR,Mangalagiri,NOWLUR,334,41,247,622,20,20,69,109,104,279,291,999,1569,994,0,0,0,0
4750,GUNTUR,Mangalagiri,NUTHAKKI,442,17,216,675,168,0,0,168,138,3334,0,0,3334,1602,0,0,0,0
4751,GUNTUR,Mangalagiri,PEDAVADLAPUDI,379,1,102,482,52,0,0,52,47,1323,0,0,1323,600,0,0,0,0
4752,GUNTUR,Mangalagiri,RAMACHANDRAPURAM,2,2,193,197,0,0,50,50,41,0,0,1175,1175,587,0,0,0,0
4753,GUNTUR,Mangalagiri,YERRABALEM,133,112,451,696,60,23,52,135,80,1423,474,1122,3019,1346,0,0,0,0
4754,GUNTUR,Medikonduru,DOKIPARRU,375,30,553,958,133,3,108,244,247,2475,60,1894,4429,2861,0,0,0,0
4755,GUNTUR,Medikonduru,GUNDLAPALEM,104,24,47,175,61,2,4,67,64,2573,48,44,2665,2345,0,0,0,0
4756,GUNTUR,Medikonduru,JANGAMGUNTLAPALEM,99,39,471,609,61,26,277,364,335,3101,1506,12876,17483,8890,7,3,10,20
4757,GUNTUR,Medikonduru,KORRAPADU,281,108,378,767,86,28,165,279,245,2304,367,7282,9953,4763,1,0,5,6
4758,GUNTUR,Medikonduru,MANDAPADU,360,96,149,605,196,35,40,271,224,7889,816,1569,10274,4546,9,0,2,11
4759,GUNTUR,Medikonduru,MANGALAGIRIPADU,3,0,566,569,0,0,161,161,145,0,0,7487,7487,4658,0,0,8,8
4760,GUNTUR,Medikonduru,MEDIKONDURU,488,62,495,1045,203,17,85,305,278,6144,244,1808,8196,4794,1,0,0,1
4761,GUNTUR,Medikonduru,PALADUGU,348,95,263,706,171,4,42,217,201,7989,60,1104,9153,4659,23,0,3,26
4762,GUNTUR,Medikonduru,PERICHERLA,539,72,474,1085,234,16,136,386,367,5957,285,2369,8611,6676,6,0,1,7
4763,GUNTUR,Medikonduru,SIRIPURAM,791,121,519,1431,193,2,90,285,272,5584,33,5389,11006,6401,6,0,12,18
4764,GUNTUR,Medikonduru,VARAGANI,279,4,277,560,198,4,169,371,191,7783,90,5285,13158,3257,6,0,2,8
4765,GUNTUR,Medikonduru,VELAVARTHI PADU,269,7,396,672,140,4,100,244,229,7226,96,4249,11571,6208,10,0,1,11
4766,GUNTUR,Medikonduru,VISADALA,242,13,185,440,116,11,61,188,181,3497,433,2638,6568,4290,1,0,4,5
4767,GUNTUR,Muppalla,BOLLAVRAM,175,7,259,441,96,3,167,266,233,2596,90,4621,7307,3487,0,0,0,0
4768,GUNTUR,Muppalla,CHAGANTIVARIPALEM,114,59,868,1041,45,21,520,586,516,935,592,10589,12116,6373,0,0,0,0
4769,GUNTUR,Muppalla,DAMMALAPADU,147,30,890,1067,63,9,342,414,355,1304,98,5468,6870,3327,0,0,1,1
4770,GUNTUR,Muppalla,GOLLAPADU,179,69,349,597,109,30,184,323,302,2513,542,4075,7130,3997,0,0,0,0
4771,GUNTUR,Muppalla,IRUKUPALEM,241,32,557,830,145,4,125,274,224,4632,74,2463,7169,3992,0,0,0,0
4772,GUNTUR,Muppalla,KUNDURUVARIPALEM,1,56,434,491,0,44,278,322,286,0,1473,6617,8090,4217,0,0,0,0
4773,GUNTUR,Muppalla,LANKELA KURAPADU,176,46,696,918,89,14,323,426,337,3160,701,9104,12965,6953,1,1,2,4
4774,GUNTUR,Muppalla,MADALA,562,71,1319,1952,261,17,456,734,703,7032,316,9391,16739,9417,2,0,0,2
4775,GUNTUR,Muppalla,MUPPALLA,583,9,860,1452,212,2,263,477,406,4947,25,3925,8897,4523,0,0,0,0
4776,GUNTUR,Muppalla,NARENPADU,249,58,374,681,164,31,178,373,337,6022,1216,4451,11689,6180,4,0,1,5
4777,GUNTUR,Muppalla,PALUDEVARLAPADU,354,11,314,679,166,3,159,328,257,5584,86,3771,9441,5353,2,0,0,2
4778,GUNTUR,Muppalla,RUDRAVARAM,96,67,256,419,64,56,128,248,243,2180,3044,3628,8852,4407,4,7,1,12
4779,GUNTUR,Muppalla,THONDAPI,357,18,848,1223,157,0,472,629,614,3648,0,13762,17410,9272,0,0,4,4
4780,GUNTUR,Muppalla,THURAKAPALEM,0,0,129,129,0,0,97,97,82,0,0,7951,7951,3972,0,0,41,41
4781,GUNTUR,Nadendla,AMMENSAHEBPALEM,51,22,151,224,20,0,56,76,69,550,0,2052,2602,1362,0,0,0,0
4782,GUNTUR,Nadendla,APPAPURAM,242,2,554,798,66,0,117,183,179,1548,0,5649,7197,3881,1,0,7,8
4783,GUNTUR,Nadendla,BUKKAPURAM,84,0,281,365,17,0,61,78,71,184,0,1185,1369,751,0,0,1,1
4784,GUNTUR,Nadendla,CHANDAVARAM,225,15,730,970,94,1,224,319,276,6143,48,9216,15407,8484,11,0,6,17
4785,GUNTUR,Nadendla,CHIRUMAMILLA,311,55,495,861,136,21,118,275,199,4498,426,2920,7844,3036,3,0,0,3
4786,GUNTUR,Nadendla,ENDUGUMPALEM,159,6,323,488,96,0,11,107,93,2782,0,220,3002,1545,1,0,0,1
4787,GUNTUR,Nadendla,GANAPAVARAM,681,20,710,1411,236,2,127,365,342,9555,40,2899,12494,8603,8,0,0,8
4788,GUNTUR,Nadendla,GORIJAVOLU,223,13,270,506,31,0,38,69,44,1549,0,1996,3545,1419,1,0,3,4
4789,GUNTUR,Nadendla,IRLAPADU,318,0,305,623,104,0,132,236,206,2820,0,5892,8712,4727,1,0,12,13
4790,GUNTUR,Nadendla,JANGALAPALLI,149,8,307,464,101,3,136,240,205,3457,151,6370,9978,4829,1,0,3,4
4791,GUNTUR,Nadendla,KANUPARRU,334,98,442,874,123,26,74,223,208,3751,484,1917,6152,3655,3,0,0,3
4792,GUNTUR,Nadendla,NADENDLA,902,123,1262,2287,232,2,244,478,459,6139,59,7301,13499,7388,2,0,1,3
4793,GUNTUR,Nadendla,SANKURATRIPADU,158,33,480,671,76,22,187,285,235,2971,1094,8054,12119,6410,7,2,4,13
4794,GUNTUR,Nadendla,SATHULURU,286,41,544,871,140,5,95,240,215,6033,197,3749,9979,5251,5,0,9,14
4795,GUNTUR,Nadendla,THUBADU,391,34,507,932,75,1,132,208,176,2634,24,3654,6312,3153,1,0,0,1
4796,GUNTUR,Nagaram,ADDANKIVARIPALEM,48,0,512,560,5,0,230,235,215,100,0,7064,7164,3555,0,0,0,0
4797,GUNTUR,Nagaram,ALLAPARRU,104,38,272,414,44,14,1,59,58,2817,170,111,3098,1539,12,0,1,13
4798,GUNTUR,Nagaram,BELLAMVARIPALEM,107,2,220,329,13,0,24,37,37,260,0,414,674,356,0,0,0,0
4799,GUNTUR,Nagaram,BORAMADIGAPALLI,212,34,160,406,48,0,0,48,39,624,0,0,624,283,0,0,0,0
4800,GUNTUR,Nagaram,CHINAMATLAPUDI,127,0,523,650,44,0,77,121,115,867,0,2930,3797,1922,0,0,0,0
4801,GUNTUR,Nagaram,CHIRAKAVARIPALEM,4,0,321,325,1,0,32,33,32,20,0,520,540,258,0,0,0,0
4802,GUNTUR,Nagaram,DHULIPUDI(NORTH),425,28,202,655,158,3,84,245,208,4032,139,3628,7799,3954,0,0,3,3
4803,GUNTUR,Nagaram,DHULIPUDI(SOUTH),5,0,371,376,1,0,291,292,256,22,0,7167,7189,3637,0,0,0,0
4804,GUNTUR,Nagaram,EDUPALLI,39,39,585,663,21,11,111,143,61,230,74,1240,1544,515,0,0,0,0
4805,GUNTUR,Nagaram,ELETIPALEM,177,8,265,450,107,0,19,126,112,3505,0,272,3777,2048,0,0,0,0
4806,GUNTUR,Nagaram,JILLEPALLI,83,0,27,110,14,0,0,14,14,242,0,0,242,102,0,0,0,0
4807,GUNTUR,Nagaram,KOLAGANIVARIPALEM,1,2,302,305,0,0,7,7,4,0,0,116,116,36,0,0,0,0
4808,GUNTUR,Nagaram,MANTRIPALEM,354,0,381,735,134,0,11,145,129,4590,0,227,4817,2370,5,0,0,5
4809,GUNTUR,Nagaram,Meesalavaripalem,0,0,1,1,0,0,0,0,0,0,0,0,0,0,0,0,0,0
4810,GUNTUR,Nagaram,NAGARAM,197,89,526,812,47,24,94,165,124,689,472,1378,2539,1346,0,0,0,0
4811,GUNTUR,Nagaram,PAMIDIMARRU,312,4,54,370,158,4,12,174,150,5483,80,240,5803,3452,2,0,0,2
4812,GUNTUR,Nagaram,PEDAMATLAPUDI,65,0,438,503,28,0,0,28,24,334,0,0,334,176,0,0,0,0
4813,GUNTUR,Nagaram,PEDAPALLI,170,33,718,921,113,4,339,456,387,3475,42,7684,11201,5434,0,0,0,0
4814,GUNTUR,Nagaram,PEDDAVARAM,140,27,207,374,56,0,1,57,63,924,0,6,930,444,0,0,0,0
4815,GUNTUR,Nagaram,PUDIWADA,280,19,628,927,48,0,179,227,64,365,0,1592,1957,420,0,0,0,0
4816,GUNTUR,Nagaram,SAJJAVARIPALEM,325,9,197,531,196,1,35,232,223,3321,20,689,4030,2532,0,0,0,0
4817,GUNTUR,Nagaram,SIRIPUDI,178,24,426,628,119,19,131,269,221,3027,382,1885,5294,2437,0,0,0,0
4818,GUNTUR,Nagaram,TADIVAKAVARIPALEM,47,0,328,375,34,0,109,143,137,900,0,2356,3256,1668,0,0,0,0
4819,GUNTUR,Nagaram,THOTAPALLI,94,11,117,222,66,6,97,169,152,2402,145,3000,5547,2605,0,0,0,0
4820,GUNTUR,Nagaram,ULLIPALEM,200,12,201,413,122,3,65,190,166,2709,90,1346,4145,2180,0,0,0,0
4821,GUNTUR,Nagaram,VENIGALLAVARIPALEM,121,0,8,129,98,0,5,103,98,4292,0,362,4654,2302,3,0,0,3
4822,GUNTUR,Nakarikallu,CHAGALLU,111,10,510,631,66,2,293,361,333,2934,27,8898,11859,6273,0,0,2,2
4823,GUNTUR,Nakarikallu,CHALLAGUNDLA,238,156,1487,1881,27,27,444,498,462,507,466,8410,9383,6027,0,0,1,1
4824,GUNTUR,Nakarikallu,CHEJERLA,214,172,651,1037,92,39,211,342,335,2247,1310,6909,10466,6335,0,1,11,12
4825,GUNTUR,Nakarikallu,CHIMALA MARRI,210,33,702,945,88,15,156,259,232,1546,251,2920,4717,2478,0,0,0,0
4826,GUNTUR,Nakarikallu,DECHAVARAM,181,86,671,938,26,9,203,238,232,536,224,6063,6823,4627,0,0,3,3
4827,GUNTUR,Nakarikallu,GUNDLAPALLI,486,249,1750,2485,186,119,585,890,854,5030,1629,13720,20379,12384,6,0,7,13
4828,GUNTUR,Nakarikallu,KANDLAKUNTA,543,96,629,1268,182,19,257,458,409,4224,315,5472,10011,5858,2,0,0,2
4829,GUNTUR,Nakarikallu,KUNKALAGUNTA,488,401,1640,2529,65,72,559,696,679,1299,1446,20449,23194,12326,0,0,24,24
4830,GUNTUR,Nakarikallu,NARASINGAPADU,29,4,549,582,22,1,277,300,289,661,8,6106,6775,4825,0,0,3,3
4831,GUNTUR,Nakarikallu,NEKARIKALLU,439,560,2076,3075,91,218,492,801,726,1521,10245,15886,27652,19245,0,24,18,42
4832,GUNTUR,Nakarikallu,RUPENAGUNTLA,213,29,613,855,65,19,312,396,370,1096,363,13568,15027,9256,0,0,16,16
4833,GUNTUR,Nakarikallu,THURAKAPALEM,27,0,185,212,12,0,121,133,105,248,0,6895,7143,3352,0,0,16,16
4834,GUNTUR,Nakarikallu,TRIPURA PURAM,4,4,243,251,3,0,22,25,22,45,0,336,381,170,0,0,0,0
4835,GUNTUR,Narasaraopeta,ALLURUVARIPALEM,105,110,317,532,14,35,60,109,94,235,674,1962,2871,1933,0,0,0,0
4836,GUNTUR,Narasaraopeta,ARAVAPALLI,32,32,409,473,12,14,237,263,226,355,520,9436,10311,5526,0,0,2,2
4837,GUNTUR,Narasaraopeta,CHINATALAPALEM,0,0,183,183,0,0,147,147,148,0,0,6118,6118,3713,0,0,1,1
4838,GUNTUR,Narasaraopeta,CHINATURAKAPALEM,1,0,707,708,0,0,69,69,65,0,0,1368,1368,680,0,0,0,0
4839,GUNTUR,Narasaraopeta,DONDAPADU,222,16,423,661,160,6,256,422,348,4579,118,6324,11021,5024,0,0,0,0
4840,GUNTUR,Narasaraopeta,ELLAMANDA,396,34,523,953,107,3,148,258,238,2511,76,4762,7349,4409,3,0,6,9
4841,GUNTUR,Narasaraopeta,GONEPUDI,119,9,486,614,4,9,202,215,177,38,64,5115,5217,3170,0,0,1,1
4842,GUNTUR,Narasaraopeta,GURAVAYAPALEM,807,32,618,1457,349,10,232,591,611,9719,288,3877,13884,7859,9,1,0,10
4843,GUNTUR,Narasaraopeta,IKKURRU,168,48,849,1065,100,1,397,498,499,2704,12,6529,9245,5160,0,0,0,0
4844,GUNTUR,Narasaraopeta,ISAPPALEM,139,34,548,721,35,12,214,261,243,525,153,2213,2891,1990,0,0,0,0
4845,GUNTUR,Narasaraopeta,JONNALAGADDA,831,59,758,1648,337,16,274,627,570,8013,265,7767,16045,10351,0,0,2,2
4846,GUNTUR,Narasaraopeta,K.M.AGRAHARAM,162,9,306,477,103,1,159,263,259,4562,24,7955,12541,7252,8,0,10,18
4847,GUNTUR,Narasaraopeta,KAKANI,336,6,160,502,76,0,5,81,74,832,0,102,934,431,0,0,0,0
4848,GUNTUR,Narasaraopeta,KESANAPALLI,427,74,270,771,153,17,12,182,177,2894,328,252,3474,2125,0,0,0,0
4849,GUNTUR,Narasaraopeta,KONDAKAVURU,99,83,360,542,39,16,128,183,184,1976,419,4679,7074,4106,3,0,0,3
4850,GUNTUR,Narasaraopeta,KOTHAPALEM,206,32,83,321,145,1,3,149,164,6590,6,54,6650,3852,4,0,0,4
4851,GUNTUR,Narasaraopeta,LINGAMGUNTLA,390,201,971,1562,40,24,227,291,250,1132,376,4161,5669,3931,0,0,0,0
4852,GUNTUR,Narasaraopeta,MULAKALUR,385,12,439,836,133,1,205,339,339,3305,31,4548,7884,5737,0,0,2,2
4853,GUNTUR,Narasaraopeta,PALAPADU,305,47,700,1052,157,26,274,457,441,3680,749,6678,11107,7306,1,0,0,1
4854,GUNTUR,Narasaraopeta,PAMIDIMARRU,274,6,294,574,162,4,77,243,228,7779,119,3837,11735,6419,14,0,10,24
4855,GUNTUR,Narasaraopeta,PAMIDIPADU,178,80,1371,1629,78,26,228,332,309,1412,573,3512,5497,2858,0,0,0,0
4856,GUNTUR,Narasaraopeta,PEDATURAKAPALEM,1,0,349,350,0,0,77,77,56,0,0,1629,1629,830,0,0,0,0
4857,GUNTUR,Narasaraopeta,PETLURIVARIPALEM,373,13,449,835,214,6,64,284,255,8492,109,1152,9753,5431,8,0,0,8
4858,GUNTUR,Narasaraopeta,RAVIPADU,709,26,870,1605,172,12,420,604,540,3016,358,11063,14437,9693,1,0,3,4
4859,GUNTUR,Narasaraopeta,REDDYPALEM,173,181,326,680,137,115,158,410,375,5538,4293,6311,16142,9322,1,1,2,4
4860,GUNTUR,Narasaraopeta,UPPALAPADU,378,47,487,912,120,10,145,275,265,1330,58,2980,4368,2970,0,0,0,0
4861,GUNTUR,Nizampatnam,ADAVULADEEVI,200,55,1590,1845,126,15,722,863,762,2971,251,11177,14399,7018,1,0,0,1
4862,GUNTUR,Nizampatnam,AMUDALAPALLI,119,73,928,1120,60,27,522,609,526,656,337,4564,5557,2843,0,0,0,0
4863,GUNTUR,Nizampatnam,BAVAJIPALEM,2,0,453,455,0,0,153,153,112,0,0,2703,2703,1228,0,0,0,0
4864,GUNTUR,Nizampatnam,BORRAVARIPALEM,0,0,529,529,0,0,255,255,230,0,0,4469,4469,2184,0,0,0,0
4865,GUNTUR,Nizampatnam,DINDI,2,10,684,696,0,0,182,182,195,0,0,2350,2350,1274,0,0,0,0
4866,GUNTUR,Nizampatnam,GARUVUPALEM,93,27,324,444,6,0,23,29,21,120,0,388,508,231,0,0,0,0
4867,GUNTUR,Nizampatnam,GURNADHANAGAR,174,0,61,235,134,0,43,177,190,3093,0,916,4009,2071,0,0,0,0
4868,GUNTUR,Nizampatnam,HORISPET,3,0,309,312,1,0,183,184,167,18,0,3912,3930,1996,0,0,0,0
4869,GUNTUR,Nizampatnam,KALLIPHALAM,130,30,490,650,71,16,77,164,141,2061,558,1302,3921,1845,0,0,0,0
4870,GUNTUR,Nizampatnam,KOTHAPALEM,1,29,1702,1732,0,2,252,254,231,0,40,5036,5076,3123,0,0,0,0
4871,GUNTUR,Nizampatnam,KUCHINAPUDI,400,67,305,772,247,35,55,337,305,2862,514,760,4136,2116,0,0,0,0
4872,GUNTUR,Nizampatnam,MUTHUPALLI,126,31,244,401,0,0,21,21,17,0,0,348,348,195,0,0,0,0
4873,GUNTUR,Nizampatnam,NIZAMPATNAM,352,51,2249,2652,29,3,215,247,237,803,39,4373,5215,3586,0,0,1,1
4874,GUNTUR,Nizampatnam,PALLAPATLA,88,17,496,601,59,0,178,237,219,1134,0,1896,3030,1614,0,0,0,0
4875,GUNTUR,Nizampatnam,PREGNAM,82,110,522,714,37,28,194,259,249,501,800,3842,5143,2724,0,0,0,0
4876,GUNTUR,Nuzendla,CHINTALA CHERUVU,251,1,1049,1301,118,0,579,697,599,2820,0,20888,23708,11429,0,0,17,17
4877,GUNTUR,Nuzendla,GURRAPANAIDUPALEM,70,13,63,146,26,4,22,52,40,289,80,392,761,390,0,0,0,0
4878,GUNTUR,Nuzendla,INAVOLU,45,0,761,806,8,0,215,223,181,81,0,2480,2561,1485,0,0,0,0
4879,GUNTUR,Nuzendla,JANGALAPALLI,143,15,307,465,97,10,212,319,344,2869,786,11234,14889,9349,3,4,25,32
4880,GUNTUR,Nuzendla,KAMMAVARIPALEM,41,27,396,464,21,8,272,301,287,280,133,13908,14321,7825,0,0,20,20
4881,GUNTUR,Nuzendla,KHAMBHAMPADU,280,42,428,750,142,21,276,439,419,4768,565,12441,17774,10797,2,0,17,19
4882,GUNTUR,Nuzendla,KOTHAZADDAVARIPALEM,78,6,375,459,27,1,247,275,291,560,8,7778,8346,4740,0,0,1,1
4883,GUNTUR,Nuzendla,MUKKELLAPADU,2,52,375,429,0,1,157,158,119,0,8,2323,2331,1028,0,0,0,0
4884,GUNTUR,Nuzendla,MULAKALUR,171,0,473,644,123,0,277,400,398,6443,0,7894,14337,7671,20,0,2,22
4885,GUNTUR,Nuzendla,MUPPARAJU VARIPALEM,82,13,266,361,43,0,158,201,183,1425,0,7923,9348,6040,0,0,13,13
4886,GUNTUR,Nuzendla,MURTHIJAPURAM,123,7,679,809,70,3,422,495,462,1646,40,14118,15804,8653,0,0,25,25
4887,GUNTUR,Nuzendla,MUTHARAJUVARIPALEM,10,0,447,457,7,0,245,252,240,130,0,3766,3896,1882,0,0,0,0
4888,GUNTUR,Nuzendla,NUZENDLA,65,46,620,731,29,5,183,217,221,624,82,3379,4085,2216,0,0,0,0
4889,GUNTUR,Nuzendla,PAMIDIPADU,101,1,552,654,51,1,365,417,515,672,24,5136,5832,3286,0,0,0,0
4890,GUNTUR,Nuzendla,PATHACHERUVUKOMMUPALEM,173,0,346,519,14,0,32,46,41,280,0,634,914,453,0,0,0,0
4891,GUNTUR,Nuzendla,PATHAZADDAVARIPALEM,92,2,127,221,31,0,14,45,45,240,0,280,520,314,0,0,0,0
4892,GUNTUR,Nuzendla,PEDDAVARAM,75,2,99,176,36,1,65,102,97,491,10,995,1496,762,0,0,0,0
4893,GUNTUR,Nuzendla,PUTCHANUTHALA,317,202,1055,1574,38,16,462,516,440,652,334,19587,20573,9914,0,0,18,18
4894,GUNTUR,Nuzendla,PUVVADA,361,1,761,1123,177,0,446,623,689,6328,0,12920,19248,11236,6,0,4,10
4895,GUNTUR,Nuzendla,TALARLAPALLI,189,2,689,880,129,0,431,560,541,4473,0,11996,16469,10083,6,0,3,9
4896,GUNTUR,Nuzendla,TELLABADU,32,0,329,361,12,0,189,201,197,211,0,9444,9655,5171,0,0,29,29
4897,GUNTUR,Nuzendla,THIMMAPURAM,41,1,606,648,24,0,433,457,329,215,0,12743,12958,5878,0,0,7,7
4898,GUNTUR,Nuzendla,TRIPURAPURAM,125,1,149,275,112,0,110,222,214,5215,0,4705,9920,5360,1,0,0,1
4899,GUNTUR,Nuzendla,UPPALAPADU,192,27,331,550,117,6,197,320,308,1961,46,3677,5684,3137,0,0,0,0
4900,GUNTUR,Nuzendla,V.APPAPURAM,194,6,331,531,1,1,68,70,59,20,20,1373,1413,724,0,0,0,0
4901,GUNTUR,Pedakakani,AGATHAVARAPPADU,48,19,252,319,0,0,0,0,0,0,0,0,0,0,0,0,0,0
4902,GUNTUR,Pedakakani,ANUMARLAPUDI,86,0,213,299,22,0,6,28,25,963,0,250,1213,667,0,0,1,1
4903,GUNTUR,Pedakakani,GOLLAMUDI,3,3,171,177,2,1,93,96,68,40,20,2309,2369,1113,0,0,0,0
4904,GUNTUR,Pedakakani,KOPPURAVURU,105,57,571,733,1,25,42,68,67,2,1370,2067,3439,2132,0,1,0,1
4905,GUNTUR,Pedakakani,NAMBUR,1389,53,1569,3011,353,11,189,553,533,5855,116,2751,8722,5727,0,0,0,0
4906,GUNTUR,Pedakakani,PEDA KAKANI,1181,160,1687,3028,52,67,103,222,202,1179,3537,1923,6639,3533,1,6,0,7
4907,GUNTUR,Pedakakani,RAMACHANDARAPALEM,1,0,106,107,0,0,42,42,35,0,0,1397,1397,843,0,0,1,1
4908,GUNTUR,Pedakakani,TANGELLAMUDI,242,0,17,259,107,0,3,110,95,3013,0,41,3054,1789,0,0,0,0
4909,GUNTUR,Pedakakani,THAKKELLAPADU  (R),495,89,225,809,136,6,41,183,148,3852,62,645,4559,2818,2,0,0,2
4910,GUNTUR,Pedakakani,UPPALAPADU,369,59,711,1139,75,7,159,241,209,1741,305,5016,7062,3859,0,0,4,4
4911,GUNTUR,Pedakakani,VENIGANDLA,293,160,276,729,123,27,2,152,160,3260,679,22,3961,2699,0,0,0,0
4912,GUNTUR,Pedakakani,VENKATA KRISHNA PURA,67,19,449,535,39,11,216,266,258,1113,267,3908,5288,2812,0,0,0,0
4913,GUNTUR,Pedakurapadu,75 TYALLUR,408,67,712,1187,222,2,254,478,354,8338,65,6706,15109,7102,1,0,0,1
4914,GUNTUR,Pedakurapadu,ABBARAJUPALEM,4,47,322,373,3,22,188,213,168,120,505,10536,11161,5022,0,0,24,24
4915,GUNTUR,Pedakurapadu,BALUSUPADU,189,47,416,652,107,14,169,290,193,3846,279,7627,11752,3493,3,0,7,10
4916,GUNTUR,Pedakurapadu,BYTCHAYYAPALEM,1,0,168,169,0,0,105,105,85,0,0,4294,4294,1907,0,0,2,2
4917,GUNTUR,Pedakurapadu,CHINNAMAKKENA,1,59,201,261,0,20,114,134,122,0,854,5102,5956,2639,0,0,6,6
4918,GUNTUR,Pedakurapadu,GARAPADU,86,101,573,760,23,51,282,356,242,492,1419,7083,8994,3521,0,0,4,4
4919,GUNTUR,Pedakurapadu,HUSSAINNAGARAM,88,30,432,550,54,13,272,339,290,2433,398,9758,12589,5019,0,0,4,4
4920,GUNTUR,Pedakurapadu,JALALPURAM,197,11,341,549,116,4,155,275,241,4143,161,5702,10006,5313,0,0,1,1
4921,GUNTUR,Pedakurapadu,KAMBHAMPADU,161,74,339,574,87,54,117,258,212,2968,1737,3915,8620,3611,0,1,1,2
4922,GUNTUR,Pedakurapadu,KANNEGANDLA,42,0,193,235,20,0,79,99,54,977,0,3114,4091,1718,0,0,3,3
4923,GUNTUR,Pedakurapadu,KASIPADU,187,43,343,573,99,35,184,318,188,3151,1447,4359,8957,3634,0,0,0,0
4924,GUNTUR,Pedakurapadu,LAGADAPADU,435,20,467,922,254,13,99,366,339,12123,563,2453,15139,7454,18,0,0,18
4925,GUNTUR,Pedakurapadu,LINGAMGUNTLA,324,42,307,673,199,19,141,359,290,6020,615,4558,11193,5319,7,0,0,7
4926,GUNTUR,Pedakurapadu,MUSSAPURAM,233,7,239,479,22,0,13,35,34,301,0,250,551,328,0,0,0,0
4927,GUNTUR,Pedakurapadu,PARASA,70,0,202,272,43,0,92,135,81,2588,0,4106,6694,2588,3,0,6,9
4928,GUNTUR,Pedakurapadu,PATIBANDLA,580,60,496,1136,301,34,85,420,391,10069,654,2179,12902,7339,2,0,1,3
4929,GUNTUR,Pedakurapadu,PEDAKURAPADU,699,14,1717,2430,262,1,103,366,341,9052,20,1806,10878,5866,2,0,0,2
4930,GUNTUR,Pedakurapadu,PODAPADU,207,1,260,468,138,0,40,178,185,7598,0,1066,8664,4478,15,0,0,15
4931,GUNTUR,Pedakurapadu,RAMAPURAM,149,10,189,348,99,9,96,204,196,3615,238,3062,6915,3265,2,0,1,3
4932,GUNTUR,Pedakurapadu,THAMMAVARAM,94,5,356,455,39,1,175,215,171,1335,36,5286,6657,2961,2,0,3,5
4933,GUNTUR,Pedanandipadu,ABBINENI GUNTAPALEM,256,18,416,690,126,5,85,216,189,4267,83,2784,7134,4298,2,0,4,6
4934,GUNTUR,Pedanandipadu,ANNAPARRU,290,15,226,531,147,0,2,149,147,5257,0,40,5297,3243,5,0,0,5
4935,GUNTUR,Pedanandipadu,ANNAVARAM,332,14,132,478,49,5,20,74,69,606,44,527,1177,705,0,0,0,0
4936,GUNTUR,Pedanandipadu,GOGULAMUDI,103,51,280,434,24,18,1,43,40,453,309,12,774,439,0,0,0,0
4937,GUNTUR,Pedanandipadu,GORIJAVOLUGUNTAPALEM,40,22,299,361,4,7,14,25,25,80,140,278,498,272,0,0,0,0
4938,GUNTUR,Pedanandipadu,KATRAPADU,286,8,237,531,144,4,62,210,181,7387,104,2736,10227,4985,16,0,2,18
4939,GUNTUR,Pedanandipadu,KOPPARRU,375,0,380,755,160,0,35,195,152,7983,0,700,8683,3086,14,0,0,14
4940,GUNTUR,Pedanandipadu,NAGULAPADU,383,99,280,762,244,6,64,314,307,10938,57,2850,13845,8274,13,0,0,13
4941,GUNTUR,Pedanandipadu,PALAPARRU,352,16,182,550,28,0,1,29,29,565,0,20,585,317,0,0,0,0
4942,GUNTUR,Pedanandipadu,PAMIDIVARIPALEM,174,19,155,348,84,0,77,161,144,2420,0,1697,4117,2205,4,0,0,4
4943,GUNTUR,Pedanandipadu,PEDANANDIPADU,388,20,720,1128,199,2,184,385,368,7918,149,6974,15041,9536,11,0,8,19
4944,GUNTUR,Pedanandipadu,PUSULUR,100,104,406,610,16,1,17,34,33,328,20,338,686,404,0,0,0,0
4945,GUNTUR,Pedanandipadu,RAJUPALEM,118,13,117,248,65,2,13,80,71,2079,69,260,2408,1261,0,0,0,0
4946,GUNTUR,Pedanandipadu,RAVIPADU,135,7,240,382,70,0,9,79,78,1339,0,176,1515,822,0,0,0,0
4947,GUNTUR,Pedanandipadu,UPPALAPADU,361,5,536,902,164,1,99,264,256,5521,29,1565,7115,5045,8,0,0,8
4948,GUNTUR,Pedanandipadu,VARAGANI,404,42,444,890,161,2,36,199,177,7520,40,1220,8780,5477,6,0,1,7
4949,GUNTUR,Phirangipuram,113 THALLURU,328,1,452,781,200,0,123,323,298,7311,0,5634,12945,6868,7,0,4,11
4950,GUNTUR,Phirangipuram,AMEENABAD,335,52,764,1151,45,12,86,143,140,812,162,1615,2589,1605,0,0,0,0
4951,GUNTUR,Phirangipuram,BETHAPUDI,139,2,705,846,43,0,238,281,186,1128,0,7550,8678,3164,0,0,2,2
4952,GUNTUR,Phirangipuram,ERRAGUNTLA PADU,113,40,344,497,59,21,100,180,172,1995,479,2548,5022,2666,0,0,0,0
4953,GUNTUR,Phirangipuram,GOLLAPALEM,435,21,90,546,298,6,64,368,350,12080,466,4530,17076,10717,22,2,24,48
4954,GUNTUR,Phirangipuram,GUNDALAPADU,296,18,384,698,174,4,80,258,254,4751,167,2777,7695,4251,3,0,3,6
4955,GUNTUR,Phirangipuram,HOUSUEGANESH,58,0,154,212,16,0,31,47,48,292,0,411,703,445,0,0,0,0
4956,GUNTUR,Phirangipuram,KANDRIKA,199,4,260,463,126,2,125,253,255,3558,40,3239,6837,3698,1,0,0,1
4957,GUNTUR,Phirangipuram,MERIKA PUDI,163,35,255,453,46,10,66,122,105,799,250,2651,3700,1853,0,0,3,3
4958,GUNTUR,Phirangipuram,MUNAGA PADU,127,0,550,677,32,0,170,202,165,710,0,5723,6433,3401,0,0,3,3
4959,GUNTUR,Phirangipuram,NUDURUPADU,172,5,480,657,110,0,136,246,217,3755,0,4214,7969,4330,0,0,1,1
4960,GUNTUR,Phirangipuram,PHIRANGIPURAM,798,169,624,1591,169,40,125,334,312,3278,1122,4115,8515,5131,0,0,0,0
4961,GUNTUR,Phirangipuram,PONUGUPADU,657,22,447,1126,278,12,55,345,216,8321,289,740,9350,3310,1,0,0,1
4962,GUNTUR,Phirangipuram,REPUDI,72,0,82,154,40,0,10,50,50,1820,0,141,1961,1355,3,0,0,3
4963,GUNTUR,Phirangipuram,SIRANGIPALEM,181,2,205,388,139,0,46,185,153,6806,0,1737,8543,4399,11,0,2,13
4964,GUNTUR,Phirangipuram,TAKKELLA PADU,112,28,476,616,22,13,136,171,133,338,326,3744,4408,2186,0,0,0,0
4965,GUNTUR,Phirangipuram,VEMAVARAM,151,14,237,402,106,11,151,268,231,3803,52,4107,7962,4151,1,0,0,1
4966,GUNTUR,Piduguralla,BRAHMANAPALLI,413,65,974,1452,147,8,284,439,390,3304,124,7128,10556,7710,2,0,6,8
4967,GUNTUR,Piduguralla,CHENNAYAPALEM,99,30,330,459,54,15,204,273,259,2880,846,7753,11479,7293,4,3,1,8
4968,GUNTUR,Piduguralla,CHINAAGRAHARAM,21,0,373,394,11,0,217,228,239,800,0,9850,10650,6938,1,0,20,21
4969,GUNTUR,Piduguralla,GUTHIKONDA,362,382,1298,2042,46,90,369,505,463,1110,1683,8184,10977,6685,1,0,2,3
4970,GUNTUR,Piduguralla,JANAPADU,795,119,1543,2457,155,30,380,565,511,3140,1007,6717,10864,7614,1,2,2,5
4971,GUNTUR,Piduguralla,JULLAKALLU,385,70,1353,1808,127,18,471,616,515,1843,384,11410,13637,9413,0,0,4,4
4972,GUNTUR,Piduguralla,KAMEPALLI,106,31,412,549,65,21,223,309,292,1625,613,5917,8155,5474,0,0,2,2
4973,GUNTUR,Piduguralla,KARALAPADU,245,66,1018,1329,160,49,645,854,856,5069,1553,12176,18798,11788,0,0,3,3
4974,GUNTUR,Piduguralla,KONANKI,194,195,1040,1429,3,48,290,341,337,143,1739,6962,8844,5509,0,0,2,2
4975,GUNTUR,Piduguralla,PANDHITIVARIPALEM,15,18,780,813,5,11,387,403,387,104,339,10777,11220,6718,0,0,3,3
4976,GUNTUR,Piduguralla,PATHAGANESWARAPADU,93,57,289,439,12,23,115,150,116,180,410,1165,1755,1015,0,0,0,0
4977,GUNTUR,Piduguralla,PEDAAGRAHARAM,48,0,387,435,31,0,204,235,221,1648,0,8410,10058,6276,3,0,11,14
4978,GUNTUR,Piduguralla,THUMMALACHERUVU,358,32,1084,1474,59,21,337,417,383,964,770,9539,11273,6897,0,0,2,2
4979,GUNTUR,Piduguralla,VEERAPURAM,87,32,737,856,0,0,13,13,9,0,0,136,136,76,0,0,0,0
4980,GUNTUR,Pittalavanipalem,ALAKAPURAM,145,60,51,256,120,8,19,147,145,6730,226,671,7627,3584,12,0,0,12
4981,GUNTUR,Pittalavanipalem,ALLUR,208,69,344,621,140,10,114,264,173,3621,200,4887,8708,3621,0,0,3,3
4982,GUNTUR,Pittalavanipalem,BHAVANAMVARIPALEM,286,23,411,720,200,17,215,432,412,5377,558,5700,11635,5968,0,0,0,0
4983,GUNTUR,Pittalavanipalem,CHANDOLE,395,94,511,1000,194,26,94,314,238,5336,1690,1818,8844,4579,2,7,1,10
4984,GUNTUR,Pittalavanipalem,G.N.PALEM,12,38,672,722,8,1,367,376,332,496,42,11309,11847,5895,2,0,1,3
4985,GUNTUR,Pittalavanipalem,KHAJIPALEM,389,15,373,777,278,3,118,399,332,7346,58,2850,10254,5649,0,0,0,0
4986,GUNTUR,Pittalavanipalem,KODURU,45,37,94,176,30,32,9,71,67,1915,2555,532,5002,2775,0,11,0,11
4987,GUNTUR,Pittalavanipalem,KOMALI,103,32,151,286,77,21,79,177,149,4255,1418,3178,8851,3824,7,2,2,11
4988,GUNTUR,Pittalavanipalem,KOTHAPALEM,47,0,400,447,39,0,282,321,290,1183,0,11880,13063,5769,0,0,14,14
4989,GUNTUR,Pittalavanipalem,MANTHENAVARIPALEM,220,0,333,553,74,0,121,195,37,3238,0,4982,8220,528,3,0,2,5
4990,GUNTUR,Pittalavanipalem,PITTALAVANIPALEM,101,33,599,733,35,1,284,320,70,1698,57,13577,15332,810,1,0,5,6
4991,GUNTUR,Pittalavanipalem,PITTALAVARIPALEM,0,0,375,375,0,0,167,167,37,0,0,4054,4054,394,0,0,0,0
4992,GUNTUR,Pittalavanipalem,POTHANAKATTAVARIPALEM,4,37,366,407,1,13,275,289,266,29,363,9705,10097,5644,0,0,1,1
4993,GUNTUR,Pittalavanipalem,SANGUPALEM,141,8,393,542,73,5,206,284,270,2769,49,6326,9144,5188,1,0,0,1
4994,GUNTUR,Ponnur,ALURU,138,24,192,354,94,3,8,105,120,3609,60,160,3829,2091,0,0,0,0
4995,GUNTUR,Ponnur,AREMANDA,38,52,377,467,29,10,122,161,150,760,263,2166,3189,1811,0,0,0,0
4996,GUNTUR,Ponnur,BRAHMANA KODUR,385,27,337,749,224,4,127,355,327,6368,84,3999,10451,5835,2,0,0,2
4997,GUNTUR,Ponnur,CHINAITIKAMPADU,86,14,261,361,69,6,210,285,241,2408,84,6840,9332,4257,0,0,1,1
4998,GUNTUR,Ponnur,CHINTALAPUDI,215,80,181,476,23,12,18,53,51,472,320,360,1152,578,0,0,0,0
4999,GUNTUR,Ponnur,DANDAMUDI,150,29,229,408,103,3,56,162,136,5410,65,1746,7221,3574,9,0,0,9
5000,GUNTUR,Ponnur,DOPPALAPUDI,267,93,260,620,164,38,121,323,301,6007,1808,4309,12124,6136,2,0,0,2
5001,GUNTUR,Ponnur,GAYAMVARIPALEM,37,1,198,236,29,1,110,140,123,727,6,2142,2875,1501,0,0,0,0
5002,GUNTUR,Ponnur,GOLLAMUDIPADU,133,7,213,353,77,2,131,210,197,2496,22,4768,7286,3884,0,0,0,0
5003,GUNTUR,Ponnur,JADAVALLI,137,9,43,189,103,6,36,145,141,6104,488,2550,9142,5598,11,1,7,19
5004,GUNTUR,Ponnur,JUPUDI,286,5,201,492,100,1,95,196,181,2096,72,2965,5133,2668,0,0,1,1
5005,GUNTUR,Ponnur,KASUKARRU,297,24,497,818,58,3,192,253,200,914,55,3229,4198,2300,0,0,0,0
5006,GUNTUR,Ponnur,KATTEMPUDI,139,7,269,415,66,1,61,128,132,2590,20,1708,4318,2295,1,0,0,1
5007,GUNTUR,Ponnur,KONDAMUDI,206,7,145,358,129,0,35,164,147,5222,0,916,6138,3195,4,0,0,4
5008,GUNTUR,Ponnur,MACHAVARAM,387,20,295,702,188,1,40,229,192,7197,20,1209,8426,3902,6,0,0,6
5009,GUNTUR,Ponnur,MAMILLAPALLI,424,68,562,1054,157,0,34,191,169,4127,0,578,4705,2708,3,0,0,3
5010,GUNTUR,Ponnur,MANNAVA,460,17,108,585,251,12,11,274,232,12075,397,205,12677,6590,15,0,0,15
5011,GUNTUR,Ponnur,MULUKUDURU,203,33,567,803,78,1,181,260,246,1880,20,3858,5758,3137,0,0,0,0
5012,GUNTUR,Ponnur,MUNIPALLE,249,33,187,469,174,15,44,233,217,11023,284,1206,12513,6827,35,0,1,36
5013,GUNTUR,Ponnur,NANDUR,330,6,680,1016,81,1,300,382,361,1700,30,6156,7886,4117,0,0,1,1
5014,GUNTUR,Ponnur,PATCHALA TADIPARRU,213,7,61,281,88,0,1,89,86,5203,0,23,5226,2764,13,0,0,13
5015,GUNTUR,Ponnur,PEDAITIKAMPADU,195,14,117,326,112,6,15,133,125,4337,206,516,5059,3131,0,0,0,0
5016,GUNTUR,Ponnur,PEDAPALEM,247,26,197,470,170,0,113,283,280,9225,0,5972,15197,7537,6,0,5,11
5017,GUNTUR,Ponnur,SITARAMA PURAM,50,0,173,223,11,0,46,57,54,187,0,916,1103,598,0,0,0,0
5018,GUNTUR,Ponnur,TALLAPALEM,112,0,73,185,55,0,27,82,71,1939,0,642,2581,1569,1,0,0,1
5019,GUNTUR,Ponnur,UPPARAPALEM,118,38,684,840,66,15,463,544,557,2013,696,11757,14466,7401,0,0,1,1
5020,GUNTUR,Ponnur,VADDEMUKKALA,125,6,348,479,87,3,183,273,211,2617,28,4483,7128,3836,0,0,1,1
5021,GUNTUR,Ponnur,VALLABHARAOPALEM,156,63,137,356,13,1,2,16,12,93,20,22,135,65,0,0,0,0
5022,GUNTUR,Ponnur,VELLALUR,68,14,363,445,37,0,70,107,100,692,0,1153,1845,964,0,0,0,0
5023,GUNTUR,Prathipadu,CHINAKONDRUPADU,0,0,0,0,0,0,0,0,0,0,0,0,0,0,0,0,0,0
5024,GUNTUR,Prathipadu,EDULAPALEM,141,0,8,149,8,0,0,8,8,160,0,0,160,79,0,0,0,0
5025,GUNTUR,Prathipadu,ENAMADALA,277,39,700,1016,27,0,48,75,75,544,0,898,1442,822,0,0,0,0
5026,GUNTUR,Prathipadu,GANIKAPUDI,155,5,332,492,90,0,64,154,132,1893,0,1048,2941,1590,0,0,0,0
5027,GUNTUR,Prathipadu,GOTTIPADU,793,128,874,1795,121,5,16,142,136,1709,70,214,1993,1127,0,0,0,0
5028,GUNTUR,Prathipadu,KONDEPADU,193,5,243,441,38,0,7,45,45,708,0,140,848,464,0,0,0,0
5029,GUNTUR,Prathipadu,KOTHAMALLAYAPALEM,1,12,329,342,1,0,39,40,32,8,0,772,780,426,0,0,0,0
5030,GUNTUR,Prathipadu,KOYAVARIPALEM,115,65,336,516,53,7,16,76,72,3195,116,285,3596,1949,14,0,0,14
5031,GUNTUR,Prathipadu,MALLAYAPALEM,209,44,607,860,101,5,32,138,136,4254,100,691,5045,2695,1,0,0,1
5032,GUNTUR,Prathipadu,MEDAVARIPALEM,45,0,120,165,27,0,72,99,94,484,0,1029,1513,936,0,0,0,0
5033,GUNTUR,Prathipadu,NADIMPALEM,376,17,809,1202,46,0,80,126,118,1137,0,2347,3484,1974,0,0,1,1
5034,GUNTUR,Prathipadu,NIMMAGADDAVARIPALEM,31,24,63,118,15,4,1,20,20,386,62,36,484,298,0,0,0,0
5035,GUNTUR,Prathipadu,PRATHIPADU,1057,142,1418,2617,125,3,128,256,225,2946,60,2129,5135,2871,0,0,0,0
5036,GUNTUR,Prathipadu,THUMMALAPALEM,88,1,103,192,21,0,1,22,23,432,0,20,452,276,0,0,0,0
5037,GUNTUR,Prathipadu,TIKKIREDDIPALEM,398,19,195,612,40,3,28,71,53,1282,156,1380,2818,1208,2,0,2,4
5038,GUNTUR,Prathipadu,VANGIPURAM,513,1,623,1137,120,0,239,359,320,1618,0,6273,7891,3811,0,0,1,1
5039,GUNTUR,Rajupalem,ANCHULAVARIPALEM,48,24,595,667,31,17,279,327,314,1359,592,7417,9368,4998,2,0,5,7
5040,GUNTUR,Rajupalem,BALIJEPALLI,149,35,430,614,108,9,188,305,292,3419,128,4311,7858,4077,1,0,0,1
5041,GUNTUR,Rajupalem,BEERAVALLIPAYA,39,6,151,196,13,3,46,62,51,211,60,694,965,482,0,0,0,0
5042,GUNTUR,Rajupalem,BRAHMANAPALLI,33,0,428,461,16,0,203,219,219,281,0,5182,5463,2818,0,0,1,1
5043,GUNTUR,Rajupalem,CHOWTAPAPAYAPALEM,100,51,388,539,18,8,157,183,175,350,144,4714,5208,2976,0,0,4,4
5044,GUNTUR,Rajupalem,DEVARAMPADU,158,23,233,414,55,10,109,174,153,899,204,2595,3698,1877,0,0,0,0
5045,GUNTUR,Rajupalem,GANAPAVARAM,409,134,799,1342,132,56,194,382,359,1956,1104,5333,8393,4562,0,0,0,0
5046,GUNTUR,Rajupalem,INUMETLA,298,2,597,897,107,1,239,347,326,2139,9,4440,6588,3238,0,0,0,0
5047,GUNTUR,Rajupalem,KOTA NEMALIPURI,369,103,1079,1551,101,6,143,250,236,1301,83,2400,3784,2535,0,0,0,0
5048,GUNTUR,Rajupalem,KOTHAPALEM,12,2,396,410,5,0,238,243,238,144,0,6336,6480,3269,0,0,1,1
5049,GUNTUR,Rajupalem,KUBADPURAM,164,100,1085,1349,84,51,542,677,654,1876,1127,10153,13156,7846,0,0,1,1
5050,GUNTUR,Rajupalem,MOKKAPADU,108,30,452,590,72,19,269,360,357,2647,540,12709,15896,7455,0,0,19,19
5051,GUNTUR,Rajupalem,NEMALIPURI,200,54,877,1131,142,4,291,437,416,3865,80,8763,12708,6504,0,0,14,14
5052,GUNTUR,Rajupalem,RAJUPALEM,168,152,414,734,91,37,206,334,320,3098,1322,7514,11934,7232,2,2,3,7
5053,GUNTUR,Rajupalem,REDDIGUDEM,64,68,591,723,13,28,232,273,240,260,856,8307,9423,4554,0,2,10,12
5054,GUNTUR,Rajupalem,UPPALAPADU,137,163,569,869,74,83,241,398,401,1538,1930,6887,10355,5546,0,0,1,1
5055,GUNTUR,Rentacrintala,GOLI,124,175,384,683,78,56,174,308,296,2517,1350,5177,9044,5074,1,0,1,2
5056,GUNTUR,Rentacrintala,JETHIPALAM,100,204,780,1084,7,109,213,329,321,143,3928,6638,10709,6877,0,4,4,8
5057,GUNTUR,Rentacrintala,MALLAVARAM,54,214,476,744,38,121,245,404,387,2542,4770,10024,17336,9214,8,10,21,39
5058,GUNTUR,Rentacrintala,MANCHIKALLU,339,51,982,1372,124,17,524,665,599,1310,271,6471,8052,4995,0,0,0,0
5059,GUNTUR,Rentacrintala,MITTAGUDIPADU,108,10,652,770,66,1,377,444,388,2153,12,11170,13335,7167,0,0,2,2
5060,GUNTUR,Rentacrintala,PALUVOI,261,168,919,1348,172,98,543,813,791,5337,3301,8550,17188,9017,0,0,0,0
5061,GUNTUR,Rentacrintala,PALVVOI RAILWAY GATE,64,36,580,680,33,11,213,257,216,899,404,7914,9217,5154,0,0,6,6
5062,GUNTUR,Rentacrintala,PASARLAPADU,288,78,650,1016,173,55,349,577,514,6639,1277,8949,16865,10124,7,0,1,8
5063,GUNTUR,Rentacrintala,RENTACHINTALA,835,234,2112,3181,229,49,339,617,592,7254,1410,8023,16687,9781,2,1,0,3
5064,GUNTUR,Rentacrintala,RENTALA,311,90,1270,1671,205,67,821,1093,1015,7072,1306,16759,25137,13077,0,0,0,0
5065,GUNTUR,Rentacrintala,THUMRUKOTA,552,117,1500,2169,279,65,831,1175,1113,6639,1265,18901,26805,14221,6,0,1,7
5066,GUNTUR,Repalle,ARAVAPALLI,99,0,338,437,34,0,99,133,118,525,0,2397,2922,1803,0,0,0,0
5067,GUNTUR,Repalle,BETHAPUDI,426,1,498,925,106,0,3,109,102,1755,0,60,1815,1007,0,0,0,0
5068,GUNTUR,Repalle,BONDALAGARUVU,11,6,164,181,6,3,113,122,84,333,105,5655,6093,2378,0,0,3,3
5069,GUNTUR,Repalle,CHATRAGADDA,145,1,392,538,58,0,154,212,199,857,0,2998,3855,2102,0,0,0,0
5070,GUNTUR,Repalle,CHENNUPALLIVARIPALEM,27,5,290,322,18,0,186,204,176,307,0,5472,5779,2748,0,0,0,0
5071,GUNTUR,Repalle,CHODAYAPALEM,407,2,13,422,151,0,1,152,108,2233,0,20,2253,988,0,0,0,0
5072,GUNTUR,Repalle,GANGADIPALEM,15,0,897,912,13,0,536,549,510,392,0,12432,12824,6473,0,0,1,1
5073,GUNTUR,Repalle,GUDDIKAYALANKA,0,19,673,692,0,16,374,390,363,0,370,8720,9090,4824,0,0,0,0
5074,GUNTUR,Repalle,KAITHEPALLI,109,15,265,389,80,12,182,274,213,3748,298,6651,10697,5016,3,0,3,6
5075,GUNTUR,Repalle,KAMARAJUGADDA(NORTH),26,0,263,289,20,0,180,200,186,720,0,6483,7203,3799,0,0,0,0
5076,GUNTUR,Repalle,KAMARAJUGADDA(SOUTH),112,0,131,243,71,0,74,145,131,1264,0,1436,2700,1431,0,0,0,0
5077,GUNTUR,Repalle,KARUMURU,149,35,481,665,70,1,109,180,162,1176,3,1351,2530,1360,0,0,0,0
5078,GUNTUR,Repalle,LANKEVANIDIBBA,1,70,728,799,0,1,475,476,442,0,20,9462,9482,5142,0,0,0,0
5079,GUNTUR,Repalle,MOLLAGUNTA,99,13,586,698,55,7,353,415,380,1277,179,6852,8308,4515,0,0,0,0
5080,GUNTUR,Repalle,MORLAVARIPALEM,0,0,479,479,0,0,245,245,231,0,0,2443,2443,1277,0,0,0,0
5081,GUNTUR,Repalle,NALLURIPALEM,490,62,170,722,305,29,32,366,323,11432,306,501,12239,6145,1,0,0,1
5082,GUNTUR,Repalle,NALLURU(NORTH),0,11,301,312,0,0,145,145,132,0,0,3617,3617,2435,0,0,2,2
5083,GUNTUR,Repalle,NALLURU(S),275,0,1,276,140,0,0,140,125,3599,0,0,3599,2007,0,0,0,0
5084,GUNTUR,Repalle,PENUMUDI,231,9,641,881,82,0,42,124,117,1404,0,723,2127,1183,0,0,0,0
5085,GUNTUR,Repalle,PETERU,503,15,1044,1562,236,2,302,540,522,3627,40,4385,8052,4913,0,0,0,0
5086,GUNTUR,Repalle,PIRATLANKA,128,14,338,480,91,9,247,347,272,2044,343,3442,5829,2814,0,0,0,0
5087,GUNTUR,Repalle,POTUMERAKA,59,18,511,588,26,0,141,167,108,366,0,1206,1572,675,0,0,0,0
5088,GUNTUR,Repalle,RAJUKALVA,115,17,319,451,64,11,116,191,168,1945,380,4117,6442,3199,0,0,0,0
5089,GUNTUR,Repalle,SINGUPALEM,135,0,97,232,96,0,53,149,110,3560,0,2440,6000,3039,4,0,12,16
5090,GUNTUR,Repalle,THUMMALA,66,266,529,861,40,31,287,358,182,1512,2311,8054,11877,4047,0,12,3,15
5091,GUNTUR,Repalle,UPPUDI,373,18,478,869,234,8,104,346,319,5387,114,2177,7678,5138,0,0,0,0
5092,GUNTUR,Repalle,VADDEVARIPALEM,1,1,258,260,0,0,178,178,143,0,0,10670,10670,4172,0,0,21,21
5093,GUNTUR,Repalle,VISWESWARAM,66,5,176,247,49,0,138,187,161,1489,0,4946,6435,3144,0,0,0,0
5094,GUNTUR,Rompicherla,ALAVALA,217,5,313,535,99,3,79,181,155,4506,151,3181,7838,3602,2,0,2,4
5095,GUNTUR,Rompicherla,ANNAVARAM,321,10,393,724,52,1,37,90,91,1572,54,1154,2780,1589,2,0,2,4
5096,GUNTUR,Rompicherla,ANNAVARAPPADU,31,13,176,220,9,1,76,86,74,104,5,954,1063,539,0,0,0,0
5097,GUNTUR,Rompicherla,AREPALLI,144,0,265,409,65,0,109,174,181,1391,0,4596,5987,3194,1,0,6,7
5098,GUNTUR,Rompicherla,ATCHAIAHPALEM,0,29,215,244,0,20,131,151,139,0,1383,9482,10865,5745,0,8,47,55
5099,GUNTUR,Rompicherla,BUTCHIPAPANNAPALEM,92,64,498,654,0,13,152,165,140,0,194,3533,3727,1897,0,0,1,1
5100,GUNTUR,Rompicherla,EDVERDPETA,35,1,222,258,22,1,130,153,159,211,4,1607,1822,900,0,0,0,0
5101,GUNTUR,Rompicherla,GOGULAPADU,317,72,333,722,92,1,58,151,159,1263,19,1507,2789,1552,0,0,0,0
5102,GUNTUR,Rompicherla,KARLAKUNTA,88,8,159,255,0,6,65,71,86,0,93,2789,2882,1431,0,0,9,9
5103,GUNTUR,Rompicherla,KONAKANCHEVARIPALEM,170,5,242,417,84,0,74,158,154,3458,0,3307,6765,3915,3,0,3,6
5104,GUNTUR,Rompicherla,KOTHAPALLI,262,184,380,826,0,0,48,48,45,0,0,1276,1276,670,0,0,0,0
5105,GUNTUR,Rompicherla,MACHAVARAM,291,55,615,961,171,24,356,551,487,4211,287,4885,9383,5169,1,0,0,1
5106,GUNTUR,Rompicherla,MUNAMAKA,187,4,266,457,95,2,144,241,217,1053,19,2135,3207,1845,0,0,0,0
5107,GUNTUR,Rompicherla,MUTHANAPALLI,171,6,161,338,101,3,83,187,161,1563,29,2412,4004,2028,0,0,0,0
5108,GUNTUR,Rompicherla,NALLAGARLAPADU,146,5,295,446,106,5,194,305,312,2138,71,2008,4217,2715,0,0,0,0
5109,GUNTUR,Rompicherla,PARAGATICHERLA,90,41,385,516,37,18,182,237,219,596,309,3978,4883,2848,0,0,0,0
5110,GUNTUR,Rompicherla,RAMIREDDYPALEM,45,65,247,357,0,0,43,43,36,0,0,316,316,149,0,0,0,0
5111,GUNTUR,Rompicherla,REDDYPALEM,446,160,931,1537,67,0,30,97,82,470,0,326,796,468,0,0,0,0
5112,GUNTUR,Rompicherla,ROMPICHERLA,230,38,997,1265,1,3,224,228,202,36,47,5942,6025,3843,0,0,0,0
5113,GUNTUR,Rompicherla,SANTHAGUDIPADU,391,143,753,1287,180,67,188,435,399,3255,1141,3222,7618,3811,1,0,0,1
5114,GUNTUR,Rompicherla,SUBBAIAHPALEM,20,82,136,238,0,0,40,40,39,0,0,948,948,573,0,0,0,0
5115,GUNTUR,Rompicherla,THURUMELLA,131,0,409,540,42,0,153,195,172,803,0,3741,4544,2041,0,0,2,2
5116,GUNTUR,Rompicherla,TUNGAPADU,87,0,192,279,12,0,107,119,107,143,0,2827,2970,1839,0,0,0,0
5117,GUNTUR,Rompicherla,VADLAMUDIVARIPALEM,200,62,365,627,44,13,26,83,83,425,142,297,864,485,0,0,0,0
5118,GUNTUR,Rompicherla,VEERAVATNAM,118,3,398,519,0,0,24,24,18,0,0,772,772,315,0,0,0,0
5119,GUNTUR,Rompicherla,VIPARLAPALLI,132,21,288,441,52,0,128,180,147,682,0,2762,3444,1867,0,0,0,0
5120,GUNTUR,Rompicherla,VIPPARLA,198,63,682,943,103,21,345,469,459,1323,426,3442,5191,2880,0,0,0,0
5121,GUNTUR,Sattenapalle,ABBUR,248,60,325,633,95,28,141,264,124,1979,532,4700,7211,1903,0,0,2,2
5122,GUNTUR,Sattenapalle,BHATLUR,234,48,163,445,179,40,80,299,290,8200,1780,2361,12341,6684,9,4,0,13
5123,GUNTUR,Sattenapalle,BHIMAVARAM,407,5,335,747,250,0,99,349,279,9646,0,1881,11527,5251,20,0,0,20
5124,GUNTUR,Sattenapalle,BHRUGUBANDA,184,5,471,660,25,2,125,152,105,594,12,1587,2193,863,0,0,0,0
5125,GUNTUR,Sattenapalle,DEEPALADINNEPALEM,101,1,85,187,58,0,6,64,64,1688,0,120,1808,955,0,0,0,0
5126,GUNTUR,Sattenapalle,DHULIPALLA,445,93,809,1347,231,61,398,690,619,10082,3543,15723,29348,14260,23,11,18,52
5127,GUNTUR,Sattenapalle,GANDLURU,22,0,198,220,17,0,143,160,135,1030,0,8517,9547,4727,3,0,26,29
5128,GUNTUR,Sattenapalle,GARNEPUDI,175,4,36,215,73,0,8,81,74,1259,0,68,1327,659,0,0,0,0
5129,GUNTUR,Sattenapalle,GOGULAPADU,38,0,71,109,21,0,37,58,49,488,0,1765,2253,1124,0,0,1,1
5130,GUNTUR,Sattenapalle,GORANTLA,186,5,220,411,116,1,41,158,137,8090,20,1143,9253,4291,20,0,2,22
5131,GUNTUR,Sattenapalle,GUDIPUDI,284,66,499,849,161,12,186,359,70,3256,172,6908,10336,801,0,0,3,3
5132,GUNTUR,Sattenapalle,GUJJARLAPUDI,72,1,173,246,39,0,95,134,112,795,0,1775,2570,1279,0,0,0,0
5133,GUNTUR,Sattenapalle,KANDULAVARIPALEM,149,6,360,515,79,1,154,234,212,3621,8,5583,9212,5028,9,0,4,13
5134,GUNTUR,Sattenapalle,KANKANALAPALLI,254,0,313,567,100,0,156,256,186,3609,0,6689,10298,4371,5,0,7,12
5135,GUNTUR,Sattenapalle,KANTEPUDI,203,8,104,315,119,1,38,158,147,8749,20,2096,10865,5935,47,0,7,54
5136,GUNTUR,Sattenapalle,KATTAMURU,514,3,281,798,339,0,134,473,458,18214,0,4580,22794,11067,35,0,1,36
5137,GUNTUR,Sattenapalle,KATTAVARIPALEM,254,16,124,394,114,15,49,178,92,2795,849,2200,5844,1708,0,1,1,2
5138,GUNTUR,Sattenapalle,KOMERAPUDI,516,7,673,1196,241,1,203,445,382,12012,41,7801,19854,9303,20,0,14,34
5139,GUNTUR,Sattenapalle,LAKKARAJU GARLAPADU,491,0,282,773,231,0,91,322,306,11388,0,2762,14150,7030,25,0,0,25
5140,GUNTUR,Sattenapalle,NANDIGAMA,556,91,594,1241,233,21,196,450,405,6761,569,5437,12767,6678,2,0,2,4
5141,GUNTUR,Sattenapalle,PAKALAPADU,236,2,396,634,80,2,88,170,110,3083,15,3173,6271,2203,4,0,2,6
5142,GUNTUR,Sattenapalle,PEDAMAKKENA,316,37,337,690,132,2,112,246,208,8895,40,4931,13866,6468,28,0,8,36
5143,GUNTUR,Sattenapalle,PHANIDAM,294,27,366,687,134,0,107,241,196,3631,0,1754,5385,2374,1,0,0,1
5144,GUNTUR,Sattenapalle,RENTAPALLA,409,8,563,980,155,0,233,388,319,7276,0,5128,12404,5561,21,0,1,22
5145,GUNTUR,Savalyapuram,BONDILAVARI PALEM,83,11,217,311,45,0,121,166,141,1461,0,5906,7367,4250,0,0,6,6
5146,GUNTUR,Savalyapuram,CHINAKANCHERLA,58,7,196,261,32,4,153,189,170,414,117,6611,7142,4131,0,0,4,4
5147,GUNTUR,Savalyapuram,GUNTUPALEM,8,7,341,356,3,4,207,214,210,89,126,11241,11456,6214,0,0,20,20
5148,GUNTUR,Savalyapuram,IRLAPADU,50,13,244,307,28,9,165,202,185,1068,206,7168,8442,4579,0,0,8,8
5149,GUNTUR,Savalyapuram,KANUMARLAPUDI,191,3,281,475,29,1,130,160,157,480,12,3322,3814,2966,0,0,1,1
5150,GUNTUR,Savalyapuram,KARUMANCHI,309,37,724,1070,193,3,188,384,364,5672,94,3241,9007,6470,2,0,0,2
5151,GUNTUR,Savalyapuram,KOTHALUR,211,12,308,531,91,0,64,155,157,2496,0,1145,3641,2258,0,0,0,0
5152,GUNTUR,Savalyapuram,MATHUKU MALLI,131,28,578,737,12,2,64,78,74,132,6,599,737,434,0,0,0,0
5153,GUNTUR,Savalyapuram,MUNDRU VARIPALEM,219,3,161,383,121,3,87,211,211,5035,77,3173,8285,4792,11,0,4,15
5154,GUNTUR,Savalyapuram,PITCHIKALAPALEM,196,0,261,457,116,0,193,309,286,2890,0,9808,12698,7909,0,0,7,7
5155,GUNTUR,Savalyapuram,POTLURU,302,1,503,806,87,0,134,221,238,3767,0,4194,7961,5202,6,0,0,6
5156,GUNTUR,Savalyapuram,SANAMPUDI,125,5,371,501,66,0,136,202,200,1543,0,3577,5120,2855,0,0,1,1
5157,GUNTUR,Savalyapuram,SAVALYAPURAM,140,128,536,804,43,19,186,248,212,792,795,5321,6908,4513,0,1,2,3
5158,GUNTUR,Savalyapuram,VAYYAKALLU,225,2,178,405,83,2,101,186,156,3107,94,3866,7067,3578,0,0,1,1
5159,GUNTUR,Savalyapuram,VELPURU,422,79,1209,1710,140,13,308,461,406,2269,249,5982,8500,5690,2,0,1,3
5160,GUNTUR,Tadikonda,BANDARUPALLI,155,146,294,595,84,61,42,187,173,1984,1699,1183,4866,2766,0,1,1,2
5161,GUNTUR,Tadikonda,BEJATHPURAM,74,0,268,342,22,0,95,117,70,744,0,2969,3713,1475,0,0,0,0
5162,GUNTUR,Tadikonda,DAMARAPALLI,146,4,189,339,70,1,63,134,129,2469,20,2834,5323,3643,1,0,5,6
5163,GUNTUR,Tadikonda,GARIKAPADU,196,0,330,526,109,0,162,271,226,3815,0,4979,8794,4796,2,0,0,2
5164,GUNTUR,Tadikonda,KANTHERU,350,49,238,637,72,12,19,103,93,1261,270,327,1858,1064,0,0,0,0
5165,GUNTUR,Tadikonda,LACHANNAGUDIPADU,179,16,144,339,108,4,23,135,107,6392,78,784,7254,4090,12,0,0,12
5166,GUNTUR,Tadikonda,LAM,360,4,541,905,160,1,67,228,218,6332,20,2631,8983,7197,4,0,3,7
5167,GUNTUR,Tadikonda,MOTHADAKA,275,51,381,707,102,10,31,143,120,2671,237,818,3726,1883,2,1,0,3
5168,GUNTUR,Tadikonda,MUKKAMALA,28,5,312,345,23,3,206,232,169,1456,115,8940,10511,3724,0,0,3,3
5169,GUNTUR,Tadikonda,NIDUMUKKALA,483,18,278,779,145,1,11,157,138,3219,6,124,3349,2570,0,0,0,0
5170,GUNTUR,Tadikonda,PAMULAPADU,309,17,237,563,103,1,63,167,139,2772,47,1713,4532,2054,1,0,0,1
5171,GUNTUR,Tadikonda,PHANIDARAM,71,5,301,377,2,3,160,165,161,40,67,6314,6421,4116,0,0,4,4
5172,GUNTUR,Tadikonda,PONNEKALLU,456,125,826,1407,123,50,201,374,321,3836,2163,7189,13188,7378,0,4,5,9
5173,GUNTUR,Tadikonda,RAVELA,481,63,612,1156,251,9,124,384,315,8910,169,3604,12683,6650,12,0,0,12
5174,GUNTUR,Tadikonda,TADIKONDA,967,250,1281,2498,172,32,204,408,287,6753,520,6979,14252,8161,10,0,7,17
5175,GUNTUR,Tenali,ANGALAKUDURU,466,33,313,812,244,2,27,273,248,6560,40,540,7140,4439,0,0,0,0
5176,GUNTUR,Tenali,BURRIPALEM,416,37,397,850,148,12,142,302,279,3652,240,5330,9222,4846,0,0,0,0
5177,GUNTUR,Tenali,CHAVAVARIPALEM,164,0,55,219,60,0,0,60,55,1043,0,0,1043,630,0,0,0,0
5178,GUNTUR,Tenali,ERUKALAPUDI,28,13,220,261,13,9,114,136,115,510,312,4193,5015,2868,0,0,1,1
5179,GUNTUR,Tenali,GUDIVADA,434,4,157,595,322,1,15,338,313,11421,20,300,11741,6739,1,0,0,1
5180,GUNTUR,Tenali,HALFPET,467,2,187,656,311,1,110,422,382,10818,25,2055,12898,6947,4,0,0,4
5181,GUNTUR,Tenali,JAGGADIGUNTAPALEM,1,49,217,267,0,0,0,0,0,0,0,0,0,0,0,0,0,0
5182,GUNTUR,Tenali,KANCHERLAPALEM,309,3,132,444,211,3,59,273,253,8190,94,1469,9753,5079,1,0,0,1
5183,GUNTUR,Tenali,KATTEVARAM,329,6,261,596,105,0,15,120,98,5838,0,324,6162,4013,16,0,0,16
5184,GUNTUR,Tenali,KOLAKALUR,957,21,1621,2599,475,2,435,912,819,12147,40,7772,19959,12760,0,0,0,0
5185,GUNTUR,Tenali,KOPALLE,292,44,127,463,165,24,47,236,219,5321,376,1005,6702,4252,1,0,0,1
5186,GUNTUR,Tenali,MALLEPADU,294,37,17,348,0,0,0,0,0,0,0,0,0,0,0,0,0,0
5187,GUNTUR,Tenali,NANDIVELUGU,395,47,660,1102,217,0,113,330,312,5541,0,2555,8096,5616,0,0,0,0
5188,GUNTUR,Tenali,NELAPADU,174,0,92,266,89,0,22,111,98,4156,0,1041,5197,3133,1,0,0,1
5189,GUNTUR,Tenali,PEDARAVURU,691,62,279,1032,307,25,43,375,364,11415,815,1188,13418,7342,0,0,1,1
5190,GUNTUR,Tenali,SANGAMJAGARLAMUDI,172,60,425,657,110,16,86,212,155,5924,1153,2625,9702,4903,3,5,2,10
5191,GUNTUR,Tenali,SOMASUNDARAPALEM,14,0,329,343,0,0,113,113,107,0,0,4414,4414,3369,0,0,1,1
5192,GUNTUR,Tenali,TELAPROLU,39,17,215,271,26,16,23,65,50,1738,814,1473,4025,2205,4,0,3,7
5193,GUNTUR,Thadepalle,CHIRRAVUR,321,0,97,418,59,0,11,70,57,1630,0,205,1835,1181,0,0,0,0
5194,GUNTUR,Thadepalle,GUNDIMEDA,366,11,73,450,63,1,7,71,58,1089,20,84,1193,806,0,0,0,0
5195,GUNTUR,Thadepalle,IPPATAM,92,0,91,183,0,0,4,4,3,0,0,80,80,30,0,0,0,0
5196,GUNTUR,Thadepalle,KOLANUKONDA,171,90,292,553,0,0,0,0,0,0,0,0,0,0,0,0,0,0
5197,GUNTUR,Thadepalle,KRISHNANAGAR,460,5,197,662,0,0,0,0,0,0,0,0,0,0,0,0,0,0
5198,GUNTUR,Thadepalle,KUNCHANAPALLI,69,12,78,159,4,2,5,11,6,80,40,100,220,70,0,0,0,0
5199,GUNTUR,Thadepalle,MELLEMPUDI,123,23,117,263,9,1,3,13,12,180,20,60,260,140,0,0,0,0
5200,GUNTUR,Thadepalle,PENUMAKA,452,107,174,733,6,3,12,21,19,120,60,240,420,245,0,0,0,0
5201,GUNTUR,Thadepalle,PRATHURU,442,1,77,520,172,0,3,175,171,2716,0,34,2750,2223,0,0,0,0
5202,GUNTUR,Thadepalle,TADEPALLI,497,63,307,867,0,0,0,0,0,0,0,0,0,0,0,0,0,0
5203,GUNTUR,Thadepalle,UNDAVALLI,311,16,249,576,15,0,0,15,15,300,0,0,300,220,0,0,0,0
5204,GUNTUR,Thadepalle,VADDESWARAM,315,3,187,505,11,0,4,15,11,220,0,80,300,120,0,0,0,0
5205,GUNTUR,Thullur,ABBARAJUPALEM,93,2,52,147,30,0,3,33,33,468,0,34,502,350,0,0,0,0
5206,GUNTUR,Thullur,ANANTHAVARAM,451,124,139,714,71,12,11,94,49,1107,112,135,1354,411,0,0,0,0
5207,GUNTUR,Thullur,BORUPALEM,262,8,52,322,83,2,6,91,61,530,8,64,602,302,0,0,0,0
5208,GUNTUR,Thullur,DONDAPADU,283,2,214,499,42,0,33,75,38,314,0,677,991,231,0,0,0,0
5209,GUNTUR,Thullur,HARISCHANDRAPURAM,134,29,135,298,31,7,11,49,43,450,170,193,813,482,0,0,0,0
5210,GUNTUR,Thullur,INAVOLU,264,2,173,439,53,0,20,73,74,951,0,360,1311,779,0,0,0,0
5211,GUNTUR,Thullur,LINGAYAPALEM,315,0,195,510,15,0,13,28,31,292,0,259,551,422,0,0,0,0
5212,GUNTUR,Thullur,MALKAPURAM,220,24,91,335,44,3,1,48,35,384,43,20,447,251,0,0,0,0
5213,GUNTUR,Thullur,MANDADAM,430,142,189,761,89,23,11,123,117,1504,384,216,2104,1386,0,0,0,0
5214,GUNTUR,Thullur,NEKKALLU,148,4,240,392,28,0,45,73,71,518,0,836,1354,838,0,0,0,0
5215,GUNTUR,Thullur,NELAPADU,132,1,142,275,57,0,10,67,54,726,0,131,857,423,0,0,0,0
5216,GUNTUR,Thullur,PEDDAPARIMI,366,59,438,863,118,15,68,201,149,2272,447,1710,4429,1881,0,0,1,1
5217,GUNTUR,Thullur,RAYAPUDI,168,2,408,578,20,0,64,84,85,386,0,1160,1546,978,0,0,0,0
5218,GUNTUR,Thullur,SAKHAMURU,177,13,163,353,46,0,5,51,15,545,0,31,576,139,0,0,0,0
5219,GUNTUR,Thullur,TULLUR,571,181,384,1136,122,27,19,168,155,2498,467,353,3318,1971,0,0,0,0
5220,GUNTUR,Thullur,UDDANDA RAYUNIPALEM,278,0,41,319,26,0,1,27,20,228,0,8,236,106,0,0,0,0
5221,GUNTUR,Thullur,VADDAMANU,354,18,255,627,50,0,13,63,59,987,0,228,1215,622,0,0,0,0
5222,GUNTUR,Thullur,VELAGAPUDI,332,57,201,590,42,6,21,69,48,621,92,420,1133,482,0,0,0,0
5223,GUNTUR,Thullur,VENKATA PALEM,384,40,207,631,23,1,7,31,30,394,20,95,509,337,0,0,0,0
5224,GUNTUR,Tsundur,ALAPADU,414,19,135,568,257,10,66,333,299,7444,226,1299,8969,4565,0,0,0,0
5225,GUNTUR,Tsundur,AMBEDKARNAGAR,349,43,8,400,202,3,0,205,166,7752,16,0,7768,3913,0,0,0,0
5226,GUNTUR,Tsundur,CHINAGADELAVARRU,164,2,271,437,124,1,165,290,277,6108,44,8141,14293,6881,7,0,12,19
5227,GUNTUR,Tsundur,CHINAPARIMI,360,49,216,625,211,13,36,260,199,7079,156,624,7859,3730,2,0,0,2
5228,GUNTUR,Tsundur,DUNDIPALEM,286,1,462,749,146,0,132,278,252,5768,0,2323,8091,5018,2,0,0,2
5229,GUNTUR,Tsundur,EDLAPALLI,66,14,315,395,7,0,0,7,5,116,0,0,116,46,0,0,0,0
5230,GUNTUR,Tsundur,KARUMURIVARIPALEM,122,0,51,173,67,0,1,68,66,1873,0,20,1893,1071,0,0,0,0
5231,GUNTUR,Tsundur,KOTHAPALLINARIKELLAPALLI,45,8,111,164,31,8,72,111,109,1536,458,3927,5921,2914,0,1,4,5
5232,GUNTUR,Tsundur,MANDURU,228,37,384,649,166,25,198,389,374,4038,1125,5974,11137,5430,0,0,1,1
5233,GUNTUR,Tsundur,MODUKURU,538,85,543,1166,263,38,150,451,417,5500,642,2752,8894,4745,0,0,0,0
5234,GUNTUR,Tsundur,MUNNANGIVARIPALEM,19,53,368,440,17,14,154,185,134,1093,224,5713,7030,3226,1,0,3,4
5235,GUNTUR,Tsundur,NADIGADDAPALEM,187,88,75,350,140,11,36,187,166,5695,220,2003,7918,4025,1,0,5,6
5236,GUNTUR,Tsundur,PEDAGADELAVARRU,176,13,111,300,136,8,58,202,190,4646,205,1587,6438,3125,0,0,0,0
5237,GUNTUR,Tsundur,PENUGUDURUPADU,308,18,179,505,234,9,100,343,325,6784,342,2883,10009,5553,0,0,0,0
5238,GUNTUR,Tsundur,THOTTEMPUDI,167,6,199,372,105,0,99,204,184,5206,0,4041,9247,4789,5,0,2,7
5239,GUNTUR,Tsundur,TSUNDUR,160,63,402,625,96,22,125,243,206,2745,851,3696,7292,3779,0,0,0,0
5240,GUNTUR,Tsundur,VALIVERU,530,17,257,804,378,3,70,451,442,13659,60,1409,15128,7694,3,0,0,3
5241,GUNTUR,Tsundur,VETAPALEM,378,3,162,543,217,1,72,290,265,8153,8,2820,10981,5459,3,0,4,7
5242,GUNTUR,Vatticherukuru,ANANTHAVARAPADU,400,5,221,626,130,0,8,138,129,2534,0,160,2694,1598,1,0,0,1
5243,GUNTUR,Vatticherukuru,CHAMALLAMUDI,318,26,190,534,111,4,33,148,115,2368,80,427,2875,1485,0,0,0,0
5244,GUNTUR,Vatticherukuru,CHINTAPALLIPADU,79,1,153,233,9,0,18,27,10,168,0,318,486,168,0,0,0,0
5245,GUNTUR,Vatticherukuru,GARAPADU,155,23,155,333,28,0,12,40,34,336,0,174,510,196,0,0,0,0
5246,GUNTUR,Vatticherukuru,KAREMPUDIPADU,27,7,353,387,1,0,123,124,42,18,0,2793,2811,607,0,0,0,0
5247,GUNTUR,Vatticherukuru,KATRAPADU,47,14,173,234,29,2,47,78,64,1046,51,1286,2383,920,1,0,0,1
5248,GUNTUR,Vatticherukuru,KORNEPADU,313,25,295,633,46,4,61,111,107,724,68,980,1772,1036,0,0,0,0
5249,GUNTUR,Vatticherukuru,KOVELAMUDI,216,0,265,481,132,0,148,280,256,4469,0,4102,8571,4601,1,0,0,1
5250,GUNTUR,Vatticherukuru,KURNUTHALA,214,5,192,411,142,2,103,247,236,4256,65,4684,9005,5338,0,0,5,5
5251,GUNTUR,Vatticherukuru,LEMALLEPADU,117,7,233,357,21,0,19,40,33,149,0,231,380,293,0,0,0,0
5252,GUNTUR,Vatticherukuru,MUTLURU,324,17,562,903,143,4,88,235,217,3084,56,1390,4530,2708,0,0,0,0
5253,GUNTUR,Vatticherukuru,PALLAPADU,162,19,281,462,62,0,47,109,101,1301,0,892,2193,1149,0,0,0,0
5254,GUNTUR,Vatticherukuru,PULLADIGUNTA,2,40,129,171,0,0,13,13,11,0,0,261,261,129,0,0,0,0
5255,GUNTUR,Vatticherukuru,SOWPADU,201,8,285,494,27,3,131,161,130,626,208,6490,7324,3563,0,1,14,15
5256,GUNTUR,Vatticherukuru,VATTICHERUKURU,351,7,272,630,174,1,89,264,252,3862,36,1285,5183,2884,0,0,0,0
5257,GUNTUR,Vatticherukuru,VINJANAMPADU,239,12,106,357,45,0,0,45,44,694,0,0,694,341,0,0,0,0
5258,GUNTUR,Vatticherukuru,YAMARRU,147,12,216,375,41,0,82,123,106,802,0,1443,2245,1153,0,0,0,0
5259,GUNTUR,Veldurthi,BODILAVEEDU,91,15,390,496,46,9,226,281,265,1086,262,7083,8431,4060,0,0,2,2
5260,GUNTUR,Veldurthi,GANGALAKUNTA,134,538,758,1430,81,233,407,721,742,1470,15969,9641,27080,14961,0,57,0,57
5261,GUNTUR,Veldurthi,GOTHIPALLA,195,461,780,1436,124,97,13,234,242,5328,6428,1105,12861,7094,3,25,5,33
5262,GUNTUR,Veldurthi,GUNDLAPADU,183,0,821,1004,56,0,395,451,429,1228,0,7343,8571,4896,0,0,0,0
5263,GUNTUR,Veldurthi,KANDLAKUNTA,307,362,725,1394,136,97,114,347,353,5371,6422,3659,15452,7796,3,16,2,21
5264,GUNTUR,Veldurthi,KOTHAPULLAREDDIGUDEM,82,723,554,1359,15,367,280,662,654,357,9249,6863,16469,8658,0,2,1,3
5265,GUNTUR,Veldurthi,LOYAPALLI,31,334,323,688,1,149,179,329,340,107,4349,8872,13328,7519,1,0,5,6
5266,GUNTUR,Veldurthi,MANDADI,325,180,976,1481,151,80,419,650,636,4998,3984,14266,23248,14611,1,10,5,16
5267,GUNTUR,Veldurthi,MITTAMEEDAPALLI,5,192,358,555,1,55,235,291,301,20,2031,12333,14384,7439,0,2,27,29
5268,GUNTUR,Veldurthi,PATLAVEEDU,57,223,795,1075,33,97,385,515,572,939,9151,17861,27951,15324,0,27,27,54
5269,GUNTUR,Veldurthi,RACHAMALLIPADU,79,53,681,813,44,17,361,422,420,1937,482,13504,15923,9591,2,0,4,6
5270,GUNTUR,Veldurthi,SREERAMAPURAMTHANDA,10,359,246,615,1,201,53,255,252,24,5872,1802,7698,4238,0,1,0,1
5271,GUNTUR,Veldurthi,SRIGIRIPADU,363,6,1112,1481,163,2,530,695,726,4259,41,12700,17000,9436,0,0,4,4
5272,GUNTUR,Veldurthi,UPPALAPADU,77,456,983,1516,45,132,360,537,548,1346,9165,14172,24683,13674,0,41,6,47
5273,GUNTUR,Veldurthi,VAJRALAPADU,5,659,11,675,1,316,6,323,333,98,28876,734,29708,14730,0,105,4,109
5274,GUNTUR,Veldurthi,VELDURTHY,416,253,920,1589,227,72,243,542,581,11343,4610,6410,22363,12507,15,8,2,25
5275,GUNTUR,Vemuru,ABBANAGUDAVALLI,111,29,208,348,58,0,120,178,170,714,0,1423,2137,1255,0,0,0,0
5276,GUNTUR,Vemuru,BALIJEPALLI,157,59,257,473,89,31,93,213,199,3149,1101,2633,6883,4058,0,0,0,0
5277,GUNTUR,Vemuru,BHUTUMALLI,67,0,43,110,2,0,0,2,1,38,0,0,38,10,0,0,0,0
5278,GUNTUR,Vemuru,CHADALAWADA,342,28,119,489,113,7,14,134,122,1731,95,234,2060,1083,0,0,0,0
5279,GUNTUR,Vemuru,CHAMPADU,190,11,21,222,175,9,8,192,186,6620,272,166,7058,4129,0,0,0,0
5280,GUNTUR,Vemuru,CHAVALI,422,33,617,1072,311,1,77,389,345,9008,20,1731,10759,5921,0,0,0,0
5281,GUNTUR,Vemuru,JAMPANI,678,26,516,1220,313,1,51,365,302,5050,20,873,5943,3277,0,0,0,0
5282,GUNTUR,Vemuru,KAKARLAMUDI,24,5,248,277,12,2,114,128,61,361,17,2467,2845,729,0,0,0,0
5283,GUNTUR,Vemuru,KODIPARRU,214,0,101,315,143,0,48,191,150,6179,0,1690,7869,4404,3,0,0,3
5284,GUNTUR,Vemuru,KUNCHELLAPADU,151,3,229,383,99,1,127,227,193,3867,17,4657,8541,4295,0,0,0,0
5285,GUNTUR,Vemuru,PENUMARRU,112,5,41,158,65,2,7,74,68,2975,107,278,3360,1995,1,0,0,1
5286,GUNTUR,Vemuru,PERAVALI,186,28,416,630,117,18,96,231,214,2275,349,1830,4454,2576,0,0,0,0
5287,GUNTUR,Vemuru,PERAVALIPALEM,212,11,454,677,70,6,205,281,183,933,120,5348,6401,2312,0,0,0,0
5288,GUNTUR,Vemuru,POTHUMARRU,257,26,74,357,24,3,9,36,37,438,50,178,666,360,0,0,0,0
5289,GUNTUR,Vemuru,VARAHAPURAM,305,0,55,360,180,0,13,193,179,2429,0,198,2627,1279,0,0,0,0
5290,GUNTUR,Vemuru,VELLABADU,249,0,32,281,193,0,16,209,212,3067,0,139,3206,1723,0,0,0,0
5291,GUNTUR,Vemuru,VEMURU,1143,224,123,1490,122,45,36,203,179,2193,793,659,3645,1889,0,0,0,0
5292,GUNTUR,Vinukonda,ANDUGULAPADU,226,21,720,967,132,0,323,455,460,5085,0,8330,13415,7491,4,0,3,7
5293,GUNTUR,Vinukonda,BHARATHAPURAM,36,25,249,310,33,15,195,243,248,1494,424,8228,10146,4885,0,0,12,12
5294,GUNTUR,Vinukonda,BRAHMANAPALLI,301,12,355,668,122,0,174,296,282,2512,0,6351,8863,5771,0,0,2,2
5295,GUNTUR,Vinukonda,CHATRAGADDAPADU,89,1,330,420,56,1,268,325,330,905,22,3810,4737,2898,0,0,0,0
5296,GUNTUR,Vinukonda,CHIKATEEGALAPALEM,3,21,535,559,0,11,264,275,238,0,204,11578,11782,6354,0,0,12,12
5297,GUNTUR,Vinukonda,DONDAPADU,166,11,682,859,81,1,398,480,493,2737,10,14302,17049,9176,1,0,8,9
5298,GUNTUR,Vinukonda,ENUGUPALEM,161,29,475,665,106,12,311,429,432,3612,244,13173,17029,9780,3,0,20,23
5299,GUNTUR,Vinukonda,GOKANAKONDA,94,6,464,564,57,5,307,369,358,1031,243,11784,13058,6411,0,0,16,16
5300,GUNTUR,Vinukonda,GONUGUNTLA VARIPALEM,308,0,245,553,197,0,118,315,303,5681,0,2117,7798,4464,0,0,0,0
5301,GUNTUR,Vinukonda,HASSANAYUNIPALEM,8,2,205,215,4,0,48,52,46,54,0,1072,1126,574,0,0,0,0
5302,GUNTUR,Vinukonda,JALALAPALEM,87,2,135,224,44,0,91,135,131,2310,0,5950,8260,4626,4,0,16,20
5303,GUNTUR,Vinukonda,KOPPUKONDA,137,165,642,944,29,87,407,523,489,868,2217,10470,13555,6535,0,1,1,2
5304,GUNTUR,Vinukonda,NADIGADDA,106,188,650,944,26,47,392,465,454,500,1172,12607,14279,7825,0,0,3,3
5305,GUNTUR,Vinukonda,NAGULAVARAM,260,12,840,1112,172,9,451,632,588,4259,219,14327,18805,10048,0,0,2,2
5306,GUNTUR,Vinukonda,NARAGAYAPALEM,61,1,321,383,46,0,238,284,291,2323,0,9802,12125,7658,2,0,15,17
5307,GUNTUR,Vinukonda,NEELA GANGAVARAM,173,7,517,697,90,4,299,393,399,4227,163,12631,17021,8639,3,1,32,36
5308,GUNTUR,Vinukonda,PEDAKANCHERLA,252,41,709,1002,104,15,329,448,384,1462,137,5357,6956,3748,0,0,0,0
5309,GUNTUR,Vinukonda,PERUMALLAPALLI,97,5,220,322,55,3,135,193,166,999,28,4474,5501,2685,0,0,0,0
5310,GUNTUR,Vinukonda,PITTAMBANDA,157,1,499,657,126,1,335,462,495,8050,68,13444,21562,12434,24,0,7,31
5311,GUNTUR,Vinukonda,SIVAPURAM,227,81,387,695,67,18,189,274,240,1337,490,9899,11726,5811,1,1,18,20
5312,GUNTUR,Vinukonda,THIMMAYAPALEM,198,23,351,572,47,18,73,138,134,844,230,1420,2494,1316,0,0,0,0
5313,GUNTUR,Vinukonda,UMMADIVARAM,208,24,270,502,105,0,186,291,291,2183,0,9230,11413,6045,4,0,13,17
5314,GUNTUR,Vinukonda,UPPARAPALEM,183,5,778,966,30,0,367,397,334,546,0,15014,15560,7367,0,0,14,14
5315,GUNTUR,Vinukonda,VENKUPALEM,57,0,226,283,27,0,169,196,214,1082,0,7329,8411,4947,0,0,9,9
5316,GUNTUR,Vinukonda,VITTAMRAJUPALLI,311,42,646,999,163,10,345,518,480,5075,281,10514,15870,10621,7,0,6,13
5317,KRISHNA,A Konduru,A. KONDURU,470,696,486,1652,197,82,255,534,506,5957,1901,9355,17213,11466,3,2,7,12
5318,KRISHNA,A Konduru,CHEEMALAPADU,260,327,528,1115,72,136,190,398,390,3596,5441,10219,19256,12083,6,2,13,21
5319,KRISHNA,A Konduru,GOLLAMANDALA,315,251,439,1005,180,187,204,571,549,7640,9395,4558,21593,13376,15,21,1,37
5320,KRISHNA,A Konduru,GOPALAPURAM,14,315,172,501,1,229,101,331,348,71,16989,5190,22250,12871,0,54,10,64
5321,KRISHNA,A Konduru,JEELAKUNTA,96,142,84,322,69,108,50,227,233,5226,8634,4260,18120,11075,10,36,19,65
5322,KRISHNA,A Konduru,KAMBAMPADU,717,43,871,1631,359,4,503,866,834,16559,39,11894,28492,20183,33,0,1,34
5323,KRISHNA,A Konduru,KODURU,469,10,391,870,210,3,111,324,303,7782,125,4369,12276,8739,4,0,3,7
5324,KRISHNA,A Konduru,KRISHNARAO PALEM,82,646,136,864,13,365,24,402,379,260,10494,673,11427,6848,0,6,0,6
5325,KRISHNA,A Konduru,KUMMARAKUNTLA,1,454,1,456,1,323,1,325,404,19,21922,24,21965,12579,0,69,0,69
5326,KRISHNA,A Konduru,MADHAVARAM,161,216,554,931,63,104,331,498,485,2429,3390,14402,20221,12933,6,10,27,43
5327,KRISHNA,A Konduru,MAREPALLE,285,1,205,491,190,0,118,308,293,9653,0,3953,13606,9205,18,0,0,18
5328,KRISHNA,A Konduru,POLISETTIPADU,362,7,373,742,215,2,170,387,388,10555,89,7098,17742,13020,19,0,6,25
5329,KRISHNA,A Konduru,RAMACHANDRAPURAM,47,33,790,870,0,1,324,325,312,0,6,12869,12875,9469,0,0,14,14
5330,KRISHNA,A Konduru,REPUDI,389,16,712,1117,138,2,328,468,446,3181,38,10099,13318,8161,0,0,6,6
5331,KRISHNA,A Konduru,REPUDI THANDA,4,519,4,527,2,317,0,319,324,16,21637,0,21653,11860,0,80,0,80
5332,KRISHNA,A Konduru,VALLAMPATLA,191,75,263,529,63,57,124,244,188,805,1207,3170,5182,3355,0,0,0,0
5333,KRISHNA,Agiripalle,ADIVENNEKKALAM,187,3,25,215,0,0,0,0,0,0,0,0,0,0,0,0,0,0
5334,KRISHNA,Agiripalle,AGIRIPALLE,181,31,744,956,29,1,18,48,42,418,5,588,1011,583,0,0,1,1
5335,KRISHNA,Agiripalle,AMMAVARIGUDEM,68,0,269,337,2,0,122,124,114,56,0,4372,4428,2962,0,0,2,2
5336,KRISHNA,Agiripalle,BODDANAPALLI,193,1,607,801,62,0,158,220,197,2164,0,4901,7065,5235,5,0,1,6
5337,KRISHNA,Agiripalle,CHINAGIRIPALLE,84,0,483,567,38,0,90,128,123,1736,0,4693,6429,4990,5,0,3,8
5338,KRISHNA,Agiripalle,CHOPPARAMETLA,102,4,487,593,28,0,68,96,86,1207,0,3288,4495,3089,1,0,10,11
5339,KRISHNA,Agiripalle,EDARA,870,15,501,1386,20,0,2,22,18,313,0,25,338,179,0,0,0,0
5340,KRISHNA,Agiripalle,EDULAGUDEM,276,4,338,618,47,0,23,70,31,802,0,525,1327,461,0,0,0,0
5341,KRISHNA,Agiripalle,GOLLAGUDEM,230,22,206,458,6,0,2,8,9,120,0,40,160,96,0,0,0,0
5342,KRISHNA,Agiripalle,K.EDARA,1,1,504,506,0,0,8,8,8,0,0,35,35,21,0,0,0,0
5343,KRISHNA,Agiripalle,KALATURU,201,1,215,417,22,0,6,28,24,141,0,62,203,152,0,0,0,0
5344,KRISHNA,Agiripalle,KANASANAPALLI,121,8,210,339,37,0,13,50,44,664,0,333,997,703,0,0,0,0
5345,KRISHNA,Agiripalle,KOMMURU,47,0,282,329,2,0,5,7,5,26,0,70,96,47,0,0,0,0
5346,KRISHNA,Agiripalle,KRISHNAVARAM,159,11,268,438,0,0,5,5,5,0,0,25,25,25,0,0,0,0
5347,KRISHNA,Agiripalle,NARASINGAPALEM,278,4,136,418,129,1,14,144,125,3650,20,391,4061,3013,3,0,0,3
5348,KRISHNA,Agiripalle,NUGONDAPALLI,179,3,250,432,1,0,10,11,9,18,0,134,152,71,0,0,0,0
5349,KRISHNA,Agiripalle,PINNAMAREDDIPALLE,338,0,0,338,194,0,0,194,181,8505,0,0,8505,6296,12,0,0,12
5350,KRISHNA,Agiripalle,POTHAVARAPPADU,157,0,39,196,0,0,0,0,0,0,0,0,0,0,0,0,0,0
5351,KRISHNA,Agiripalle,SAGGURU,244,11,148,403,93,0,35,128,112,2571,0,1017,3588,2045,2,0,1,3
5352,KRISHNA,Agiripalle,SIMHADHRI APPARAOPETA,4,0,618,622,1,0,84,85,79,60,0,2237,2297,1051,0,0,0,0
5353,KRISHNA,Agiripalle,SITHARAMPURAM,2,3,406,411,0,0,1,1,1,0,0,20,20,10,0,0,0,0
5354,KRISHNA,Agiripalle,SURAVARAM,64,4,239,307,42,0,60,102,90,4024,0,3336,7360,4740,23,0,7,30
5355,KRISHNA,Agiripalle,THOTAPALLE,284,4,173,461,60,0,11,71,69,1528,0,266,1794,1283,1,0,0,1
5356,KRISHNA,Agiripalle,VADLAMANU,13,15,521,549,0,1,155,156,152,0,104,6867,6971,4553,0,1,15,16
5357,KRISHNA,Agiripalle,VATTIGUDIPADU,379,1,363,743,109,0,21,130,90,3206,0,319,3525,1310,6,0,0,6
5358,KRISHNA,Avanigadda,ASWARAO PALEM,53,17,416,486,30,0,284,314,236,1012,0,9321,10333,4929,0,0,0,0
5359,KRISHNA,Avanigadda,AVANIGADDA,674,222,1233,2129,100,11,230,341,331,3363,91,3680,7134,5572,0,0,0,0
5360,KRISHNA,Avanigadda,CHIRUVOLLANKA,149,0,378,527,62,0,40,102,93,294,0,193,487,255,0,0,0,0
5361,KRISHNA,Avanigadda,EDLANKA,104,1,87,192,58,0,7,65,55,345,0,24,369,186,0,0,0,0
5362,KRISHNA,Avanigadda,MODUMUDI,126,0,325,451,82,0,184,266,219,2317,0,4771,7088,3634,0,0,0,0
5363,KRISHNA,Avanigadda,PULIGADDA,218,0,346,564,54,0,15,69,67,1987,0,268,2255,1545,0,0,0,0
5364,KRISHNA,Avanigadda,RAMACHANDRAPURAM,57,8,311,376,44,3,198,245,208,1477,106,7331,8914,4466,0,0,0,0
5365,KRISHNA,Avanigadda,RAMAKOTI PURAM,0,3,305,308,0,0,138,138,130,0,0,1325,1325,853,0,0,0,0
5366,KRISHNA,Avanigadda,TUNGALAVARI PALEM,20,3,219,242,12,3,127,142,123,161,26,835,1022,694,0,0,0,0
5367,KRISHNA,Avanigadda,VEKANURU,96,12,568,676,69,6,144,219,195,2444,105,5166,7715,4869,0,0,1,1
5368,KRISHNA,Bantumilli,AMUDALAPALLE,342,0,70,412,140,0,29,169,155,7401,0,1070,8471,4331,6,0,0,6
5369,KRISHNA,Bantumilli,ARTHAMURU,106,57,672,835,42,4,341,387,341,1427,58,6618,8103,3827,0,0,0,0
5370,KRISHNA,Bantumilli,BANTUMILLI,171,35,497,703,28,0,106,134,112,854,0,4027,4881,3253,0,0,4,4
5371,KRISHNA,Bantumilli,BARRIPADU,42,0,224,266,2,0,0,2,1,9,0,0,9,3,0,0,0,0
5372,KRISHNA,Bantumilli,CHINATUMMIDI,0,2,234,236,0,2,171,173,151,0,19,2265,2284,1062,0,0,0,0
5373,KRISHNA,Bantumilli,CHORAMPUDI,70,0,384,454,2,0,44,46,30,28,0,507,535,204,0,0,0,0
5374,KRISHNA,Bantumilli,KANCHADAM,116,0,357,473,53,0,159,212,191,1161,0,4339,5500,2470,0,0,0,0
5375,KRISHNA,Bantumilli,KORLAPADU,35,1,276,312,6,0,125,131,111,37,0,3604,3641,1747,0,0,13,13
5376,KRISHNA,Bantumilli,MALAPARAJUGUDEM,45,1,173,219,25,0,83,108,47,719,0,2158,2877,839,0,0,0,0
5377,KRISHNA,Bantumilli,MALLAMPUDI,16,2,424,442,6,0,160,166,73,27,0,1301,1328,423,0,0,0,0
5378,KRISHNA,Bantumilli,MALLESWARAM,80,0,313,393,45,0,140,185,161,776,0,1058,1834,904,0,0,0,0
5379,KRISHNA,Bantumilli,MANIMESWARAM,192,4,211,407,116,0,115,231,143,2153,0,1939,4092,1552,0,0,0,0
5380,KRISHNA,Bantumilli,MULAPARRU,233,3,479,715,136,0,125,261,223,2305,0,2052,4357,2124,0,0,0,0
5381,KRISHNA,Bantumilli,MUNJULURU,42,3,401,446,28,3,184,215,178,432,44,4292,4768,2009,0,0,0,0
5382,KRISHNA,Bantumilli,NAGANNACHERUVU,143,6,115,264,0,0,0,0,0,0,0,0,0,0,0,0,0,0
5383,KRISHNA,Bantumilli,NAGESWARARAOPET,49,2,385,436,4,2,142,148,138,35,21,1789,1845,910,0,0,0,0
5384,KRISHNA,Bantumilli,PEDATUMIDI,558,3,520,1081,214,2,276,492,468,5124,26,6556,11706,6228,0,0,0,0
5385,KRISHNA,Bantumilli,PENDURRU,29,6,547,582,15,1,146,162,30,341,5,2549,2895,370,0,0,0,0
5386,KRISHNA,Bantumilli,RAMAVARAPUMODI,201,6,284,491,85,0,212,297,285,2024,0,3993,6017,3213,0,0,0,0
5387,KRISHNA,Bantumilli,RAVIGUNTA,0,0,74,74,0,0,36,36,0,0,0,617,617,0,0,0,0,0
5388,KRISHNA,Bantumilli,SATULURU,197,5,234,436,166,5,169,340,329,6629,256,5446,12331,6015,0,0,0,0
5389,KRISHNA,Bapulapadu,AMPAPURAM,20,5,168,193,0,0,85,85,80,0,0,1599,1599,975,0,0,0,0
5390,KRISHNA,Bapulapadu,ARUGOLANU,284,4,360,648,163,4,211,378,354,5570,120,7786,13476,8141,0,0,2,2
5391,KRISHNA,Bapulapadu,BANDARUGUDEM,300,3,312,615,133,0,85,218,195,3912,0,1799,5711,3175,0,0,0,0
5392,KRISHNA,Bapulapadu,BAPULAPADU,284,11,374,669,98,0,114,212,218,6473,0,8862,15335,12359,12,0,37,49
5393,KRISHNA,Bapulapadu,BILLANAPALLI,126,3,217,346,11,0,53,64,63,125,0,833,958,645,0,0,0,0
5394,KRISHNA,Bapulapadu,BOMMULURU,424,3,306,733,229,2,167,398,355,5390,58,4211,9659,6165,0,0,0,0
5395,KRISHNA,Bapulapadu,CHIRIVADA,163,17,361,541,103,10,237,350,317,4215,181,7141,11537,6375,1,0,0,1
5396,KRISHNA,Bapulapadu,DANTAGUNTLA,23,1,306,330,13,0,245,258,216,745,0,15341,16086,7881,0,0,12,12
5397,KRISHNA,Bapulapadu,KAKULAPADU,222,1,136,359,90,0,47,137,120,1492,0,1152,2644,1439,0,0,0,0
5398,KRISHNA,Bapulapadu,KANUMOLU,236,14,375,625,127,3,230,360,352,3579,45,8537,12161,8089,3,0,1,4
5399,KRISHNA,Bapulapadu,KODURUPADU,248,37,422,707,68,1,132,201,184,855,24,4996,5875,3411,0,0,0,0
5400,KRISHNA,Bapulapadu,KOTHAPALLI,204,14,356,574,31,1,10,42,38,482,20,222,724,338,0,0,0,0
5401,KRISHNA,Bapulapadu,KOYYERU,271,2,226,499,177,1,136,314,312,8685,64,8540,17289,10743,22,0,30,52
5402,KRISHNA,Bapulapadu,MADICHERLA,317,123,391,831,97,1,82,180,161,1249,20,1887,3156,1756,0,0,0,0
5403,KRISHNA,Bapulapadu,MALLAVALLI,220,2,483,705,111,1,21,133,128,2548,18,614,3180,2728,0,0,1,1
5404,KRISHNA,Bapulapadu,OGIRALA,142,0,296,438,82,0,127,209,200,5494,0,7825,13319,7483,7,0,17,24
5405,KRISHNA,Bapulapadu,PERIKEEDU,120,6,329,455,51,0,205,256,281,2006,0,6516,8522,5842,0,0,0,0
5406,KRISHNA,Bapulapadu,R.A.PET,99,3,84,186,50,0,47,97,104,2264,0,1469,3733,2403,2,0,0,2
5407,KRISHNA,Bapulapadu,RAMANNAGUDEM,63,0,195,258,33,0,85,118,109,788,0,2377,3165,1945,0,0,0,0
5408,KRISHNA,Bapulapadu,RANGANNAGUDEM,332,7,374,713,1,0,98,99,87,20,0,2194,2214,1348,0,0,0,0
5409,KRISHNA,Bapulapadu,REMALLE,587,38,125,750,250,2,12,264,240,5816,34,228,6078,3991,1,0,0,1
5410,KRISHNA,Bapulapadu,SEETHARAMPURAM-K,175,4,388,567,77,1,200,278,278,1993,26,5759,7778,5930,2,0,2,4
5411,KRISHNA,Bapulapadu,SERINARASANNAPALEM,75,28,189,292,39,21,127,187,157,1693,1037,5933,8663,4810,0,0,2,2
5412,KRISHNA,Bapulapadu,SITHARAMAPURAM-A,56,2,264,322,3,0,98,101,101,82,0,2349,2431,1505,0,0,0,0
5413,KRISHNA,Bapulapadu,THIPPANAGUNTA,328,0,33,361,236,0,22,258,254,14217,0,1703,15920,8439,15,0,5,20
5414,KRISHNA,Bapulapadu,VEERAVALLI,480,14,502,996,71,0,143,214,197,2174,0,3665,5839,3272,0,0,0,0
5415,KRISHNA,Bapulapadu,VELERU,262,70,161,493,0,1,17,18,17,0,1,212,213,113,0,0,0,0
5416,KRISHNA,Challapalli,AMUDALA LANKA,105,0,168,273,49,0,69,118,97,334,0,1585,1919,1007,0,0,0,0
5417,KRISHNA,Challapalli,CHALLAPALLE,353,179,628,1160,86,22,58,166,155,662,263,380,1305,866,0,0,0,0
5418,KRISHNA,Challapalli,LAKSHMIPURAM,407,25,926,1358,125,3,408,536,416,1300,24,5800,7124,3099,0,0,0,0
5419,KRISHNA,Challapalli,MAJERU,68,16,666,750,36,0,258,294,135,422,0,2566,2988,872,0,0,0,0
5420,KRISHNA,Challapalli,MANGALAPURAM,307,5,555,867,162,1,328,491,464,2315,12,3736,6063,3001,0,0,0,0
5421,KRISHNA,Challapalli,NADAKUDURU,261,0,256,517,72,0,76,148,122,827,0,735,1562,806,0,0,0,0
5422,KRISHNA,Challapalli,PAGOLU,164,2,262,428,71,0,118,189,112,766,0,1179,1945,761,0,0,0,0
5423,KRISHNA,Challapalli,PURITIGADDA,399,8,117,524,147,0,11,158,124,2166,0,108,2274,1248,0,0,0,0
5424,KRISHNA,Challapalli,VAKKALAGADDA,210,11,33,254,90,3,7,100,81,3821,131,230,4182,2021,9,0,0,9
5425,KRISHNA,Challapalli,VELIVOLU,224,30,106,360,84,0,21,105,91,1430,0,300,1730,807,0,0,0,0
5426,KRISHNA,Challapalli,YARLAGADDA,227,29,124,380,131,17,57,205,169,2451,460,949,3860,1911,1,0,0,1
5427,KRISHNA,Chandarlapadu,BOBBELLAPADU,153,17,406,576,92,3,274,369,320,3017,56,12231,15304,8499,0,0,8,8
5428,KRISHNA,Chandarlapadu,CHANDARLAPADU,866,83,2231,3180,87,25,616,728,650,873,463,10980,12316,7091,1,0,5,6
5429,KRISHNA,Chandarlapadu,CHINTALAPADU,427,3,865,1295,111,1,418,530,506,3041,14,13863,16918,10043,2,0,17,19
5430,KRISHNA,Chandarlapadu,ETURU,628,37,360,1025,299,8,59,366,350,8166,192,1500,9858,6636,5,0,2,7
5431,KRISHNA,Chandarlapadu,GUDIMETLA,284,2,1214,1500,90,1,450,541,527,2229,12,9640,11881,6856,0,0,0,0
5432,KRISHNA,Chandarlapadu,KASARABADA,161,11,461,633,119,8,304,431,414,3381,182,7811,11374,5827,0,0,1,1
5433,KRISHNA,Chandarlapadu,KODAVATIKALLU,369,58,641,1068,133,0,114,247,228,1549,0,1211,2760,1711,0,0,0,0
5434,KRISHNA,Chandarlapadu,KONAYAPALEM,662,95,755,1512,335,25,313,673,659,9440,196,8343,17979,9668,3,0,1,4
5435,KRISHNA,Chandarlapadu,KONDRAPADU,49,67,427,543,15,17,175,207,184,178,98,3347,3623,2140,0,0,0,0
5436,KRISHNA,Chandarlapadu,MUNAGALA PALLE,298,5,133,436,197,4,98,299,290,7799,146,4729,12674,8366,4,0,3,7
5437,KRISHNA,Chandarlapadu,MUPPALLA,374,9,1031,1414,195,5,446,646,594,4024,73,14540,18637,11907,0,0,7,7
5438,KRISHNA,Chandarlapadu,POKKUNURU,250,8,343,601,152,4,178,334,315,7498,95,4848,12441,6588,15,0,1,16
5439,KRISHNA,Chandarlapadu,POPURU,77,0,165,242,53,0,108,161,154,1513,0,5175,6688,4024,0,0,11,11
5440,KRISHNA,Chandarlapadu,PUNNAVALLI,144,0,153,297,100,0,72,172,162,5871,0,2712,8583,5272,16,0,1,17
5441,KRISHNA,Chandarlapadu,THOTARAVULAPADU,430,0,714,1144,225,0,236,461,445,7342,0,5309,12651,8532,6,0,3,9
5442,KRISHNA,Chandarlapadu,THURLAPADU,711,10,860,1581,127,8,435,570,569,2705,162,8983,11850,8123,2,0,0,2
5443,KRISHNA,Chandarlapadu,VELADI KOTHA PALEM,354,10,521,885,165,1,139,305,291,5314,1,3700,9015,4847,4,0,1,5
5444,KRISHNA,Chandarlapadu,VIBHAREETAPADU,43,13,317,373,4,5,124,133,115,104,193,6735,7032,3602,0,0,14,14
5445,KRISHNA,Chatrai,ARUGOLANUPETA,283,40,366,689,91,15,148,254,205,1728,380,4207,6315,3653,0,0,0,0
5446,KRISHNA,Chatrai,BURUGUGUDEM,135,5,664,804,67,0,148,215,195,1588,0,3133,4721,2586,0,0,0,0
5447,KRISHNA,Chatrai,CHANUBANDA,620,19,692,1331,264,4,207,475,437,11670,122,7556,19348,11151,31,0,11,42
5448,KRISHNA,Chatrai,CHATRAI,525,11,790,1326,205,1,253,459,432,8660,16,8301,16977,11975,8,0,0,8
5449,KRISHNA,Chatrai,CHEEPURUGUDEM,390,44,416,850,198,0,197,395,354,10780,0,5636,16416,9308,23,0,11,34
5450,KRISHNA,Chatrai,CHINNAMPETA,377,0,796,1173,98,0,432,530,429,2012,0,18120,20132,12554,0,0,22,22
5451,KRISHNA,Chatrai,CHITTAPUR,614,6,503,1123,87,1,69,157,103,3120,5,2642,5767,2912,6,0,11,17
5452,KRISHNA,Chatrai,JANARDHANAVARAM,338,17,418,773,123,3,92,218,195,4450,32,4265,8747,5611,4,0,7,11
5453,KRISHNA,Chatrai,KOTAPAADU,360,8,745,1113,115,0,236,351,280,2973,0,9174,12147,5904,0,0,6,6
5454,KRISHNA,Chatrai,KOTHAGUDEM,165,4,320,489,90,0,57,147,121,1679,0,1430,3109,1497,3,0,0,3
5455,KRISHNA,Chatrai,KRISHNARAOPALEM,91,1,247,339,52,0,51,103,86,1851,0,828,2679,1609,0,0,0,0
5456,KRISHNA,Chatrai,MARLAPALEM,373,3,637,1013,160,0,71,231,253,6308,0,2246,8554,4071,7,0,0,7
5457,KRISHNA,Chatrai,NARASIMHARAOPALEM,733,24,581,1338,200,0,121,321,296,4743,0,4119,8862,4954,1,0,4,5
5458,KRISHNA,Chatrai,PARVATAPURAM,58,3,334,395,42,0,218,260,228,1405,0,11434,12839,7426,0,0,13,13
5459,KRISHNA,Chatrai,POLAVARAM,512,20,727,1259,140,2,175,317,285,2700,23,3823,6546,3441,0,0,0,0
5460,KRISHNA,Chatrai,POTHANAPALLE,428,581,283,1292,167,52,147,366,318,9830,1044,4458,15332,8009,23,1,7,31
5461,KRISHNA,Chatrai,SOMAVARAM,72,2,351,425,43,2,136,181,159,2518,154,6729,9401,5516,6,0,7,13
5462,KRISHNA,Chatrai,TUMMAGUDEM,515,2,803,1320,222,0,115,337,284,9415,0,4997,14412,7732,26,0,10,36
5463,KRISHNA,G Konduru,ATUKURU,173,0,152,325,39,0,33,72,64,1700,0,1455,3155,2216,2,0,1,3
5464,KRISHNA,G Konduru,CH MADHAVARAM,172,217,260,649,35,15,29,79,72,1322,444,985,2751,1672,1,0,0,1
5465,KRISHNA,G Konduru,CHEVUTURU,214,20,405,639,18,0,110,128,127,187,0,3618,3805,3019,0,0,4,4
5466,KRISHNA,G Konduru,DUGGIRALAPADU,105,20,209,334,62,2,21,85,83,1463,11,256,1730,950,0,0,0,0
5467,KRISHNA,G Konduru,G. KONDURU,344,86,822,1252,24,0,40,64,59,595,0,732,1327,1005,0,0,0,0
5468,KRISHNA,G Konduru,GADDAMANUGU,236,20,175,431,6,5,33,44,37,43,279,1535,1857,911,0,0,0,0
5469,KRISHNA,G Konduru,GANGINENIPALEM,189,34,505,728,60,2,127,189,173,1963,89,4433,6485,4775,2,0,4,6
5470,KRISHNA,G Konduru,GURRAJUPALEM,5,11,227,243,0,1,54,55,53,0,8,1123,1131,672,0,0,0,0
5471,KRISHNA,G Konduru,H. MUTYALAMPADU,324,4,80,408,230,1,32,263,229,13530,36,1063,14629,8969,40,0,0,40
5472,KRISHNA,G Konduru,KATTUBADIPALEM,13,121,420,554,0,0,4,4,4,0,0,6,6,4,0,0,0,0
5473,KRISHNA,G Konduru,KAVULURU,634,30,453,1117,194,0,58,252,228,4270,0,1549,5819,4001,4,0,1,5
5474,KRISHNA,G Konduru,KODURU,326,29,445,800,127,1,37,165,151,7241,2,823,8066,4617,17,0,0,17
5475,KRISHNA,G Konduru,KONDULAPADU,280,11,166,457,101,2,54,157,123,4369,58,1882,6309,3512,11,0,1,12
5476,KRISHNA,G Konduru,KUNTAMUKKALA,475,5,364,844,180,2,74,256,249,8792,123,1483,10398,6013,22,1,2,25
5477,KRISHNA,G Konduru,NANDIGAMA,131,3,312,446,88,1,85,174,165,4339,3,3996,8338,6343,1,0,4,5
5478,KRISHNA,G Konduru,PINAPAKA,300,5,212,517,90,0,28,118,108,2141,0,304,2445,1663,2,0,0,2
5479,KRISHNA,G Konduru,SUNNAMPADU,38,12,222,272,17,0,63,80,66,992,0,2442,3434,2258,3,0,4,7
5480,KRISHNA,G Konduru,TELLADEVARAPADU,77,4,106,187,10,0,10,20,18,43,0,48,91,50,0,0,0,0
5481,KRISHNA,G Konduru,VELAGALERU,492,8,415,915,50,0,86,136,123,1983,0,2660,4643,3400,4,0,1,5
5482,KRISHNA,G Konduru,VELLATURU,874,41,667,1582,282,4,233,519,488,10405,63,9150,19618,15042,12,0,7,19
5483,KRISHNA,G Konduru,VENKATAPURAM,136,2,319,457,22,0,117,139,111,364,0,4691,5055,2945,0,0,5,5
5484,KRISHNA,Gampalagudem,AMMIREDDI GUDEM,307,19,573,899,166,11,197,374,349,5797,246,6547,12590,8583,2,0,9,11
5485,KRISHNA,Gampalagudem,ANUMOLLANKA,295,2,294,591,164,0,141,305,282,6026,0,4889,10915,6680,8,0,7,15
5486,KRISHNA,Gampalagudem,ARLAPADU,400,1,403,804,182,0,72,254,252,5639,0,1897,7536,4125,6,0,1,7
5487,KRISHNA,Gampalagudem,CHINTALANARVA,521,1,182,704,302,0,16,318,311,8576,0,376,8952,5560,10,0,0,10
5488,KRISHNA,Gampalagudem,DUNDIRALAPADU,363,21,333,717,2,0,1,3,2,3,0,20,23,11,0,0,0,0
5489,KRISHNA,Gampalagudem,GADEVARI GUDEM,2,0,377,379,0,0,290,290,292,0,0,12978,12978,6337,0,0,9,9
5490,KRISHNA,Gampalagudem,GAMPALA GUDEM,596,4,837,1437,135,0,97,232,239,5644,0,5132,10776,8700,5,0,6,11
5491,KRISHNA,Gampalagudem,GOSAVEEDU,326,8,456,790,135,2,96,233,212,4120,14,3578,7712,4243,1,0,2,3
5492,KRISHNA,Gampalagudem,GULLAPUDI,248,0,341,589,184,0,239,423,426,6869,0,8409,15278,9372,1,0,5,6
5493,KRISHNA,Gampalagudem,KANUMURU,249,3,696,948,130,1,285,416,393,4531,45,9678,14254,8607,9,0,9,18
5494,KRISHNA,Gampalagudem,KONIJERLA,377,40,562,979,161,3,86,250,248,9596,60,3752,13408,7323,33,0,6,39
5495,KRISHNA,Gampalagudem,KOTHAPALLE,118,7,382,507,74,4,163,241,238,1530,43,5697,7270,4435,0,0,1,1
5496,KRISHNA,Gampalagudem,LINGALA,181,0,285,466,137,0,160,297,297,11082,0,7286,18368,10509,46,0,10,56
5497,KRISHNA,Gampalagudem,MEDURU,352,1,287,640,203,0,142,345,330,6307,0,2746,9053,6718,2,0,1,3
5498,KRISHNA,Gampalagudem,NEMALI,362,0,335,697,228,0,77,305,297,14740,0,2865,17605,9923,42,0,0,42
5499,KRISHNA,Gampalagudem,PEDA KOMERA,300,3,268,571,168,0,43,211,243,9659,0,1240,10899,7643,23,0,3,26
5500,KRISHNA,Gampalagudem,PENUGOLANU,622,16,1307,1945,329,0,501,830,793,14338,0,13719,28057,18143,19,0,4,23
5501,KRISHNA,Gampalagudem,RAJAVARAM,150,2,118,270,99,2,57,158,158,5942,88,3155,9185,5589,16,0,2,18
5502,KRISHNA,Gampalagudem,SATYALAPADU,2,3,440,445,0,0,239,239,226,0,0,2942,2942,1641,0,0,1,1
5503,KRISHNA,Gampalagudem,SOBBALA,191,3,219,413,145,3,141,289,259,11068,246,9816,21130,11506,44,1,35,80
5504,KRISHNA,Gampalagudem,TUNIKIPADU,330,40,465,835,180,2,139,321,305,5848,84,4791,10723,5869,1,0,4,5
5505,KRISHNA,Gampalagudem,UMMADIDEVARAPALLE,132,17,146,295,87,10,69,166,160,6556,353,4576,11485,6733,22,0,18,40
5506,KRISHNA,Gampalagudem,UTUKURU,697,70,932,1699,320,0,79,399,424,14346,0,1540,15886,9218,21,0,0,21
5507,KRISHNA,Gampalagudem,VINAGADAPA,221,103,606,930,107,3,266,376,350,4328,67,11168,15563,10558,3,0,11,14
5508,KRISHNA,Gannavaram,AJJAMPUDI,221,1,68,290,86,0,25,111,109,2302,0,825,3127,1937,0,0,0,0
5509,KRISHNA,Gannavaram,ALLAPURAM,217,0,135,352,87,0,1,88,83,1481,0,10,1491,932,0,0,0,0
5510,KRISHNA,Gannavaram,BAHUBALENDRUNIGUDEM,211,13,181,405,38,2,53,93,65,2024,89,2799,4912,2647,5,0,6,11
5511,KRISHNA,Gannavaram,BUDDHAVARAM,499,8,509,1016,45,5,172,222,213,896,140,4804,5840,3621,0,0,1,1
5512,KRISHNA,Gannavaram,BUTHUMILLIPADU,49,0,10,59,33,0,4,37,38,1495,0,124,1619,1036,0,0,0,0
5513,KRISHNA,Gannavaram,CHIKKAVARAM,248,8,287,543,152,4,131,287,267,4374,119,3326,7819,5423,2,0,2,4
5514,KRISHNA,Gannavaram,CHINA AVUTAPALLE,313,0,18,331,117,0,0,117,100,6559,0,0,6559,3900,15,0,0,15
5515,KRISHNA,Gannavaram,GANNAVARAM,443,28,990,1461,77,1,142,220,196,2368,20,6047,8435,6110,1,0,9,10
5516,KRISHNA,Gannavaram,GOLLANAPALLE,353,10,452,815,121,1,179,301,288,4424,39,3958,8421,6923,4,0,0,4
5517,KRISHNA,Gannavaram,GOPAVARAPUGUDEM,173,1,207,381,60,0,66,126,108,949,0,1320,2269,1351,0,0,0,0
5518,KRISHNA,Gannavaram,JAKKULA NEKKALAM,143,0,192,335,76,0,134,210,168,1233,0,3386,4619,2482,0,0,0,0
5519,KRISHNA,Gannavaram,KESARAPALLI,696,27,468,1191,163,0,34,197,188,3741,0,957,4698,3176,0,0,0,0
5520,KRISHNA,Gannavaram,KONDAPAVULURU,447,5,295,747,156,0,73,229,207,5014,0,987,6001,4065,6,0,0,6
5521,KRISHNA,Gannavaram,KOTHAGUDEM,109,6,418,533,39,0,233,272,236,1496,0,8787,10283,6242,3,0,12,15
5522,KRISHNA,Gannavaram,MADALAVARI GUDEM,454,0,128,582,298,0,54,352,297,6047,0,1244,7291,4753,1,0,0,1
5523,KRISHNA,Gannavaram,MUSTHABADA,553,0,464,1017,64,0,25,89,84,1231,0,532,1763,1676,0,0,0,0
5524,KRISHNA,Gannavaram,PURUSHOTHAPATNAM,276,2,236,514,125,0,84,209,165,4157,0,3331,7488,4379,5,0,4,9
5525,KRISHNA,Gannavaram,SAVARIGUDEM,15,2,330,347,8,2,231,241,195,342,52,7017,7411,5099,0,0,1,1
5526,KRISHNA,Gannavaram,SURAMPALLE,581,70,460,1111,282,0,141,423,340,9165,0,6255,15420,9472,8,0,5,13
5527,KRISHNA,Gannavaram,TEMPALLE,179,0,581,760,5,0,134,139,116,149,0,3899,4048,2180,0,0,2,2
5528,KRISHNA,Gannavaram,VEERAPANENIGUDEM,197,149,522,868,38,114,134,286,195,1006,7081,4532,12619,6633,1,17,5,23
5529,KRISHNA,Ghantasala,ATCHAMPALEM,49,0,65,114,10,0,1,11,10,200,0,20,220,100,0,0,0,0
5530,KRISHNA,Ghantasala,CHILAKALAPUDI,107,0,147,254,82,0,119,201,175,3448,0,4195,7643,3857,3,0,1,4
5531,KRISHNA,Ghantasala,CHINA KALLEPALLE,215,25,72,312,116,9,10,135,119,2068,242,215,2525,1533,0,0,0,0
5532,KRISHNA,Ghantasala,CHITTURPU,451,0,75,526,171,0,9,180,163,4609,0,90,4699,2632,4,0,0,4
5533,KRISHNA,Ghantasala,CHITTURU,47,0,159,206,39,0,106,145,103,1833,0,4562,6395,2041,0,0,1,1
5534,KRISHNA,Ghantasala,DALIPARRU,255,4,110,369,171,4,46,221,172,5857,140,757,6754,3141,0,0,0,0
5535,KRISHNA,Ghantasala,DEVARAKOTA,292,6,185,483,167,2,109,278,238,5262,51,3323,8636,4619,8,0,1,9
5536,KRISHNA,Ghantasala,ENDAKUDURU,111,3,201,315,1,0,0,1,1,20,0,0,20,10,0,0,0,0
5537,KRISHNA,Ghantasala,GHANTASALA,694,70,298,1062,228,5,58,291,241,5255,51,864,6170,3698,0,0,0,0
5538,KRISHNA,Ghantasala,GHANTASALA PALEM,292,8,29,329,168,0,1,169,151,937,0,1,938,448,0,0,0,0
5539,KRISHNA,Ghantasala,GOGINENIVARI PALEM,146,2,21,169,86,0,11,97,65,3529,0,343,3872,1771,1,0,0,1
5540,KRISHNA,Ghantasala,KODALI,318,19,220,557,144,9,110,263,213,3545,164,4247,7956,4000,2,0,6,8
5541,KRISHNA,Ghantasala,KOTHAPALLE,99,0,117,216,58,0,60,118,86,588,0,539,1127,488,0,0,0,0
5542,KRISHNA,Ghantasala,LANKAPALLE,318,12,250,580,190,1,171,362,303,1722,12,2098,3832,2067,0,0,0,0
5543,KRISHNA,Ghantasala,MALLAMPALLI,29,7,527,563,23,2,427,452,333,1547,34,11756,13337,5689,7,0,0,7
5544,KRISHNA,Ghantasala,PAPAVINASANAM,376,5,384,765,108,0,59,167,156,1445,0,585,2030,1056,0,0,0,0
5545,KRISHNA,Ghantasala,PUSHADAM,76,0,140,216,58,0,108,166,60,1926,0,2742,4668,1110,0,0,0,0
5546,KRISHNA,Ghantasala,SRIKAKULAM,306,40,340,686,109,26,184,319,314,2234,354,3818,6406,3388,1,0,0,1
5547,KRISHNA,Ghantasala,TADEPALLE,174,7,139,320,100,0,10,110,97,3178,0,447,3625,1833,0,0,0,0
5548,KRISHNA,Ghantasala,TELUGURAO PALEM,221,38,0,259,132,19,0,151,146,2052,244,0,2296,1281,0,0,0,0
5549,KRISHNA,Ghantasala,V. RUDRAVARAM,182,0,53,235,128,0,21,149,130,4511,0,470,4981,2693,1,0,0,1
5550,KRISHNA,Ghantasala,VEMULAPALLE,208,1,37,246,99,1,0,100,69,1249,1,0,1250,548,0,0,0,0
5551,KRISHNA,Gudivada,BILLAPADU,310,25,571,906,129,6,196,331,310,2856,71,3174,6101,4021,0,0,0,0
5552,KRISHNA,Gudivada,BOMMULURU,699,2,72,773,222,0,13,235,230,4911,0,178,5089,3647,1,0,0,1
5553,KRISHNA,Gudivada,CHIRICHINTALA,194,2,44,240,124,0,28,152,140,1513,0,341,1854,1006,0,0,0,0
5554,KRISHNA,Gudivada,CHOWTAPALLE,373,9,94,476,141,2,0,143,126,5521,19,0,5540,2899,5,0,0,5
5555,KRISHNA,Gudivada,DONDAPADU,386,4,219,609,1,0,27,28,20,5,0,456,461,248,0,0,0,0
5556,KRISHNA,Gudivada,GUNTAKODURU,143,3,21,167,106,2,9,117,101,3647,35,263,3945,1966,1,0,0,1
5557,KRISHNA,Gudivada,KALVAPUDI AGRAHARAM,82,1,126,209,52,1,47,100,94,1211,11,729,1951,994,0,0,0,0
5558,KRISHNA,Gudivada,LINGAVARAM,315,0,292,607,66,0,0,66,60,1098,0,0,1098,775,0,0,0,0
5559,KRISHNA,Gudivada,MALLAIPALEM,71,6,381,458,6,0,30,36,22,377,0,1288,1665,765,0,0,0,0
5560,KRISHNA,Gudivada,MOTURU,317,4,375,696,157,2,128,287,253,4695,5,2471,7171,3836,1,0,0,1
5561,KRISHNA,Gudivada,NUZELLA,62,0,46,108,45,0,21,66,51,2262,0,618,2880,1574,2,0,0,2
5562,KRISHNA,Gudivada,PARNASA,66,0,150,216,29,0,90,119,101,776,0,1987,2763,1550,0,0,0,0
5563,KRISHNA,Gudivada,RAMANNAPUDI,68,7,161,236,46,5,84,135,118,1537,211,3189,4937,2480,0,0,0,0
5564,KRISHNA,Gudivada,SAIDEPUDI,55,0,68,123,40,0,32,72,62,1716,0,1340,3056,1470,1,0,1,2
5565,KRISHNA,Gudivada,SEEPUDI,206,1,136,343,43,0,39,82,52,1387,0,326,1713,672,1,0,0,1
5566,KRISHNA,Gudivada,SERI GOLVEPALLE,85,0,161,246,54,0,119,173,158,1004,0,3078,4082,2006,0,0,0,0
5567,KRISHNA,Gudivada,SERIDINTAKURRU,91,5,91,187,40,2,38,80,57,1014,63,1125,2202,957,0,0,0,0
5568,KRISHNA,Gudivada,SERIVELPUR,131,19,102,252,56,16,60,132,115,2437,1313,3043,6793,3913,4,9,8,21
5569,KRISHNA,Gudivada,SIDDHANTAM,35,0,57,92,12,0,39,51,45,735,0,2340,3075,1488,1,0,6,7
5570,KRISHNA,Gudivada,TATIVARRU,288,0,6,294,171,0,2,173,127,5372,0,69,5441,2312,0,0,0,0
5571,KRISHNA,Gudivada,VALIVARTHIPADU,397,3,203,603,0,0,0,0,0,0,0,0,0,0,0,0,0,0
5572,KRISHNA,Gudlavalleru,ANGALURU,317,5,423,745,193,1,225,419,362,3302,20,6970,10292,5852,0,0,6,6
5573,KRISHNA,Gudlavalleru,CHANDRALA,146,1,256,403,80,0,150,230,197,940,0,1529,2469,1191,0,0,0,0
5574,KRISHNA,Gudlavalleru,CHINAGONNURU,37,0,104,141,0,0,0,0,0,0,0,0,0,0,0,0,0,0
5575,KRISHNA,Gudlavalleru,CHITRAM,108,0,68,176,39,0,16,55,57,202,0,65,267,147,0,0,0,0
5576,KRISHNA,Gudlavalleru,DOKIPARRU,643,31,584,1258,126,3,91,220,212,2833,6,2289,5128,2617,0,0,0,0
5577,KRISHNA,Gudlavalleru,GADEPUDI,62,2,69,133,41,1,41,83,53,1334,26,1018,2378,1064,0,0,0,0
5578,KRISHNA,Gudlavalleru,GUDLAVALLERU,963,40,300,1303,144,5,2,151,150,4694,107,58,4859,3606,3,0,0,3
5579,KRISHNA,Gudlavalleru,KATTAVANICHERUVU,62,0,155,217,27,0,110,137,78,893,0,2725,3618,1439,0,0,0,0
5580,KRISHNA,Gudlavalleru,KOWTARAM,377,57,413,847,188,2,110,300,282,6040,11,3215,9266,6013,2,0,1,3
5581,KRISHNA,Gudlavalleru,KUCHIKAYALAPUDI,208,0,2,210,90,0,1,91,76,632,0,18,650,349,0,0,0,0
5582,KRISHNA,Gudlavalleru,KURADA,116,3,309,428,65,0,118,183,135,481,0,1060,1541,664,0,0,0,0
5583,KRISHNA,Gudlavalleru,MAMIDIKOLLA,110,0,148,258,69,0,13,82,57,702,0,90,792,437,0,0,0,0
5584,KRISHNA,Gudlavalleru,PENJENDRA,246,12,127,385,96,0,55,151,100,725,0,405,1130,496,0,0,0,0
5585,KRISHNA,Gudlavalleru,POLIMETLA,112,1,24,137,78,0,12,90,68,1780,0,196,1976,819,0,0,0,0
5586,KRISHNA,Gudlavalleru,PURITIPADU,41,0,256,297,0,0,149,149,105,0,0,3499,3499,1545,0,0,0,0
5587,KRISHNA,Gudlavalleru,SERI DAGGUMILLI,120,1,306,427,83,0,211,294,223,1915,0,4413,6328,3154,0,0,0,0
5588,KRISHNA,Gudlavalleru,SERI KALAVAPUDI,140,4,82,226,69,2,30,101,77,681,11,207,899,430,0,0,0,0
5589,KRISHNA,Gudlavalleru,VADLAMANNADU,159,0,521,680,79,0,157,236,206,2315,0,2534,4849,2588,1,0,0,1
5590,KRISHNA,Gudlavalleru,VEMAVARAM,92,3,184,279,47,2,118,167,140,1834,143,4975,6952,4021,1,1,4,6
5591,KRISHNA,Gudlavalleru,VENTURUMILLI,79,0,85,164,59,0,63,122,84,1564,0,1204,2768,1109,0,0,0,0
5592,KRISHNA,Gudlavalleru,VINNAKOTA,211,20,329,560,101,12,107,220,133,1931,112,1618,3661,1378,0,0,0,0
5593,KRISHNA,Gudlavalleru,VULAVALAPUDI,22,0,134,156,9,0,66,75,73,35,0,342,377,221,0,0,0,0
5594,KRISHNA,Gudur,AKULAMANNADU,79,1,271,351,41,1,83,125,105,1564,25,2039,3628,1708,0,0,0,0
5595,KRISHNA,Gudur,AKUMARRU,84,0,109,193,35,0,35,70,71,283,0,200,483,288,0,0,0,0
5596,KRISHNA,Gudur,CHITTIGUDURU,146,0,161,307,88,0,96,184,150,891,0,1173,2064,1067,0,0,0,0
5597,KRISHNA,Gudur,GANDRAM,33,1,95,129,17,0,35,52,27,169,0,233,402,142,0,0,0,0
5598,KRISHNA,Gudur,GUDURU,312,66,663,1041,130,24,223,377,368,3568,210,2367,6145,3676,7,0,0,7
5599,KRISHNA,Gudur,GURJEPALLE,138,16,2,156,90,0,0,90,88,2235,0,0,2235,1095,0,0,0,0
5600,KRISHNA,Gudur,IDUGULAPALLE,148,9,70,227,97,1,27,125,89,1854,10,298,2162,1040,0,0,0,0
5601,KRISHNA,Gudur,JAKKAMCHERLA,24,0,107,131,4,0,2,6,5,20,0,10,30,25,0,0,0,0
5602,KRISHNA,Gudur,KALAPATAM,72,0,77,149,58,0,31,89,75,3229,0,1548,4777,2754,7,0,0,7
5603,KRISHNA,Gudur,KANCHAKODURU,150,1,170,321,86,0,107,193,125,1530,0,1948,3478,1551,0,0,1,1
5604,KRISHNA,Gudur,KANKATAVA,189,13,345,547,119,2,196,317,276,2702,4,2662,5368,2594,0,0,0,0
5605,KRISHNA,Gudur,KAPPALADODDI,41,10,273,324,6,0,23,29,20,45,0,150,195,111,0,0,0,0
5606,KRISHNA,Gudur,KOKANARAYANAPALEM,5,6,330,341,2,2,181,185,161,6,34,2398,2438,1193,0,0,0,0
5607,KRISHNA,Gudur,LELLAGARUVU,0,0,192,192,0,0,94,94,39,0,0,1115,1115,133,0,0,0,0
5608,KRISHNA,Gudur,MADDIPATLA,47,0,82,129,40,0,63,103,82,1109,0,1209,2318,1069,0,0,0,0
5609,KRISHNA,Gudur,MALLAVOLU,173,39,1663,1875,106,11,728,845,730,3186,245,12678,16109,8023,0,0,0,0
5610,KRISHNA,Gudur,MUKKOLU,81,11,367,459,48,4,150,202,149,1880,125,4723,6728,2998,0,0,6,6
5611,KRISHNA,Gudur,NARIKEDALAPALEM,39,3,177,219,35,2,102,139,131,1123,7,2862,3992,2586,0,0,0,0
5612,KRISHNA,Gudur,PINAGUDURULANKA,0,0,91,91,0,0,0,0,0,0,0,0,0,0,0,0,0,0
5613,KRISHNA,Gudur,POLAVARAM,84,11,234,329,45,1,64,110,91,493,2,538,1033,650,0,0,0,0
5614,KRISHNA,Gudur,POSINAVARIPALEM,2,0,833,835,0,0,262,262,206,0,0,2205,2205,1015,0,0,0,0
5615,KRISHNA,Gudur,RAMANNAPETA,46,0,145,191,39,0,126,165,157,1708,0,7186,8894,4882,2,0,5,7
5616,KRISHNA,Gudur,RAMANUJA VARTHALAPALLE,32,1,184,217,16,0,128,144,131,309,0,2969,3278,1512,0,0,0,0
5617,KRISHNA,Gudur,RAMARAJUPALEM,2,1,383,386,2,0,150,152,124,14,0,2191,2205,1086,0,0,0,0
5618,KRISHNA,Gudur,RAYAVARAM,82,6,462,550,47,1,167,215,132,1270,13,3634,4917,2088,2,0,0,2
5619,KRISHNA,Gudur,TARAKATURU,181,15,418,614,112,0,90,202,155,2783,0,1186,3969,2297,0,0,0,0
5620,KRISHNA,Gudur,THUMMALAPALEM,159,0,73,232,102,0,32,134,122,1950,0,495,2445,1105,0,0,0,0
5621,KRISHNA,Ibrahimpatnam,CHILUKURU,195,1,91,287,139,0,19,158,139,3691,0,418,4109,2155,0,0,0,0
5622,KRISHNA,Ibrahimpatnam,DAMULURU,189,14,397,600,95,4,183,282,258,2455,79,5522,8056,4741,2,0,1,3
5623,KRISHNA,Ibrahimpatnam,ELAPROLU,370,2,197,569,193,1,75,269,243,4215,28,2234,6477,4561,0,0,0,0
5624,KRISHNA,Ibrahimpatnam,GUNTUPALLI,527,183,236,946,170,3,6,179,184,3659,21,83,3763,2841,0,0,0,0
5625,KRISHNA,Ibrahimpatnam,IBRAHIMPATNAM,283,90,1316,1689,2,0,232,234,231,57,0,6354,6411,5479,0,0,2,2
5626,KRISHNA,Ibrahimpatnam,JUPUDI,359,270,551,1180,79,135,176,390,383,1262,4542,3640,9444,6716,0,3,0,3
5627,KRISHNA,Ibrahimpatnam,KACHAVARAM,50,2,324,376,0,0,0,0,0,0,0,0,0,0,0,0,0,0
5628,KRISHNA,Ibrahimpatnam,KETANAKONDA,392,28,584,1004,113,1,236,350,327,6013,20,6543,12576,8804,19,0,1,20
5629,KRISHNA,Ibrahimpatnam,KONDAPALLE,506,140,703,1349,43,2,107,152,134,1313,112,4832,6257,4826,0,0,1,1
5630,KRISHNA,Ibrahimpatnam,KOTIKALAPUDI,737,1,58,796,248,0,10,258,252,5626,0,98,5724,4495,1,0,0,1
5631,KRISHNA,Ibrahimpatnam,MULAPADU,379,11,687,1077,138,2,237,377,364,1588,30,5264,6882,5511,0,0,0,0
5632,KRISHNA,Ibrahimpatnam,THUMMALAPALEM,82,14,185,281,20,4,70,94,92,294,140,3309,3743,3146,0,0,4,4
5633,KRISHNA,Jaggayyapeta,ANNAVARAM,168,58,458,684,126,51,367,544,542,8116,4046,28470,40632,23035,14,12,97,123
5634,KRISHNA,Jaggayyapeta,ANUMANCHIPALLE,238,23,955,1216,129,17,566,712,721,2316,492,13764,16572,9490,0,0,0,0
5635,KRISHNA,Jaggayyapeta,BALUSUPADU,257,24,433,714,172,10,302,484,495,8160,377,14031,22568,15523,8,0,11,19
5636,KRISHNA,Jaggayyapeta,BANDIPALEM,497,7,960,1464,309,2,573,884,934,10076,189,25726,35991,18525,3,0,18,21
5637,KRISHNA,Jaggayyapeta,BUDAWADA,148,724,552,1424,80,489,381,950,956,3486,18948,15473,37907,28409,4,8,5,17
5638,KRISHNA,Jaggayyapeta,CHILLAKALLU,794,50,1620,2464,389,11,672,1072,1140,17164,504,35867,53535,37606,23,2,80,105
5639,KRISHNA,Jaggayyapeta,DHARMAVARAPPADU,19,444,73,536,6,249,15,270,299,333,15231,724,16288,10593,0,21,1,22
5640,KRISHNA,Jaggayyapeta,GANDRAI,676,94,1324,2094,253,30,641,924,909,11694,907,21058,33659,23046,12,1,16,29
5641,KRISHNA,Jaggayyapeta,GOWRAVARAM,331,8,1047,1386,194,0,568,762,807,7651,0,27463,35114,25634,5,0,22,27
5642,KRISHNA,Jaggayyapeta,JAYANTHIPURAM,347,423,351,1121,212,257,228,697,702,6313,9382,7254,22949,16284,3,4,1,8
5643,KRISHNA,Jaggayyapeta,KOWTHAVARI AGRAHARAM,63,26,512,601,43,21,422,486,526,993,537,13143,14673,8609,0,0,0,0
5644,KRISHNA,Jaggayyapeta,MALKAPURAM,481,28,592,1101,281,20,373,674,640,14657,775,17935,33367,22585,13,0,11,24
5645,KRISHNA,Jaggayyapeta,MUKTESWARAPURAM(MUTYALA,115,142,216,473,74,72,120,266,279,5055,3739,7931,16725,11017,15,9,17,41
5646,KRISHNA,Jaggayyapeta,POCHAMPALLE,342,5,765,1112,186,2,499,687,676,6530,146,27222,33898,21398,7,0,53,60
5647,KRISHNA,Jaggayyapeta,SHERMOHAMAD PET,198,144,1741,2083,114,60,1109,1283,1312,7250,3297,57464,68011,44316,17,5,50,72
5648,KRISHNA,Jaggayyapeta,THAKKELLAPADU,352,139,472,963,249,125,337,711,753,16905,10679,19515,47099,26762,58,60,87,205
5649,KRISHNA,Jaggayyapeta,VEDADRI,72,148,320,540,57,120,206,383,375,2778,7973,12152,22903,13834,5,21,14,40
5650,KRISHNA,Kaikalur,ACHAVARAM,133,1,269,403,114,0,67,181,160,4760,0,2148,6908,3645,1,0,0,1
5651,KRISHNA,Kaikalur,ALAPADU,137,0,311,448,1,0,1,2,2,20,0,20,40,15,0,0,0,0
5652,KRISHNA,Kaikalur,ATAPAKA,202,23,288,513,0,0,0,0,0,0,0,0,0,0,0,0,0,0
5653,KRISHNA,Kaikalur,BHUJABALAPATNAM,156,1,305,462,0,0,0,0,0,0,0,0,0,0,0,0,0,0
5654,KRISHNA,Kaikalur,CHATAKAI,0,0,225,225,0,0,0,0,0,0,0,0,0,0,0,0,0,0
5655,KRISHNA,Kaikalur,DODDIPATLA,9,0,362,371,0,0,5,5,5,0,0,100,100,56,0,0,0,0
5656,KRISHNA,Kaikalur,GONEPADU,64,1,215,280,0,0,2,2,2,0,0,40,40,18,0,0,0,0
5657,KRISHNA,Kaikalur,GOPAVARAM,236,0,78,314,0,0,0,0,0,0,0,0,0,0,0,0,0,0
5658,KRISHNA,Kaikalur,GUMMALLAPADU,164,2,179,345,85,1,117,203,171,1194,20,2471,3685,1744,0,0,0,0
5659,KRISHNA,Kaikalur,KAIKALURU,214,37,498,749,64,0,2,66,58,312,0,21,333,192,0,0,0,0
5660,KRISHNA,Kaikalur,KOTTADA,49,0,332,381,0,0,3,3,3,0,0,18,18,7,0,0,0,0
5661,KRISHNA,Kaikalur,NARASAYAPALEM,4,0,117,121,0,0,0,0,0,0,0,0,0,0,0,0,0,0
5662,KRISHNA,Kaikalur,PALLEVADA,245,1,61,307,1,0,0,1,1,20,0,0,20,10,0,0,0,0
5663,KRISHNA,Kaikalur,PANDIRIPALLIGUDEM,1,0,676,677,0,0,249,249,257,0,0,5512,5512,2948,0,0,0,0
5664,KRISHNA,Kaikalur,PENCHIKALAMARRU,1,0,426,427,0,0,0,0,0,0,0,0,0,0,0,0,0,0
5665,KRISHNA,Kaikalur,RACHAPATNAM,235,0,204,439,129,0,37,166,142,1542,0,264,1806,1195,0,0,0,0
5666,KRISHNA,Kaikalur,RAMAVARAM,230,0,84,314,0,0,0,0,0,0,0,0,0,0,0,0,0,0
5667,KRISHNA,Kaikalur,SEETANAPALLE,42,4,311,357,10,0,94,104,94,31,0,365,396,234,0,0,0,0
5668,KRISHNA,Kaikalur,SRUNGAVARAPPADU,1,0,616,617,0,0,199,199,192,0,0,5626,5626,2921,0,0,0,0
5669,KRISHNA,Kaikalur,SYAMALAMBAPURAM,2,0,70,72,0,0,0,0,0,0,0,0,0,0,0,0,0,0
5670,KRISHNA,Kaikalur,TAMARAKOLLU,172,5,477,654,52,0,104,156,142,491,0,1078,1569,823,0,0,0,0
5671,KRISHNA,Kaikalur,VADARLAPADU,46,3,269,318,0,0,2,2,1,0,0,40,40,10,0,0,0,0
5672,KRISHNA,Kaikalur,VARAHAPATNAM,169,10,209,388,21,0,40,61,62,140,0,243,383,250,0,0,0,0
5673,KRISHNA,Kaikalur,VEMAVARAPPADU,144,0,242,386,60,0,97,157,97,489,0,1324,1813,756,0,0,0,0
5674,KRISHNA,Kaikalur,VINJARAM,93,9,253,355,66,0,48,114,108,2319,0,1632,3951,2750,2,0,0,2
5675,KRISHNA,Kalidindi,AMARAVATI,18,0,375,393,0,0,0,0,0,0,0,0,0,0,0,0,0,0
5676,KRISHNA,Kalidindi,AVAKURU,4,0,214,218,0,0,1,1,1,0,0,20,20,12,0,0,0,0
5677,KRISHNA,Kalidindi,BHASKARARAOPET,206,0,351,557,140,0,195,335,246,2510,0,4494,7004,3358,0,0,0,0
5678,KRISHNA,Kalidindi,CHINATADINADA,213,0,550,763,7,0,19,26,23,116,0,380,496,224,0,0,0,0
5679,KRISHNA,Kalidindi,GOPALAPURAM,6,0,316,322,0,0,142,142,125,0,0,1230,1230,633,0,0,0,0
5680,KRISHNA,Kalidindi,GURUVAIPALEM,61,2,356,419,0,0,0,0,0,0,0,0,0,0,0,0,0,0
5681,KRISHNA,Kalidindi,KALIDINDI,165,12,955,1132,0,0,0,0,0,0,0,0,0,0,0,0,0,0
5682,KRISHNA,Kalidindi,KALLAPALEM,213,2,267,482,48,0,84,132,123,719,0,707,1426,1018,2,0,0,2
5683,KRISHNA,Kalidindi,KONDANGI,32,0,657,689,0,0,0,0,0,0,0,0,0,0,0,0,0,0
5684,KRISHNA,Kalidindi,KONDURU,95,2,266,363,21,0,65,86,72,122,0,565,687,487,0,0,0,0
5685,KRISHNA,Kalidindi,KORUKOLLU,436,0,787,1223,0,0,0,0,0,0,0,0,0,0,0,0,0,0
5686,KRISHNA,Kalidindi,KOTCHERLA,114,1,220,335,0,0,2,2,2,0,0,32,32,24,0,0,0,0
5687,KRISHNA,Kalidindi,LODIDA LANKA,136,0,95,231,80,0,41,121,108,1720,0,650,2370,1251,0,0,0,0
5688,KRISHNA,Kalidindi,MATTAGUNTA,39,2,341,382,25,0,54,79,17,713,0,829,1542,234,0,0,1,1
5689,KRISHNA,Kalidindi,MULALANKA(MULUPPARIGUDE,86,0,527,613,29,0,290,319,244,659,0,5056,5715,2957,0,0,0,0
5690,KRISHNA,Kalidindi,PADAMATI PALEM,162,2,369,533,0,0,0,0,0,0,0,0,0,0,0,0,0,0
5691,KRISHNA,Kalidindi,PEDALANKA,104,6,779,889,0,0,221,221,134,0,0,4074,4074,1443,0,0,1,1
5692,KRISHNA,Kalidindi,POTHUMARRU,136,1,631,768,38,0,271,309,278,793,0,4500,5293,3957,0,0,0,0
5693,KRISHNA,Kalidindi,S R P AGRAHARAM,21,3,566,590,0,0,2,2,2,0,0,10,10,6,0,0,0,0
5694,KRISHNA,Kalidindi,SANA RUDRAVARAM,128,6,505,639,0,0,1,1,1,0,0,20,20,12,0,0,0,0
5695,KRISHNA,Kalidindi,SANTOSHAPURAM,43,0,353,396,9,0,109,118,97,38,0,943,981,531,0,0,0,0
5696,KRISHNA,Kalidindi,TADINADA,16,1,518,535,3,0,67,70,53,45,0,1090,1135,712,0,0,0,0
5697,KRISHNA,Kalidindi,VENKATAPURAM,66,0,298,364,3,0,91,94,80,3,0,3545,3548,1942,0,0,4,4
5698,KRISHNA,Kanchika Cherla,BATHINAPADU,253,0,29,282,151,0,8,159,146,4474,0,164,4638,2617,0,0,0,0
5699,KRISHNA,Kanchika Cherla,CHEVITIKALLAU,382,0,277,659,36,0,88,124,3,481,0,2623,3104,48,0,0,0,0
5700,KRISHNA,Kanchika Cherla,GANDEPALLE,661,33,286,980,156,13,4,173,172,4136,179,90,4405,2693,4,0,0,4
5701,KRISHNA,Kanchika Cherla,GANIATUKURU,51,8,522,581,0,1,187,188,107,0,32,4931,4963,1809,0,0,0,0
5702,KRISHNA,Kanchika Cherla,GOTTUMUKKALA,431,43,612,1086,158,1,38,197,202,2225,3,693,2921,1936,0,0,0,0
5703,KRISHNA,Kanchika Cherla,KANCHIKACHERLA,1577,146,1513,3236,181,1,8,190,195,3412,20,117,3549,2516,2,0,0,2
5704,KRISHNA,Kanchika Cherla,KESARA,514,26,493,1033,115,6,202,323,316,3985,171,4821,8977,5951,6,0,0,6
5705,KRISHNA,Kanchika Cherla,KOTHAPETA,465,7,185,657,133,0,20,153,138,3754,0,410,4164,2361,2,0,0,2
5706,KRISHNA,Kanchika Cherla,KUNIKINAPADU,1,33,230,264,0,12,138,150,113,0,274,3543,3817,1571,0,0,0,0
5707,KRISHNA,Kanchika Cherla,MOGULURU,435,49,532,1016,208,16,197,421,379,4493,182,3348,8023,4963,5,0,1,6
5708,KRISHNA,Kanchika Cherla,MUNNALURU,1,6,246,253,0,5,132,137,75,0,363,7755,8118,2532,0,2,12,14
5709,KRISHNA,Kanchika Cherla,PARITALA,309,29,1015,1353,13,1,119,133,135,59,20,1830,1909,1519,0,0,0,0
5710,KRISHNA,Kanchika Cherla,PENDYALA,19,3,558,580,16,2,237,255,255,584,11,6517,7112,5698,1,0,0,1
5711,KRISHNA,Kanchika Cherla,PERAKALAPADU,326,2,150,478,189,1,33,223,232,4308,6,233,4547,2698,0,0,0,0
5712,KRISHNA,Kanchika Cherla,SERI AMARAVARAM,157,0,168,325,78,0,70,148,129,2909,0,2939,5848,3127,7,0,4,11
5713,KRISHNA,Kanchika Cherla,VEMULAPALLE,336,1,361,698,85,0,107,192,178,3735,0,3441,7176,4494,7,0,2,9
5714,KRISHNA,Kankipadu,CHALIVENDRAPALEM,6,19,104,129,0,0,0,0,0,0,0,0,0,0,0,0,0,0
5715,KRISHNA,Kankipadu,DAVULURU,171,1,101,273,93,0,60,153,139,770,0,457,1227,687,0,0,0,0
5716,KRISHNA,Kankipadu,EDUPUGALLU,556,9,103,668,2,0,0,2,2,40,0,0,40,18,0,0,0,0
5717,KRISHNA,Kankipadu,GODAVARRU,444,32,170,646,308,2,61,371,361,3256,31,390,3677,1859,0,0,0,0
5718,KRISHNA,Kankipadu,GOLLAGUDEM,275,3,10,288,78,0,1,79,60,992,0,5,997,593,0,0,0,0
5719,KRISHNA,Kankipadu,JAGANNADHAPURAM,45,5,112,162,32,0,38,70,56,825,0,820,1645,679,1,0,0,1
5720,KRISHNA,Kankipadu,KANDALAMPADU,81,0,13,94,0,0,0,0,0,0,0,0,0,0,0,0,0,0
5721,KRISHNA,Kankipadu,KANKIPADU,256,7,211,474,16,0,1,17,13,119,0,5,124,63,0,0,0,0
5722,KRISHNA,Kankipadu,KASARANENIVARIPALEM,107,0,34,141,0,0,0,0,0,0,0,0,0,0,0,0,0,0
5723,KRISHNA,Kankipadu,KOLLAVENNU,618,6,184,808,186,0,11,197,166,6338,0,235,6573,3274,1,0,0,1
5724,KRISHNA,Kankipadu,KUNDERU,254,17,69,340,84,1,0,85,75,1310,30,0,1340,843,0,0,0,0
5725,KRISHNA,Kankipadu,MADDURU,161,3,352,516,59,2,191,252,237,541,14,1524,2079,1346,0,0,0,0
5726,KRISHNA,Kankipadu,MANTHENA,209,0,277,486,102,0,152,254,236,909,0,1261,2170,1009,0,0,0,0
5727,KRISHNA,Kankipadu,MAREDUMAKA,169,0,88,257,87,0,22,109,106,1091,0,253,1344,806,0,0,0,0
5728,KRISHNA,Kankipadu,NEPPALLE,284,2,150,436,90,0,66,156,146,833,0,617,1450,745,0,0,0,0
5729,KRISHNA,Kankipadu,PRODDUTURU,254,4,156,414,103,0,22,125,131,2527,0,449,2976,1593,0,0,0,0
5730,KRISHNA,Kankipadu,PUNADIPADU,217,19,372,608,0,0,25,25,24,0,0,187,187,117,0,0,0,0
5731,KRISHNA,Kankipadu,TENNERU,428,0,261,689,215,0,123,338,317,2175,0,1470,3645,1951,0,0,0,0
5732,KRISHNA,Kankipadu,UPPALURU,531,0,282,813,132,0,32,164,163,2316,0,402,2718,1679,0,0,0,0
5733,KRISHNA,Kankipadu,VELPURU,237,1,280,518,99,0,74,173,170,998,0,1217,2215,1310,0,0,0,0
5734,KRISHNA,Koduru,HAMSALADEEVI,0,0,374,374,0,0,262,262,267,0,0,15837,15837,7879,0,0,80,80
5735,KRISHNA,Koduru,JAYAPURAM,110,0,72,182,89,0,40,129,96,4679,0,1645,6324,3060,0,0,0,0
5736,KRISHNA,Koduru,KODURU,679,40,2031,2750,323,3,1015,1341,1016,5604,34,15177,20815,9600,0,0,0,0
5737,KRISHNA,Koduru,LINGAREDDIPALEM,188,17,1192,1397,126,7,777,910,833,3284,111,18335,21730,10147,0,0,0,0
5738,KRISHNA,Koduru,MACHAVARAM,19,1,458,478,9,0,325,334,294,237,0,12381,12618,6456,0,0,1,1
5739,KRISHNA,Koduru,MANDAPAKALA,38,2,963,1003,20,0,455,475,446,375,0,7484,7859,3997,0,0,0,0
5740,KRISHNA,Koduru,PITTALLANKA,223,3,573,799,128,0,276,404,250,2730,0,4358,7088,3151,0,0,0,0
5741,KRISHNA,Koduru,POTUMEEDA,26,1,525,552,13,1,302,316,300,313,27,7570,7910,4427,0,0,0,0
5742,KRISHNA,Koduru,RAMAKRISHNAPURAM,21,20,899,940,12,3,531,546,554,231,66,14645,14942,7505,0,0,6,6
5743,KRISHNA,Koduru,SALEMPALEM,161,1,626,788,90,1,292,383,347,3153,69,10191,13413,6862,0,0,1,1
5744,KRISHNA,Koduru,ULLIPALEM,252,50,629,931,91,18,244,353,293,1876,264,4865,7005,3448,0,0,1,1
5745,KRISHNA,Koduru,V.KOTHAPALEM,78,2,366,446,52,1,254,307,216,2175,36,8746,10957,4982,0,0,0,0
5746,KRISHNA,Koduru,VISWANATHAPALLE,189,4,661,854,148,2,419,569,496,3352,53,9016,12421,6143,0,0,0,0
5747,KRISHNA,Kruthivennu,CHERKUMILLI,0,16,271,287,0,7,159,166,15,0,110,3721,3831,221,0,0,0,0
5748,KRISHNA,Kruthivennu,CHINAGOLLAPALEM,112,20,1216,1348,33,3,168,204,133,250,24,1961,2235,971,0,0,0,0
5749,KRISHNA,Kruthivennu,CHINAPANDRAKA,260,36,793,1089,148,16,485,649,447,4071,434,9973,14478,5666,2,0,0,2
5750,KRISHNA,Kruthivennu,ENDAPALLI,0,0,271,271,0,0,171,171,49,0,0,3956,3956,629,0,0,0,0
5751,KRISHNA,Kruthivennu,GARISEPUDI,93,13,579,685,28,9,293,330,273,411,84,7594,8089,3552,0,0,1,1
5752,KRISHNA,Kruthivennu,INTERU,1,19,264,284,0,0,102,102,96,0,0,4367,4367,2030,0,0,4,4
5753,KRISHNA,Kruthivennu,KOMALLAPUDI,169,5,259,433,92,4,167,263,181,1720,122,4584,6426,2624,0,0,0,0
5754,KRISHNA,Kruthivennu,KRUTHUVENNU,141,48,941,1130,47,5,240,292,102,1375,187,5714,7276,1629,0,0,3,3
5755,KRISHNA,Kruthivennu,LAXMIPURAM,115,0,289,404,72,0,96,168,72,2814,0,1740,4554,1819,1,0,0,1
5756,KRISHNA,Kruthivennu,MATLAM,8,0,595,603,0,0,34,34,34,0,0,903,903,464,0,0,0,0
5757,KRISHNA,Kruthivennu,MUNIPEDA,189,4,149,342,85,1,73,159,59,1455,33,1253,2741,606,0,0,0,0
5758,KRISHNA,Kruthivennu,NEELIPUDI,22,0,370,392,14,0,239,253,22,619,0,5299,5918,414,0,0,0,0
5759,KRISHNA,Kruthivennu,NIDAMARRU,178,1,1332,1511,83,0,183,266,223,2917,0,4300,7217,2922,2,0,1,3
5760,KRISHNA,Kruthivennu,PADATADIKA,173,0,124,297,122,0,70,192,177,5809,0,3024,8833,4577,7,0,7,14
5761,KRISHNA,Kruthivennu,PALLEPALEM,5,17,714,736,1,9,163,173,154,35,221,6236,6492,2657,0,0,4,4
5762,KRISHNA,Kruthivennu,SEETHANAPALLI,191,0,274,465,89,0,147,236,167,1443,0,6393,7836,2889,0,0,9,9
5763,KRISHNA,Machilipatnam,ARISEPALLI,62,3,632,697,30,0,270,300,253,519,0,5571,6090,3348,0,0,1,1
5764,KRISHNA,Machilipatnam,BHOGIREDDIPALLE,200,2,563,765,150,1,447,598,606,3699,46,12733,16478,8037,0,0,7,7
5765,KRISHNA,Machilipatnam,BORRAPOTHUPALEM,1,1,356,358,1,0,286,287,248,6,0,2416,2422,1065,0,0,0,0
5766,KRISHNA,Machilipatnam,BUDDALAPALEM,104,2,359,465,50,0,196,246,224,1317,0,5103,6420,3848,1,0,1,2
5767,KRISHNA,Machilipatnam,CHINAKARAAGRAHARAM,39,0,321,360,2,0,71,73,64,2,0,546,548,264,0,0,0,0
5768,KRISHNA,Machilipatnam,CHINNAPURAM,203,74,1044,1321,69,34,402,505,371,582,621,4934,6137,2638,0,0,0,0
5769,KRISHNA,Machilipatnam,CHIRIVELLAPALEM,2,0,413,415,0,0,208,208,171,0,0,3553,3553,1954,0,0,0,0
5770,KRISHNA,Machilipatnam,GARALADIBBA,0,0,157,157,0,0,0,0,0,0,0,0,0,0,0,0,0,0
5771,KRISHNA,Machilipatnam,GOKAVARAM,24,2,315,341,2,2,127,131,95,62,26,4175,4263,2106,0,0,6,6
5772,KRISHNA,Machilipatnam,GOLLAPALEM,189,62,440,691,60,17,290,367,328,305,87,2719,3111,1436,0,0,0,0
5773,KRISHNA,Machilipatnam,GOPUVANIPALEM,1,0,289,290,0,0,155,155,141,0,0,4325,4325,2233,0,0,0,0
5774,KRISHNA,Machilipatnam,GUNDUPALEM,35,0,382,417,28,0,230,258,223,1005,0,3320,4325,2028,0,0,0,0
5775,KRISHNA,Machilipatnam,K.P.T.PALEM,12,3,323,338,0,0,0,0,0,0,0,0,0,0,0,0,0,0
5776,KRISHNA,Machilipatnam,KANURU,31,0,626,657,13,0,248,261,113,263,0,3796,4059,764,0,0,0,0
5777,KRISHNA,Machilipatnam,KARA AGRAHARAM,45,24,801,870,0,0,264,264,261,0,0,3319,3319,1676,0,0,0,0
5778,KRISHNA,Machilipatnam,KONA,215,0,572,787,4,0,0,4,2,11,0,0,11,4,0,0,0,0
5779,KRISHNA,Machilipatnam,MANGINAPUDI,56,0,242,298,45,0,168,213,198,882,0,3421,4303,2350,0,0,0,0
5780,KRISHNA,Machilipatnam,MEKAVARITHOTA,5,28,364,397,2,4,127,133,122,8,65,2208,2281,1478,0,0,0,0
5781,KRISHNA,Machilipatnam,NELAKURRU,77,0,198,275,58,0,163,221,207,1593,0,2579,4172,2135,0,0,0,0
5782,KRISHNA,Machilipatnam,PALLETHUMMALAPALEM,18,0,493,511,0,0,186,186,176,0,0,2056,2056,950,0,0,0,0
5783,KRISHNA,Machilipatnam,PEDA YADARA,172,6,342,520,113,4,204,321,202,1296,7,2924,4227,1773,0,0,0,0
5784,KRISHNA,Machilipatnam,PEDAPATNAM,336,0,359,695,182,0,141,323,273,4303,0,3110,7413,3668,2,0,0,2
5785,KRISHNA,Machilipatnam,POLATITIPPA,1,1,761,763,0,0,47,47,43,0,0,352,352,162,0,0,0,0
5786,KRISHNA,Machilipatnam,POTHEPALLI,6,0,436,442,4,0,179,183,119,168,0,6579,6747,2776,0,0,2,2
5787,KRISHNA,Machilipatnam,POTHIREDDIPALEM,100,0,242,342,79,0,135,214,170,2664,0,2993,5657,2607,0,0,0,0
5788,KRISHNA,Machilipatnam,POTLAPALEM,66,0,345,411,33,0,183,216,180,245,0,4597,4842,2391,0,0,0,0
5789,KRISHNA,Machilipatnam,RUDRAVARAM,215,3,319,537,119,0,177,296,297,6196,0,9729,15925,8094,12,0,21,33
5790,KRISHNA,Machilipatnam,S N GOLLAPALEM,181,0,448,629,92,0,282,374,335,2656,0,6832,9488,5870,0,0,0,0
5791,KRISHNA,Machilipatnam,SEETHARAMAPURAM,3,2,429,434,2,0,265,267,225,86,0,6905,6991,4010,0,0,0,0
5792,KRISHNA,Machilipatnam,SULTANNAGARAM,5,0,537,542,1,0,207,208,200,20,0,5491,5511,3141,0,0,0,0
5793,KRISHNA,Machilipatnam,TALLAPALEM,300,48,1830,2178,125,0,604,729,530,3193,0,8060,11253,6268,0,0,0,0
5794,KRISHNA,Machilipatnam,TAVISIPUDI,99,1,196,296,60,0,126,186,167,1828,0,4160,5988,3330,3,0,5,8
5795,KRISHNA,Machilipatnam,THUMMALACHERUVU,1,1,247,249,0,0,166,166,149,0,0,4387,4387,1954,0,0,0,0
5796,KRISHNA,Machilipatnam,VADA PALEM,192,25,774,991,86,0,474,560,436,3369,0,18888,22257,10243,2,0,15,17
5797,KRISHNA,Mandavalli,ALLINAGARAM,66,1,141,208,57,0,116,173,153,1188,0,2301,3489,2062,0,0,0,0
5798,KRISHNA,Mandavalli,APPAPURAM,92,9,45,146,33,0,9,42,38,161,0,96,257,115,0,0,0,0
5799,KRISHNA,Mandavalli,AYYAVARI RUDRAVARAM,132,1,455,588,77,0,235,312,313,875,0,2753,3628,1931,0,0,0,0
5800,KRISHNA,Mandavalli,BHYRAVAPATNAM,227,0,206,433,0,0,0,0,0,0,0,0,0,0,0,0,0,0
5801,KRISHNA,Mandavalli,CHAVALIPADU,162,0,134,296,26,0,48,74,70,288,0,252,540,388,0,0,0,0
5802,KRISHNA,Mandavalli,CHINTALAPUDI,111,1,26,138,76,1,15,92,64,1156,12,234,1402,575,0,0,0,0
5803,KRISHNA,Mandavalli,DAYYAMPADU,66,0,513,579,0,0,0,0,0,0,0,0,0,0,0,0,0,0
5804,KRISHNA,Mandavalli,GANNAVARAM,132,11,202,345,45,3,104,152,99,487,32,2651,3170,1688,0,0,0,0
5805,KRISHNA,Mandavalli,INGILIPAKALANKA,13,0,264,277,9,0,61,70,71,124,0,526,650,424,0,0,0,0
5806,KRISHNA,Mandavalli,KANUKOLLU,185,4,493,682,36,0,115,151,156,385,0,1418,1803,1021,0,0,0,0
5807,KRISHNA,Mandavalli,KORLAPADU,50,4,44,98,13,0,15,28,17,92,0,80,172,68,0,0,0,0
5808,KRISHNA,Mandavalli,KOVVADALANKA,2,0,231,233,0,0,94,94,91,0,0,1216,1216,839,0,0,0,0
5809,KRISHNA,Mandavalli,LINGALA,120,0,405,525,82,0,284,366,314,1574,0,4452,6026,3399,0,0,2,2
5810,KRISHNA,Mandavalli,LOKUMUDI,238,8,64,310,58,0,21,79,79,830,0,430,1260,799,0,0,0,0
5811,KRISHNA,Mandavalli,MANDAVALLI,281,17,511,809,129,4,149,282,246,1170,33,2019,3222,2063,0,0,0,0
5812,KRISHNA,Mandavalli,MANUGUNURU,224,0,10,234,93,0,1,94,88,1461,0,12,1473,845,0,0,0,0
5813,KRISHNA,Mandavalli,MOKHASAKALVAPUDI,2,5,95,102,1,2,59,62,26,9,47,1078,1134,472,0,0,0,0
5814,KRISHNA,Mandavalli,MUDUTHALLAPADU,284,0,0,284,0,0,0,0,0,0,0,0,0,0,0,0,0,0
5815,KRISHNA,Mandavalli,NANDIGAMALANKA,237,2,23,262,0,0,0,0,0,0,0,0,0,0,0,0,0,0
5816,KRISHNA,Mandavalli,NUTCHUMILLI,112,3,203,318,66,0,56,122,115,415,0,482,897,663,0,0,0,0
5817,KRISHNA,Mandavalli,PASALAPUDI,295,0,10,305,40,0,0,40,35,136,0,0,136,94,0,0,0,0
5818,KRISHNA,Mandavalli,PENUMAKALANKA,9,0,241,250,0,0,0,0,0,0,0,0,0,0,0,0,0,0
5819,KRISHNA,Mandavalli,PERIKIGUDEM,95,23,916,1034,25,7,228,260,246,418,93,3667,4178,2145,0,0,0,0
5820,KRISHNA,Mandavalli,PRATHIPADU,3,0,156,159,0,0,0,0,0,0,0,0,0,0,0,0,0,0
5821,KRISHNA,Mandavalli,PULAPARRU,53,0,427,480,1,0,10,11,11,20,0,190,210,110,0,0,0,0
5822,KRISHNA,Mandavalli,PUTLACHERUVU,3,1,469,473,0,0,0,0,0,0,0,0,0,0,0,0,0,0
5823,KRISHNA,Mandavalli,SINGANAPUDI,222,0,229,451,28,0,0,28,20,162,0,0,162,78,0,0,0,0
5824,KRISHNA,Mandavalli,THAKKELAPADU,184,0,190,374,63,0,122,185,167,624,0,1392,2016,1002,0,0,0,0
5825,KRISHNA,Mandavalli,UNIKILI,164,4,251,419,0,0,0,0,0,0,0,0,0,0,0,0,0,0
5826,KRISHNA,Mopidevi,BOBBARLANKA,74,0,51,125,0,0,0,0,0,0,0,0,0,0,0,0,0,0
5827,KRISHNA,Mopidevi,CHIRUVOLULANKA NORTH,78,0,288,366,25,0,100,125,109,591,0,1965,2556,1622,0,0,0,0
5828,KRISHNA,Mopidevi,K.KOTHAPALEM,261,4,386,651,74,0,136,210,125,2073,0,2833,4906,1681,0,0,0,0
5829,KRISHNA,Mopidevi,KOKKILIGADDA,200,0,202,402,15,0,0,15,14,117,0,0,117,58,0,0,0,0
5830,KRISHNA,Mopidevi,KOSURUVARIPALEM,85,28,522,635,1,0,145,146,132,20,0,3913,3933,2217,0,0,0,0
5831,KRISHNA,Mopidevi,MELLAMARTHILANKA,35,1,119,155,11,0,51,62,56,399,0,1503,1902,1025,0,0,2,2
5832,KRISHNA,Mopidevi,MERAKANAPALLE,214,16,369,599,134,1,214,349,299,5314,22,5915,11251,5827,3,0,0,3
5833,KRISHNA,Mopidevi,MOPIDEVI,834,33,808,1675,283,0,78,361,345,5990,0,1849,7839,4025,6,0,0,6
5834,KRISHNA,Mopidevi,MOPIDEVILANKA,26,0,204,230,12,0,45,57,51,478,0,1966,2444,1270,0,0,4,4
5835,KRISHNA,Mopidevi,NAGAYATIPPA,88,0,371,459,0,0,2,2,2,0,0,40,40,20,0,0,0,0
5836,KRISHNA,Mopidevi,PEDAKALLEPALLE,506,36,1282,1824,208,2,537,747,603,3495,35,9152,12682,5906,0,0,0,0
5837,KRISHNA,Mopidevi,PEDAPROLU,536,118,526,1180,202,1,252,455,441,4595,10,5258,9863,5207,0,0,0,0
5838,KRISHNA,Mopidevi,VENKATAPURAM,250,16,223,489,159,5,109,273,257,5207,48,2012,7267,3770,6,0,1,7
5839,KRISHNA,Movva,AVURUPUDI,62,8,217,287,44,7,143,194,174,1547,242,6011,7800,3486,1,0,0,1
5840,KRISHNA,Movva,AYYANKI,245,2,555,802,150,0,246,396,367,4621,0,6602,11223,6441,0,0,1,1
5841,KRISHNA,Movva,BARLAPUDI,120,0,15,135,94,0,8,102,86,3149,0,242,3391,1663,0,0,0,0
5842,KRISHNA,Movva,BHATLA PENUMARRU,498,8,296,802,300,0,176,476,437,5003,0,4095,9098,4933,0,0,0,0
5843,KRISHNA,Movva,CHINA MUTHEVI,471,13,156,640,337,9,106,452,374,9566,120,2639,12325,6036,0,0,0,0
5844,KRISHNA,Movva,GUDAPADU,177,0,127,304,115,0,79,194,190,1284,0,913,2197,1222,0,0,0,0
5845,KRISHNA,Movva,KAZA,781,13,541,1335,375,1,119,495,424,6629,10,1556,8195,4211,0,0,0,0
5846,KRISHNA,Movva,KONDAVARAM,90,1,77,168,65,0,57,122,109,4192,0,1992,6184,3439,23,0,0,23
5847,KRISHNA,Movva,KOSURU,513,10,613,1136,241,4,298,543,464,5356,33,5585,10974,5809,1,0,0,1
5848,KRISHNA,Movva,KUCHIPUDI,179,26,95,300,87,0,29,116,110,2290,0,671,2961,1699,0,0,0,0
5849,KRISHNA,Movva,MANTRIPALEM,228,10,228,466,56,3,128,187,149,2049,105,6355,8509,5681,1,0,8,9
5850,KRISHNA,Movva,MOVVA,551,61,313,925,322,11,130,463,394,14332,396,4695,19423,10933,4,0,0,4
5851,KRISHNA,Movva,MOVVAPALEM,23,1,138,162,9,0,6,15,12,22,0,26,48,25,0,0,0,0
5852,KRISHNA,Movva,NIDUMOLU,243,59,286,588,127,0,102,229,210,2397,0,2100,4497,2452,0,0,1,1
5853,KRISHNA,Movva,PALANKIPADU,23,0,175,198,9,0,131,140,123,578,0,7228,7806,3772,1,0,3,4
5854,KRISHNA,Movva,PEDAMUTTEVI,336,17,196,549,259,12,119,390,315,4716,406,2017,7139,3192,0,0,0,0
5855,KRISHNA,Movva,PEDAPUDI,79,2,301,382,51,0,76,127,113,863,0,1396,2259,1544,0,0,0,0
5856,KRISHNA,Movva,PEDASANAGALLU,324,5,461,790,203,1,223,427,366,4252,9,4617,8878,5259,0,0,0,0
5857,KRISHNA,Movva,PEDDARAIDUTHOTA,10,0,319,329,7,0,211,218,165,263,0,5255,5518,2388,0,0,0,0
5858,KRISHNA,Movva,VEMULAMADA,155,20,232,407,93,0,98,191,169,2693,0,3428,6121,3720,0,0,0,0
5859,KRISHNA,Movva,YADDANAPUDI,71,0,121,192,40,0,54,94,76,1942,0,2937,4879,2583,0,0,0,0
5860,KRISHNA,Mudinepalli,ALLURU,137,2,223,362,69,1,118,188,167,621,8,781,1410,772,0,0,0,0
5861,KRISHNA,Mudinepalli,BOMMINAMPADU,260,3,471,734,158,0,223,381,257,2200,0,3424,5624,2348,0,0,0,0
5862,KRISHNA,Mudinepalli,CHEVURU,157,5,17,179,86,3,6,95,87,931,32,95,1058,629,0,0,0,0
5863,KRISHNA,Mudinepalli,CHIGURUKOTA,458,11,482,951,214,0,288,502,440,3938,0,6085,10023,5219,0,0,0,0
5864,KRISHNA,Mudinepalli,CHINAKOMANAPUDI,7,21,253,281,5,9,127,141,131,31,49,754,834,591,0,0,0,0
5865,KRISHNA,Mudinepalli,CHINAPALAPARRU,152,0,62,214,0,0,1,1,1,0,0,20,20,10,0,0,0,0
5866,KRISHNA,Mudinepalli,DAKARAM,50,1,107,158,23,0,58,81,73,398,0,936,1334,826,0,0,0,0
5867,KRISHNA,Mudinepalli,DEVAPUDI,41,9,190,240,14,4,98,116,105,199,45,2037,2281,1307,0,0,0,0
5868,KRISHNA,Mudinepalli,EDEPALLI,3,0,154,157,1,0,61,62,6,20,0,1317,1337,71,0,0,0,0
5869,KRISHNA,Mudinepalli,GURAJA,229,106,262,597,120,0,5,125,111,1449,0,373,1822,1026,0,0,2,2
5870,KRISHNA,Mudinepalli,KAKARAVADA,191,0,275,466,116,0,181,297,294,2865,0,3536,6401,3820,0,0,0,0
5871,KRISHNA,Mudinepalli,KODURU,150,9,167,326,100,4,96,200,187,3576,154,3108,6838,3458,1,0,1,2
5872,KRISHNA,Mudinepalli,KOMARRU,22,6,212,240,9,5,108,122,88,172,74,2029,2275,1058,0,0,0,0
5873,KRISHNA,Mudinepalli,KORRAGUNTAPALEM,111,0,280,391,70,0,95,165,139,2607,0,2339,4946,2633,1,0,0,1
5874,KRISHNA,Mudinepalli,MUDINEPALLI,308,12,431,751,90,0,147,237,219,1420,0,2544,3964,2585,0,0,0,0
5875,KRISHNA,Mudinepalli,MULAKALAPALLI,143,0,22,165,109,0,10,119,101,4164,0,361,4525,2229,1,0,0,1
5876,KRISHNA,Mudinepalli,PEDA KAMANAPUDI,53,0,143,196,33,0,90,123,118,461,0,2003,2464,1415,0,0,0,0
5877,KRISHNA,Mudinepalli,PEDAGONNURU,254,29,502,785,83,0,303,386,269,2786,0,10498,13284,6613,2,0,8,10
5878,KRISHNA,Mudinepalli,PEDAPALAPARRU,345,9,158,512,209,0,73,282,283,3655,0,1166,4821,3281,0,0,0,0
5879,KRISHNA,Mudinepalli,PENUMALLI,244,0,98,342,94,0,51,145,126,588,0,454,1042,573,0,0,0,0
5880,KRISHNA,Mudinepalli,PERURU,50,4,180,234,33,3,122,158,142,550,98,2772,3420,1691,0,0,0,0
5881,KRISHNA,Mudinepalli,PEYYERU,277,6,382,665,150,1,135,286,304,4447,31,6023,10501,6323,2,0,2,4
5882,KRISHNA,Mudinepalli,PRODDUVAKA,90,27,242,359,45,14,160,219,193,1019,193,4372,5584,3066,0,0,0,0
5883,KRISHNA,Mudinepalli,SANKHARSHANAPURAM,103,0,55,158,66,0,14,80,62,2521,0,347,2868,1449,3,0,0,3
5884,KRISHNA,Mudinepalli,SINGARAYAPALEM,162,9,215,386,54,0,104,158,144,677,0,788,1465,881,0,0,0,0
5885,KRISHNA,Mudinepalli,SRIHARIPURAM,103,11,263,377,27,2,97,126,130,301,11,1460,1772,1203,0,0,0,0
5886,KRISHNA,Mudinepalli,UTUKURU,128,0,425,553,59,0,257,316,211,1954,0,6821,8775,3799,0,0,1,1
5887,KRISHNA,Mudinepalli,V.RAVIGUNTA,81,0,2,83,55,0,1,56,54,1150,0,4,1154,645,0,0,0,0
5888,KRISHNA,Mudinepalli,VADALI,133,17,736,886,45,2,313,360,346,586,12,4116,4714,3696,0,0,0,0
5889,KRISHNA,Mudinepalli,VADAVALLI,126,1,271,398,66,0,183,249,209,1780,0,4735,6515,3274,0,0,0,0
5890,KRISHNA,Mudinepalli,VAIVAKA,338,6,466,810,217,1,292,510,462,4322,7,4973,9302,4752,0,0,0,0
5891,KRISHNA,Mudinepalli,VANUDURRU,241,9,251,501,91,1,150,242,235,3356,41,9333,12730,7137,2,0,20,22
5892,KRISHNA,Musunuru,AKKIREDDIGUDEM,250,4,316,570,39,0,9,48,41,1579,0,201,1780,1059,1,0,0,1
5893,KRISHNA,Musunuru,BALIVE,206,12,257,475,31,0,120,151,124,735,0,5491,6226,4079,0,0,6,6
5894,KRISHNA,Musunuru,CHEKKAPALLI,315,1,711,1027,122,0,164,286,269,5766,0,8225,13991,7382,4,0,10,14
5895,KRISHNA,Musunuru,CHILLABOINAPALLI,139,26,318,483,67,4,180,251,200,1740,151,7788,9679,4689,2,0,11,13
5896,KRISHNA,Musunuru,CHINTALAVALLI,673,3,687,1363,204,0,29,233,181,7322,0,1651,8973,3759,11,0,1,12
5897,KRISHNA,Musunuru,GOPAVARAM,652,5,671,1328,81,0,108,189,101,1563,0,4339,5902,1678,0,0,0,0
5898,KRISHNA,Musunuru,GULLAPUDI,407,7,464,878,235,0,135,370,348,14915,0,3877,18792,10137,58,0,3,61
5899,KRISHNA,Musunuru,KATRENIPADU,807,11,625,1443,166,0,98,264,226,2412,0,1285,3697,1846,1,0,1,2
5900,KRISHNA,Musunuru,KORLAGUNTA,396,1,249,646,109,0,59,168,14,5175,0,710,5885,315,3,0,0,3
5901,KRISHNA,Musunuru,LOPUDI,283,9,680,972,104,4,168,276,228,1826,84,6057,7967,4044,0,0,4,4
5902,KRISHNA,Musunuru,MUSUNURU,734,8,683,1425,105,2,199,306,265,3111,7,11629,14747,7676,5,0,46,51
5903,KRISHNA,Musunuru,RAMANAKKAPETA,570,13,338,921,116,0,27,143,134,3714,0,1223,4937,2258,5,0,3,8
5904,KRISHNA,Musunuru,SUREPALLE,238,2,322,562,60,0,132,192,139,1871,0,5079,6950,2923,2,0,5,7
5905,KRISHNA,Musunuru,VALASAPALLI,258,12,249,519,66,2,26,94,88,1014,2,681,1697,849,0,0,0,0
5906,KRISHNA,Musunuru,VELPUCHERLA,815,74,308,1197,194,4,14,212,162,6692,136,355,7183,3287,14,1,0,15
5907,KRISHNA,Musunuru,YELLAPURAM,154,4,226,384,87,1,102,190,162,2349,2,3896,6247,3232,0,0,5,5
5908,KRISHNA,Mylavaram,CHANDRAGUDEM,359,77,1349,1785,184,6,371,561,483,9628,63,16888,26579,13491,31,0,50,81
5909,KRISHNA,Mylavaram,CHANDRALA,594,12,824,1430,170,5,204,379,340,7022,267,7945,15234,9035,8,1,9,18
5910,KRISHNA,Mylavaram,GANAPAVARAM,448,10,555,1013,182,6,195,383,351,10805,137,5113,16055,9533,39,0,0,39
5911,KRISHNA,Mylavaram,KEERTHIRAYANIGUDEM,176,380,514,1070,84,108,271,463,436,4220,4600,12980,21800,14373,12,5,17,34
5912,KRISHNA,Mylavaram,KOTHAMANGAPURAM,177,1,574,752,82,0,33,115,98,5728,0,423,6151,3745,23,0,0,23
5913,KRISHNA,Mylavaram,MORUSUMILLI,552,72,460,1084,354,46,176,576,476,10685,883,5552,17120,9011,15,0,1,16
5914,KRISHNA,Mylavaram,MYLAVARAM,512,106,1406,2024,4,1,228,233,228,32,112,8265,8409,6008,0,1,14,15
5915,KRISHNA,Mylavaram,PONDUGULA,227,590,556,1373,40,230,115,385,363,1539,9180,5999,16718,10639,2,15,18,35
5916,KRISHNA,Mylavaram,PULLURU,530,290,1101,1921,44,149,155,348,346,1020,12760,5871,19651,10059,1,66,11,78
5917,KRISHNA,Mylavaram,THOLUKODU,410,3,470,883,197,0,130,327,290,7209,0,3616,10825,6362,8,0,2,10
5918,KRISHNA,Mylavaram,VELVADAM,794,3,679,1476,191,0,51,242,238,4374,0,1156,5530,4267,2,0,2,4
5919,KRISHNA,Nagayalanka,BHAVADEVARAPALLE,77,26,601,704,47,14,350,411,375,1094,551,8388,10033,4934,0,0,0,0
5920,KRISHNA,Nagayalanka,CHODAVARAM,243,48,99,390,153,45,57,255,237,6502,1997,2955,11454,5654,2,1,3,6
5921,KRISHNA,Nagayalanka,EDURUMONDI,80,7,808,895,50,4,461,515,491,1253,70,8716,10039,4918,0,0,0,0
5922,KRISHNA,Nagayalanka,ELICHETLADIBBA,0,0,384,384,0,0,279,279,308,0,0,12547,12547,6552,0,0,1,1
5923,KRISHNA,Nagayalanka,ETIMOGA,7,0,386,393,0,0,93,93,89,0,0,949,949,585,0,0,0,0
5924,KRISHNA,Nagayalanka,GANAPESWARAM,147,10,767,924,81,0,428,509,525,1305,0,12149,13454,6588,0,0,5,5
5925,KRISHNA,Nagayalanka,GULLALAMODA,6,0,482,488,0,0,212,212,206,0,0,3903,3903,1922,0,0,0,0
5926,KRISHNA,Nagayalanka,KAMMANAMOLU,10,38,351,399,1,19,269,289,351,8,431,12350,12789,6384,0,0,17,17
5927,KRISHNA,Nagayalanka,MARRIPALEM,78,23,143,244,49,2,26,77,70,1225,17,563,1805,984,0,0,0,0
5928,KRISHNA,Nagayalanka,NAGAYALANKA,245,20,683,948,30,0,65,95,39,484,0,2739,3223,516,0,0,1,1
5929,KRISHNA,Nagayalanka,NALI,2,0,431,433,0,0,271,271,273,0,0,7087,7087,3612,0,0,0,0
5930,KRISHNA,Nagayalanka,NANGEGEDDAA,110,15,490,615,61,9,197,267,242,1452,133,5964,7549,4327,0,0,0,0
5931,KRISHNA,Nagayalanka,NATCHUGUNTA,6,0,440,446,2,0,217,219,185,47,0,6001,6048,3043,0,0,0,0
5932,KRISHNA,Nagayalanka,PARRACHIVARA,395,12,805,1212,253,0,569,822,839,4412,0,12897,17309,8673,1,0,0,1
5933,KRISHNA,Nagayalanka,PEDAKAMMAVARIPALEM,3,17,227,247,3,14,146,163,123,36,371,3945,4352,2213,0,0,0,0
5934,KRISHNA,Nagayalanka,PEDAPALEM,249,5,145,399,178,1,99,278,247,4464,38,1706,6208,2999,0,0,0,0
5935,KRISHNA,Nagayalanka,REMALAVARIPALEM,31,2,312,345,14,0,141,155,115,576,0,5376,5952,2781,0,0,0,0
5936,KRISHNA,Nagayalanka,SANGAMESWARAM,3,20,639,662,2,0,404,406,374,86,0,13509,13595,6261,0,0,7,7
5937,KRISHNA,Nagayalanka,SORLAGONDI,2,10,599,611,0,0,383,383,375,0,0,5290,5290,2735,0,0,0,0
5938,KRISHNA,Nagayalanka,T.KOTHAPALEM,119,6,338,463,73,6,187,266,181,2569,213,4826,7608,3335,0,0,0,0
5939,KRISHNA,Nagayalanka,TALAGADADEEVI,79,38,201,318,50,0,128,178,162,3254,0,9248,12502,5954,8,0,29,37
5940,KRISHNA,Nagayalanka,V.P.PALEM,302,1,124,427,191,0,70,261,272,9424,0,1810,11234,6134,5,0,3,8
5941,KRISHNA,Nandigama,ADIVIRAVULAPADU,300,11,276,587,11,0,32,43,38,276,0,1068,1344,874,0,0,3,3
5942,KRISHNA,Nandigama,AMBARUPETA,376,8,105,489,28,0,6,34,33,254,0,133,387,223,0,0,0,0
5943,KRISHNA,Nandigama,CHANDAPURAM,258,2,131,391,103,0,17,120,109,3031,0,162,3193,2334,1,0,0,1
5944,KRISHNA,Nandigama,DAMULURU,273,0,294,567,85,0,45,130,120,3713,0,1451,5164,3738,8,0,1,9
5945,KRISHNA,Nandigama,GOLLAMUDI,237,28,189,454,41,1,0,42,39,1484,27,0,1511,920,1,0,0,1
5946,KRISHNA,Nandigama,ITHAVARAM,5,14,349,368,2,1,33,36,32,418,11,1321,1750,1098,1,0,3,4
5947,KRISHNA,Nandigama,JONNALAGADDA,203,17,336,556,36,13,48,97,97,717,388,1171,2276,1442,0,0,0,0
5948,KRISHNA,Nandigama,KAMMAVARI PALEM,300,128,264,692,138,53,65,256,244,3387,1297,2508,7192,5228,1,1,2,4
5949,KRISHNA,Nandigama,KANCHELA,113,0,362,475,47,0,145,192,181,636,0,3227,3863,2997,0,0,0,0
5950,KRISHNA,Nandigama,KETHAVEERUNIPADU,268,21,338,627,121,0,19,140,121,5201,0,520,5721,3373,10,0,0,10
5951,KRISHNA,Nandigama,KONATHAMATMAKURU,158,0,331,489,55,0,70,125,121,3087,0,3384,6471,4273,8,0,5,13
5952,KRISHNA,Nandigama,KONDURU,293,6,241,540,109,3,97,209,200,1803,60,2089,3952,1997,2,0,2,4
5953,KRISHNA,Nandigama,LINGALAPADU,155,46,242,443,0,0,0,0,0,0,0,0,0,0,0,0,0,0
5954,KRISHNA,Nandigama,MAGALLU,426,5,385,816,31,0,82,113,106,390,0,861,1251,861,1,0,0,1
5955,KRISHNA,Nandigama,MUNAGACHERLA,92,0,159,251,56,0,50,106,102,2734,0,987,3721,2599,4,0,0,4
5956,KRISHNA,Nandigama,NANDIGAMA,844,64,853,1761,0,0,0,0,0,0,0,0,0,0,0,0,0,0
5957,KRISHNA,Nandigama,PALLAGIRI,247,1,269,517,118,0,49,167,166,5054,0,1792,6846,4476,10,0,5,15
5958,KRISHNA,Nandigama,PEDAVARAM,336,192,701,1229,18,37,68,123,122,287,893,1872,3052,1467,1,0,0,1
5959,KRISHNA,Nandigama,RAGHAVAPURAM,318,79,264,661,83,16,70,169,170,1188,238,1307,2733,2196,0,0,0,0
5960,KRISHNA,Nandigama,RAMIREEDIPALLE,407,12,261,680,159,4,10,173,171,6051,70,297,6418,4076,6,0,0,6
5961,KRISHNA,Nandigama,RUDRAVARAM,294,20,168,482,123,5,47,175,161,3981,116,1291,5388,2894,3,0,1,4
5962,KRISHNA,Nandigama,SOMAVARAM,195,4,312,511,80,0,33,113,107,3018,0,585,3603,1976,7,0,0,7
5963,KRISHNA,Nandigama,THAKKELLAPADU,264,0,138,402,104,0,59,163,148,2562,0,3007,5569,3428,1,0,3,4
5964,KRISHNA,Nandigama,THORRAGUDIPADU,11,0,160,171,0,0,0,0,0,0,0,0,0,0,0,0,0,0
5965,KRISHNA,Nandivada,ANAMANAPUDI,30,8,183,221,0,0,0,0,0,0,0,0,0,0,0,0,0,0
5966,KRISHNA,Nandivada,ARIPIRALA,194,1,130,325,0,0,0,0,0,0,0,0,0,0,0,0,0,0
5967,KRISHNA,Nandivada,CHEDURTHIPADU,3,0,109,112,0,0,68,68,66,0,0,1709,1709,868,0,0,0,0
5968,KRISHNA,Nandivada,CHINALINGALA,6,0,111,117,3,0,93,96,100,194,0,4517,4711,2627,0,0,1,1
5969,KRISHNA,Nandivada,DANDIGANAPUDI,137,0,156,293,36,0,71,107,87,609,0,1165,1774,1098,0,0,0,0
5970,KRISHNA,Nandivada,GANDEPUDI,0,1,53,54,0,0,0,0,0,0,0,0,0,0,0,0,0,0
5971,KRISHNA,Nandivada,ILAPARRU,232,0,393,625,0,0,0,0,0,0,0,0,0,0,0,0,0,0
5972,KRISHNA,Nandivada,JANARDHANAPURAM,505,11,377,893,276,1,76,353,320,9108,6,3161,12275,6460,2,0,0,2
5973,KRISHNA,Nandivada,KUDARAVALLI,202,2,287,491,0,0,19,19,17,0,0,222,222,102,0,0,0,0
5974,KRISHNA,Nandivada,NANDIVADA,290,59,318,667,95,2,59,156,138,1123,47,535,1705,914,0,0,0,0
5975,KRISHNA,Nandivada,ODDULAMERAKA,0,0,76,76,0,0,0,0,0,0,0,0,0,0,0,0,0,0
5976,KRISHNA,Nandivada,PEDALINGALA,174,0,153,327,103,0,63,166,147,3763,0,2688,6451,3916,1,0,0,1
5977,KRISHNA,Nandivada,PEDAVIRIVADA,145,1,55,201,0,0,0,0,0,0,0,0,0,0,0,0,0,0
5978,KRISHNA,Nandivada,POLUKONDA,219,39,183,441,0,0,1,1,1,0,0,20,20,20,0,0,0,0
5979,KRISHNA,Nandivada,PONUKUMADU,121,2,78,201,0,0,0,0,0,0,0,0,0,0,0,0,0,0
5980,KRISHNA,Nandivada,PUTTAGUNTA,228,9,153,390,146,4,75,225,215,2847,46,854,3747,2327,2,0,0,2
5981,KRISHNA,Nandivada,RAMAPURAM,115,0,15,130,39,0,1,40,28,442,0,24,466,190,0,0,0,0
5982,KRISHNA,Nandivada,RUDRAPAKA,274,5,205,484,6,0,3,9,7,22,0,6,28,15,0,0,0,0
5983,KRISHNA,Nandivada,SANKARAMPADU,160,0,2,162,0,0,0,0,0,0,0,0,0,0,0,0,0,0
5984,KRISHNA,Nandivada,TAMIRISA,506,3,413,922,34,0,52,86,67,221,0,592,813,418,0,0,0,0
5985,KRISHNA,Nandivada,THUMMALAPALLE,192,1,148,341,164,0,132,296,273,3646,0,3647,7293,3438,0,0,0,0
5986,KRISHNA,Nandivada,Venkataraghavapuram,0,0,0,0,0,0,0,0,0,0,0,0,0,0,0,0,0,0
5987,KRISHNA,Nandivada,VENNANAPUDI,237,3,66,306,96,0,4,100,95,686,0,16,702,417,0,0,0,0
5988,KRISHNA,Nuzvid,ANNAVARAM,341,8,360,709,70,3,101,174,137,2111,216,4095,6422,3751,2,1,1,4
5989,KRISHNA,Nuzvid,B.V.GUDEM,120,100,375,595,39,31,130,200,160,1999,921,5357,8277,4393,5,2,5,12
5990,KRISHNA,Nuzvid,BORAVANCHA,242,0,236,478,58,0,12,70,51,1507,0,257,1764,772,3,0,0,3
5991,KRISHNA,Nuzvid,DEVARAGUNTA,182,2,565,749,42,0,69,111,36,488,0,1019,1507,389,0,0,0,0
5992,KRISHNA,Nuzvid,DIGAVALLI,281,3,400,684,101,0,121,222,161,5781,0,7136,12917,6746,24,0,22,46
5993,KRISHNA,Nuzvid,ENAMADALA,379,29,135,543,51,0,3,54,40,1381,0,48,1429,672,1,0,0,1
5994,KRISHNA,Nuzvid,GOLLAPALLI,460,8,681,1149,17,0,132,149,90,295,0,5474,5769,2706,0,0,7,7
5995,KRISHNA,Nuzvid,H.M.GUDEM,238,21,219,478,17,5,68,90,79,330,184,1399,1913,1129,0,0,1,1
5996,KRISHNA,Nuzvid,JANGAMGUDEM,220,20,290,530,2,0,6,8,7,40,0,105,145,61,0,0,0,0
5997,KRISHNA,Nuzvid,KOTHARAVICHERLA,175,1,140,316,35,1,60,96,92,783,114,3679,4576,3044,0,1,4,5
5998,KRISHNA,Nuzvid,M.N.PALEM,103,17,329,449,57,2,75,134,64,1530,14,2417,3961,1053,0,0,5,5
5999,KRISHNA,Nuzvid,MARRIBANDAM,10,2,262,274,0,0,5,5,4,0,0,69,69,25,0,0,0,0
6000,KRISHNA,Nuzvid,MEERJAPURAM,227,3,610,840,23,0,38,61,40,594,0,467,1061,564,0,0,0,0
6001,KRISHNA,Nuzvid,MITTAGUDEM,72,14,258,344,41,4,79,124,107,2773,10,2331,5114,3132,10,0,7,17
6002,KRISHNA,Nuzvid,MORSAPUDI,92,1,182,275,0,0,2,2,1,0,0,16,16,4,0,0,0,0
6003,KRISHNA,Nuzvid,MUKKOLLUPUDU,301,0,406,707,38,0,15,53,50,1639,0,350,1989,1244,3,0,0,3
6004,KRISHNA,Nuzvid,PALLERLAMUDI,374,0,188,562,42,0,3,45,7,455,0,60,515,89,0,0,0,0
6005,KRISHNA,Nuzvid,PATHARAVICHERLA,76,2,333,411,3,0,12,15,12,15,0,140,155,88,0,0,0,0
6006,KRISHNA,Nuzvid,POLASANAPALLE,264,2,613,879,116,1,148,265,234,7675,129,8628,16432,8769,25,1,26,52
6007,KRISHNA,Nuzvid,POTHIREDDIPALLI,362,3,492,857,4,2,91,97,87,48,46,4755,4849,2594,0,0,8,8
6008,KRISHNA,Nuzvid,RAMANNAGUDEM,63,0,128,191,13,0,22,35,28,206,0,339,545,314,0,0,0,0
6009,KRISHNA,Nuzvid,SIDHARDHANAGAR,45,301,139,485,8,82,2,92,55,188,2045,100,2333,764,0,1,0,1
6010,KRISHNA,Nuzvid,SITHARAMPURAM,208,1,91,300,8,0,6,14,13,137,0,146,283,141,0,0,0,0
6011,KRISHNA,Nuzvid,SUNKOLLU,281,2,216,499,23,0,16,39,27,422,0,754,1176,404,0,0,0,0
6012,KRISHNA,Nuzvid,THURUPUDIGAVALLI,227,2,274,503,116,1,68,185,135,2544,10,1076,3630,1425,0,0,0,0
6013,KRISHNA,Nuzvid,TUKKULURU,293,2,116,411,91,1,5,97,28,1237,14,76,1327,276,0,0,0,0
6014,KRISHNA,Nuzvid,VENKATAYAPALEM,148,370,91,609,39,72,1,112,59,563,2619,18,3200,1233,0,6,0,6
6015,KRISHNA,Pamarru,ADDADA,126,7,89,222,67,3,48,118,106,2234,52,1763,4049,2454,1,0,0,1
6016,KRISHNA,Pamarru,AINAMPUDI,149,5,40,194,104,0,9,113,89,3119,0,98,3217,1994,1,0,0,1
6017,KRISHNA,Pamarru,BALLIPARRU,150,0,17,167,0,0,0,0,0,0,0,0,0,0,0,0,0,0
6018,KRISHNA,Pamarru,JUJJAVARAM,79,2,314,395,53,1,181,235,234,928,12,2961,3901,2031,0,0,0,0
6019,KRISHNA,Pamarru,KANUMURU,382,17,141,540,181,0,39,220,205,3247,0,651,3898,1805,0,0,0,0
6020,KRISHNA,Pamarru,KAPAVARAM,130,0,55,185,90,0,17,107,85,2324,0,302,2626,1266,0,0,0,0
6021,KRISHNA,Pamarru,KOMARAVOLU,331,29,138,498,143,0,47,190,178,2650,0,846,3496,1683,0,0,0,0
6022,KRISHNA,Pamarru,KONDIPARRU,151,15,101,267,74,2,17,93,77,2059,25,349,2433,1324,0,0,0,0
6023,KRISHNA,Pamarru,KORIMERLA,3,3,71,77,0,0,0,0,0,0,0,0,0,0,0,0,0,0
6024,KRISHNA,Pamarru,KURUMADDALI,157,11,270,438,72,3,65,140,131,3492,50,2236,5778,2938,5,0,3,8
6025,KRISHNA,Pamarru,NEMMAKURU,53,6,61,120,0,0,1,1,2,0,0,20,20,20,0,0,0,0
6026,KRISHNA,Pamarru,NIBHANUPUDI,130,0,37,167,75,0,1,76,71,3513,0,29,3542,1834,1,0,0,1
6027,KRISHNA,Pamarru,NIMMALURU,127,7,66,200,91,1,22,114,84,2668,7,180,2855,1740,0,0,0,0
6028,KRISHNA,Pamarru,PAMARRU,1041,94,783,1918,257,1,111,369,345,7375,17,3143,10535,7545,15,0,4,19
6029,KRISHNA,Pamarru,PASUMARRU,232,3,96,331,160,3,65,228,203,6665,98,2907,9670,4931,2,0,0,2
6030,KRISHNA,Pamarru,PEDAMADDALI,559,9,73,641,293,0,2,295,255,12062,0,92,12154,6131,2,0,0,2
6031,KRISHNA,Pamarru,POLAVARAM,1,4,77,82,0,0,31,31,21,0,0,1452,1452,807,0,0,3,3
6032,KRISHNA,Pamarru,PRAKARLA,116,0,17,133,59,0,7,66,45,1222,0,208,1430,720,0,0,0,0
6033,KRISHNA,Pamarru,RAPARLA,88,0,130,218,44,0,66,110,86,953,0,1975,2928,1803,0,0,0,0
6034,KRISHNA,Pamarru,RIMMANAPUDI,250,5,32,287,108,1,19,128,118,2159,9,835,3003,1450,0,0,0,0
6035,KRISHNA,Pamarru,UNDRAPUDI,27,2,140,169,19,1,74,94,73,964,27,2855,3846,1781,1,0,3,4
6036,KRISHNA,Pamarru,URUTURU,123,13,60,196,104,8,50,162,140,3654,306,1435,5395,2698,0,0,0,0
6037,KRISHNA,Pamarru,YELAKURRU,16,21,228,265,8,1,99,108,91,143,18,2515,2676,814,0,0,0,0
6038,KRISHNA,Pamarru,ZAMIDAGGUMILLI,1,3,94,98,0,2,34,36,19,0,50,494,544,254,0,0,0,0
6039,KRISHNA,Pamarru,ZAMIGOLVEPALLE,167,7,60,234,70,4,12,86,83,2213,146,381,2740,1755,1,0,0,1
6040,KRISHNA,Pamidimukkala,AGINIPARRU,257,16,61,334,0,0,0,0,0,0,0,0,0,0,0,0,0,0
6041,KRISHNA,Pamidimukkala,ALINEKIPALEM,0,0,141,141,0,0,0,0,0,0,0,0,0,0,0,0,0,0
6042,KRISHNA,Pamidimukkala,AMEENAPURAM,116,2,181,299,84,1,123,208,178,2044,31,2774,4849,2441,0,0,0,0
6043,KRISHNA,Pamidimukkala,CHORAGUDI,233,13,352,598,189,11,263,463,412,4323,224,4864,9411,4782,0,0,0,0
6044,KRISHNA,Pamidimukkala,FATHELANKA,2,0,89,91,0,0,5,5,2,0,0,232,232,64,0,0,0,0
6045,KRISHNA,Pamidimukkala,GOPUVANIPALEM,2,7,124,133,0,5,71,76,56,0,176,2438,2614,1263,0,0,0,0
6046,KRISHNA,Pamidimukkala,GURAZADA,198,12,288,498,109,0,144,253,231,2115,0,3530,5645,3182,0,0,0,0
6047,KRISHNA,Pamidimukkala,HANUMANTHAPURAM,258,5,222,485,189,4,131,324,302,4072,61,2456,6589,3850,0,0,0,0
6048,KRISHNA,Pamidimukkala,INAMPUDI,101,14,252,367,66,1,142,209,170,2420,47,5381,7848,3905,0,0,3,3
6049,KRISHNA,Pamidimukkala,INAPURU,145,5,110,260,106,1,32,139,132,1328,5,382,1715,1020,0,0,0,0
6050,KRISHNA,Pamidimukkala,KAPILESWARAPURAM,465,22,614,1101,242,1,225,468,421,6013,21,4151,10185,5795,0,0,0,0
6051,KRISHNA,Pamidimukkala,KRISHNAPURAM,282,0,350,632,164,0,29,193,182,5314,0,1102,6416,3980,0,0,0,0
6052,KRISHNA,Pamidimukkala,KUDERU,21,28,321,370,13,14,204,231,206,476,410,7363,8249,4188,0,0,1,1
6053,KRISHNA,Pamidimukkala,LANKAPALLI,211,0,47,258,154,0,31,185,151,1388,0,205,1593,725,0,0,0,0
6054,KRISHNA,Pamidimukkala,MAMILLAPALLI,131,0,51,182,99,0,0,99,103,2321,0,0,2321,1231,0,0,0,0
6055,KRISHNA,Pamidimukkala,MANTADA,147,1,481,629,33,0,94,127,124,918,0,2416,3334,2250,0,0,1,1
6056,KRISHNA,Pamidimukkala,MARRIVADA,254,0,314,568,137,0,176,313,285,2368,0,3126,5494,3787,0,0,0,0
6057,KRISHNA,Pamidimukkala,MEDURU,418,6,964,1388,70,1,449,520,465,975,6,10689,11670,5828,0,0,0,0
6058,KRISHNA,Pamidimukkala,MULLAPUDI,106,1,232,339,70,0,160,230,191,1852,0,2823,4675,2304,0,0,0,0
6059,KRISHNA,Pamidimukkala,PAMIDIMUKKALA,677,74,353,1104,252,15,169,436,422,5356,247,2471,8074,4499,0,0,0,0
6060,KRISHNA,Pamidimukkala,PENUMATCHA,241,0,107,348,140,0,64,204,186,5119,0,2943,8062,4134,4,0,5,9
6061,KRISHNA,Pamidimukkala,SRIRANGAPURAM,152,1,107,260,71,0,54,125,82,1667,0,1190,2857,1201,0,0,0,0
6062,KRISHNA,Pamidimukkala,TADANKI,48,7,613,668,11,0,147,158,143,238,0,3387,3625,2238,0,0,0,0
6063,KRISHNA,Pamidimukkala,VEERANKI,28,0,284,312,24,0,196,220,201,658,0,6464,7122,3749,0,0,0,0
6064,KRISHNA,Pamidimukkala,VELPURU,62,2,72,136,46,2,55,103,89,1761,58,1701,3520,1693,0,0,0,0
6065,KRISHNA,Pedana,ATCHAYYAVARIPALEM,2,0,392,394,1,0,266,267,195,6,0,3488,3494,1366,0,0,0,0
6066,KRISHNA,Pedana,BALLIPARRU,62,4,335,401,21,0,103,124,33,279,0,1435,1714,260,0,0,0,0
6067,KRISHNA,Pedana,CHENNURU,194,30,542,766,94,1,179,274,191,1466,44,3092,4602,2361,0,0,0,0
6068,KRISHNA,Pedana,CHEVENDRA,153,1,335,489,82,0,137,219,176,2898,0,2748,5646,3108,1,0,0,1
6069,KRISHNA,Pedana,CHODAVARAM,43,3,187,233,28,0,120,148,105,751,0,2814,3565,1941,0,0,0,0
6070,KRISHNA,Pedana,GURIVINDAGUNTA,0,0,197,197,0,0,128,128,82,0,0,2375,2375,853,0,0,0,0
6071,KRISHNA,Pedana,JINJERU,54,0,102,156,32,0,76,108,87,1300,0,3728,5028,2409,0,0,1,1
6072,KRISHNA,Pedana,KAKARLAMUDI,35,1,572,608,19,0,217,236,152,243,0,2546,2789,1159,0,0,0,0
6073,KRISHNA,Pedana,KAMALAPURAM,90,2,211,303,26,0,13,39,32,203,0,139,342,211,0,0,0,0
6074,KRISHNA,Pedana,KONGANCHERLA,84,0,128,212,62,0,81,143,113,3088,0,4412,7500,3325,3,0,12,15
6075,KRISHNA,Pedana,KONKEPUDI,92,0,576,668,65,0,394,459,418,1137,0,6576,7713,4711,0,0,0,0
6076,KRISHNA,Pedana,KOPPALLE,119,0,159,278,44,0,23,67,56,854,0,404,1258,763,0,0,0,0
6077,KRISHNA,Pedana,KUDURU,9,1,288,298,1,0,135,136,122,7,0,2170,2177,1229,0,0,0,0
6078,KRISHNA,Pedana,LANKALAKALAVAGUNTA,149,1,160,310,61,0,90,151,131,642,0,2051,2693,1268,0,0,0,0
6079,KRISHNA,Pedana,MADAKA,83,1,325,409,43,0,138,181,155,1159,0,2807,3966,1636,0,0,0,0
6080,KRISHNA,Pedana,MUTCHERLA,49,2,65,116,35,0,4,39,35,870,0,23,893,560,0,0,0,0
6081,KRISHNA,Pedana,NADUPURU,136,4,217,357,62,1,95,158,106,2010,6,2285,4301,1946,0,0,0,0
6082,KRISHNA,Pedana,NANDAMURU,43,0,832,875,14,0,326,340,288,346,0,7855,8201,3070,0,0,2,2
6083,KRISHNA,Pedana,NANDIGAMA,156,3,507,666,50,0,258,308,243,584,0,6767,7351,4276,0,0,2,2
6084,KRISHNA,Pedana,NELAKONDAPALLE,0,0,112,112,0,0,1,1,1,0,0,5,5,5,0,0,0,0
6085,KRISHNA,Pedana,PENUMALLI,38,0,171,209,8,0,98,106,80,143,0,2387,2530,841,0,0,0,0
6086,KRISHNA,Pedana,PULLAPADU,104,4,285,393,72,4,234,310,259,1754,58,6109,7921,3935,0,0,0,0
6087,KRISHNA,Pedana,SERIVARTHELAPALLE,42,1,133,176,0,0,37,37,31,0,0,339,339,158,0,0,0,0
6088,KRISHNA,Pedana,URIVI,78,2,367,447,26,0,192,218,156,212,0,2986,3198,1240,0,0,0,0
6089,KRISHNA,Pedaparupudi,APPIKATLA,116,3,122,241,86,0,77,163,147,2689,0,1875,4564,2224,0,0,0,0
6090,KRISHNA,Pedaparupudi,BHUSHANAGULLA,165,8,262,435,58,0,77,135,141,1020,0,887,1907,1141,0,0,0,0
6091,KRISHNA,Pedaparupudi,CHINAPARUPUDI,78,9,207,294,0,0,0,0,0,0,0,0,0,0,0,0,0,0
6092,KRISHNA,Pedaparupudi,DOSAPADU,81,11,219,311,52,2,72,126,113,2336,132,4060,6528,3165,0,0,2,2
6093,KRISHNA,Pedaparupudi,EDULAMADDALI,120,33,151,304,57,7,82,146,116,2023,207,3009,5239,2953,1,0,0,1
6094,KRISHNA,Pedaparupudi,ELAMARRU,331,21,359,711,127,0,167,294,265,6525,0,7231,13756,7043,9,0,1,10
6095,KRISHNA,Pedaparupudi,GURIVINDAGUNTA,148,0,28,176,0,0,0,0,0,0,0,0,0,0,0,0,0,0
6096,KRISHNA,Pedaparupudi,JUVVANAPUDI,89,7,76,172,69,6,55,130,114,3702,232,3414,7348,3576,4,0,7,11
6097,KRISHNA,Pedaparupudi,KORNIPADU,102,3,124,229,0,0,0,0,0,0,0,0,0,0,0,0,0,0
6098,KRISHNA,Pedaparupudi,MAHESWARAPURAM,102,0,23,125,27,0,6,33,27,288,0,68,356,162,0,0,0,0
6099,KRISHNA,Pedaparupudi,MOPARRU,91,0,292,383,41,0,142,183,130,481,0,1525,2006,899,0,0,0,0
6100,KRISHNA,Pedaparupudi,NAGAPURAM,256,0,5,261,119,0,0,119,95,3795,0,0,3795,2138,0,0,0,0
6101,KRISHNA,Pedaparupudi,PAMULAPADU,275,1,161,437,138,0,0,138,114,3245,0,0,3245,1735,0,0,0,0
6102,KRISHNA,Pedaparupudi,PEDAPARUPUDI,396,42,170,608,187,14,111,312,303,6229,292,4194,10715,6022,0,0,0,0
6103,KRISHNA,Pedaparupudi,RAVULAPADU,0,0,62,62,0,0,0,0,0,0,0,0,0,0,0,0,0,0
6104,KRISHNA,Pedaparupudi,VANAPAMULA,187,0,132,319,39,0,35,74,73,393,0,539,932,493,0,0,0,0
6105,KRISHNA,Pedaparupudi,VENTRAPRAGADA,604,15,604,1223,0,0,0,0,0,0,0,0,0,0,0,0,0,0
6106,KRISHNA,Pedaparupudi,VINJARAMPADU,43,0,191,234,0,0,0,0,0,0,0,0,0,0,0,0,0,0
6107,KRISHNA,Pedaparupudi,ZAMIDINTAKURRU,29,10,80,119,0,0,0,0,0,0,0,0,0,0,0,0,0,0
6108,KRISHNA,Penamaluru,CHODAVARAM,262,18,178,458,114,7,41,162,137,997,43,391,1431,847,0,0,0,0
6109,KRISHNA,Penamaluru,ENAMALA KUDURU,176,221,368,765,12,3,1,16,16,630,236,78,944,606,1,1,0,2
6110,KRISHNA,Penamaluru,GANGURU,436,2,58,496,165,1,0,166,147,5502,32,0,5534,2867,3,0,0,3
6111,KRISHNA,Penamaluru,GOSALA,158,3,176,337,0,0,0,0,0,0,0,0,0,0,0,0,0,0
6112,KRISHNA,Penamaluru,KANURU,259,8,107,374,0,0,0,0,0,0,0,0,0,0,0,0,0,0
6113,KRISHNA,Penamaluru,PEDAPULUPAKA,222,1,8,231,93,0,0,93,83,2277,0,0,2277,1391,0,0,0,0
6114,KRISHNA,Penamaluru,PENAMALURU,403,76,175,654,119,15,32,166,163,2599,284,672,3555,2816,0,0,0,0
6115,KRISHNA,Penamaluru,PORANKI,382,98,110,590,114,0,4,118,92,2847,0,340,3187,2054,0,0,2,2
6116,KRISHNA,Penamaluru,TADIGADAPA,270,7,106,383,54,1,0,55,52,485,10,0,495,435,0,0,0,0
6117,KRISHNA,Penamaluru,VANUKURU,661,14,36,711,368,1,6,375,377,6542,24,100,6666,3405,0,0,0,0
6118,KRISHNA,Penuganchiprolu,ANIGANDLAPADU,476,167,1185,1828,71,30,309,410,366,675,737,4693,6105,3969,0,0,0,0
6119,KRISHNA,Penuganchiprolu,GUMMADIDURRU,341,0,470,811,148,0,147,295,285,1574,0,1583,3157,2172,0,0,0,0
6120,KRISHNA,Penuganchiprolu,KOLLIKULLA,0,30,321,351,0,0,85,85,75,0,0,584,584,342,0,0,1,1
6121,KRISHNA,Penuganchiprolu,KONAKANCHI,327,25,685,1037,173,9,338,520,494,3598,220,7942,11760,8428,1,0,0,1
6122,KRISHNA,Penuganchiprolu,LINGAGUDEM,225,48,270,543,141,25,138,304,281,2499,435,1881,4815,2937,0,0,0,0
6123,KRISHNA,Penuganchiprolu,MUNCHINTALA,447,43,228,718,196,13,61,270,245,3578,111,803,4492,3266,0,0,0,0
6124,KRISHNA,Penuganchiprolu,MUNDLAPADU,217,2,556,775,136,1,264,401,363,1923,102,5887,7912,5317,0,1,4,5
6125,KRISHNA,Penuganchiprolu,NAWABPETA,389,14,945,1348,129,8,206,343,325,2203,92,5113,7408,4962,0,0,4,4
6126,KRISHNA,Penuganchiprolu,PENUGANCHIPROLU,1016,65,1696,2777,315,21,358,694,683,3860,273,4929,9062,7100,0,0,0,0
6127,KRISHNA,Penuganchiprolu,SANAGAPADU,473,28,209,710,173,2,89,264,245,4079,41,2575,6695,3910,5,0,2,7
6128,KRISHNA,Penuganchiprolu,SIVAPURAM,151,180,73,404,0,0,0,0,0,0,0,0,0,0,0,0,0,0
6129,KRISHNA,Penuganchiprolu,SUBBAYAGUDEM,247,0,170,417,151,0,51,202,196,4702,0,760,5462,3778,3,0,0,3
6130,KRISHNA,Penuganchiprolu,THOTACHERLA,276,7,323,606,160,2,168,330,299,3505,27,3985,7517,4104,0,0,0,0
6131,KRISHNA,Penuganchiprolu,VENGANAIKUNIPALEM,118,0,275,393,77,0,149,226,215,2074,0,3762,5836,3922,0,0,0,0
6132,KRISHNA,Penuganchiprolu,VENKATAPURAM,240,7,143,390,201,3,47,251,215,9014,33,1377,10424,4737,7,0,4,11
6133,KRISHNA,Reddigudem,ANNERAOPETA,300,129,412,841,109,2,160,271,259,4788,24,8868,13680,10502,8,0,28,36
6134,KRISHNA,Reddigudem,KUDAPA,314,214,658,1186,119,111,202,432,397,5384,7003,8282,20669,13655,12,29,16,57
6135,KRISHNA,Reddigudem,KUNAPARAJUPARVA,700,6,1094,1800,307,2,247,556,495,7743,47,2934,10724,6711,2,0,0,2
6136,KRISHNA,Reddigudem,MADDULAPARVA,274,38,1098,1410,89,1,347,437,401,2713,62,15931,18706,14423,2,0,34,36
6137,KRISHNA,Reddigudem,MUTCHINAPALLE,630,2,936,1568,243,0,424,667,585,6778,0,20333,27111,16063,6,0,49,55
6138,KRISHNA,Reddigudem,NAGULURU,265,226,1012,1503,92,15,361,468,436,4495,202,8051,12748,8943,9,0,1,10
6139,KRISHNA,Reddigudem,NARUKULLAPADU,223,11,690,924,112,0,136,248,204,3929,0,4878,8807,4062,0,0,12,12
6140,KRISHNA,Reddigudem,PATHANAGULURU,105,4,322,431,14,3,106,123,104,197,56,3172,3425,1856,0,0,2,2
6141,KRISHNA,Reddigudem,RANGAPURAM,722,14,1080,1816,183,1,351,535,412,6363,15,15549,21927,11053,13,0,28,41
6142,KRISHNA,Reddigudem,REDDIGUDEM,1029,17,1834,2880,182,1,410,593,510,4241,20,12601,16862,9788,0,0,6,6
6143,KRISHNA,Reddigudem,RUDRAVARAM,351,210,521,1082,134,46,123,303,278,6144,746,5507,12397,7281,13,0,14,27
6144,KRISHNA,Thotlavalluru,BADRIRAJUPALEM,274,2,226,502,180,0,60,240,197,4921,0,726,5647,2911,0,0,0,0
6145,KRISHNA,Thotlavalluru,BODDAPADU,154,1,138,293,70,0,49,119,103,1296,0,778,2074,1325,0,0,0,0
6146,KRISHNA,Thotlavalluru,CHAGANTIPADU,421,28,235,684,135,15,78,228,213,984,124,506,1614,842,0,0,0,0
6147,KRISHNA,Thotlavalluru,CHINAPULIPAKA,80,23,168,271,45,10,99,154,134,945,123,1993,3061,1915,0,0,0,0
6148,KRISHNA,Thotlavalluru,DEVARAPALLE,185,25,393,603,105,11,132,248,242,748,80,923,1751,938,0,0,0,0
6149,KRISHNA,Thotlavalluru,GARIKAPARRU,342,0,328,670,268,0,177,445,430,4000,0,1701,5701,3014,0,0,0,0
6150,KRISHNA,Thotlavalluru,GURIVINDAPALLI,174,4,88,266,122,3,71,196,194,1546,30,808,2384,1308,0,0,0,0
6151,KRISHNA,Thotlavalluru,ILURU,89,4,267,360,63,2,105,170,170,1278,23,3010,4311,2392,0,0,0,0
6152,KRISHNA,Thotlavalluru,KANAKAVALLI,7,9,181,197,0,4,123,127,119,0,37,5017,5054,3121,0,0,0,0
6153,KRISHNA,Thotlavalluru,KUMMAMURU,248,17,61,326,169,12,44,225,207,4095,325,1189,5609,3365,0,0,0,0
6154,KRISHNA,Thotlavalluru,PAMULALANKA,366,0,5,371,288,0,1,289,262,4017,0,6,4023,2342,0,0,0,0
6155,KRISHNA,Thotlavalluru,PENAMAKURU,221,10,279,510,143,6,208,357,348,1482,46,2858,4386,2427,0,0,0,0
6156,KRISHNA,Thotlavalluru,ROYYURU,216,2,395,613,156,0,210,366,341,998,0,2175,3173,1535,0,0,0,0
6157,KRISHNA,Thotlavalluru,THOTLAVALLURU,754,51,707,1512,391,2,339,732,702,2437,12,2933,5382,3065,0,0,0,0
6158,KRISHNA,Thotlavalluru,VALLURUPALEM,337,16,401,754,221,8,204,433,411,2273,48,1310,3631,1903,0,0,0,0
6159,KRISHNA,Thotlavalluru,YAKAMURU,200,4,137,341,110,0,29,139,111,2339,0,418,2757,1504,0,0,0,0
6160,KRISHNA,Tiruvuru,AKKAPALEM,102,1,319,422,72,1,198,271,242,2927,40,9959,12926,8464,2,0,11,13
6161,KRISHNA,Tiruvuru,ANJANEYAPURAM,268,31,147,446,171,8,97,276,288,5530,81,2030,7641,5724,3,0,0,3
6162,KRISHNA,Tiruvuru,CHINTALAPADU,261,10,161,432,168,2,61,231,221,8258,123,2185,10566,8346,9,0,2,11
6163,KRISHNA,Tiruvuru,CHITTELA,124,11,213,348,65,7,98,170,167,2434,153,4294,6881,4929,0,0,4,4
6164,KRISHNA,Tiruvuru,CHOWTAPALLI,230,4,379,613,135,3,165,303,258,5503,102,5341,10946,5550,13,0,6,19
6165,KRISHNA,Tiruvuru,ERRAMADU,307,1,197,505,111,0,89,200,189,4316,0,3543,7859,5357,4,0,3,7
6166,KRISHNA,Tiruvuru,ERUKAPADU,325,1,138,464,189,0,55,244,255,8534,0,2414,10948,6108,13,0,7,20
6167,KRISHNA,Tiruvuru,G.KOTHURU,147,7,560,714,70,1,218,289,267,687,40,3789,4516,2953,0,0,0,0
6168,KRISHNA,Tiruvuru,GANUGAPADU,153,2,274,429,106,0,142,248,212,5010,0,4530,9540,5232,4,0,2,6
6169,KRISHNA,Tiruvuru,KAKARLA,234,6,191,431,130,0,85,215,203,6935,0,3652,10587,7141,12,0,8,20
6170,KRISHNA,Tiruvuru,KOKILAMPADU,255,51,375,681,132,5,199,336,329,4263,447,9683,14393,10287,0,2,9,11
6171,KRISHNA,Tiruvuru,KOMMIREDDIPALLI,449,1,112,562,312,0,48,360,352,18295,0,2750,21045,11413,28,0,0,28
6172,KRISHNA,Tiruvuru,LAXMIPURAM,286,1,242,529,147,0,135,282,255,2033,0,4884,6917,4932,0,0,2,2
6173,KRISHNA,Tiruvuru,MALLELA,343,39,397,779,180,10,152,342,343,6797,328,5750,12875,9237,4,2,3,9
6174,KRISHNA,Tiruvuru,MUNUKULLA,362,16,634,1012,287,10,462,759,773,13943,379,14797,29119,16056,7,0,1,8
6175,KRISHNA,Tiruvuru,MUSTIKUNTLA,300,8,282,590,227,1,94,322,319,12555,50,3270,15875,11155,22,0,3,25
6176,KRISHNA,Tiruvuru,PEDDAVARAM,89,1,300,390,74,0,221,295,284,1649,0,5016,6665,3607,0,0,0,0
6177,KRISHNA,Tiruvuru,ROLUPADI,413,44,419,876,212,20,190,422,407,9090,637,5628,15355,13042,5,0,1,6
6178,KRISHNA,Tiruvuru,TIRUVURU,1267,162,2425,3854,0,0,0,0,0,0,0,0,0,0,0,0,0,0
6179,KRISHNA,Tiruvuru,VAMAKUNTLA,152,10,394,556,121,1,261,383,372,5287,30,12498,17815,12955,5,0,13,18
6180,KRISHNA,Tiruvuru,VAVILALA,514,53,597,1164,327,0,235,562,501,8858,0,10001,18859,10519,0,0,8,8
6181,KRISHNA,Unguturu,AMUDALAPALLI,109,2,108,219,58,0,39,97,76,2640,0,1203,3843,1116,0,0,0,0
6182,KRISHNA,Unguturu,ATKURU,323,13,278,614,138,1,137,276,246,4435,50,4523,9008,5145,3,0,1,4
6183,KRISHNA,Unguturu,BOKINALA,89,0,79,168,72,0,50,122,87,1620,0,892,2512,1215,0,0,0,0
6184,KRISHNA,Unguturu,CHAGANTIPADU,0,0,216,216,0,0,157,157,133,0,0,7364,7364,4126,0,0,14,14
6185,KRISHNA,Unguturu,CHIKINALA,55,3,13,71,47,2,2,51,46,2169,32,60,2261,1137,0,0,0,0
6186,KRISHNA,Unguturu,ELUKAPADU,111,8,15,134,63,4,10,77,63,2086,143,397,2626,1332,0,0,0,0
6187,KRISHNA,Unguturu,GARAPADU,138,0,65,203,117,0,41,158,155,2108,0,725,2833,1439,0,0,0,0
6188,KRISHNA,Unguturu,INDUPALLI,248,43,237,528,120,24,112,256,252,2838,160,1860,4858,2771,0,0,0,0
6189,KRISHNA,Unguturu,KOYYAGURAPADU,114,7,194,315,54,5,116,175,147,576,94,2313,2983,1510,0,0,0,0
6190,KRISHNA,Unguturu,LANKAPALLI AGRAHARAM,172,9,79,260,127,5,40,172,149,4201,71,874,5146,2369,0,0,0,0
6191,KRISHNA,Unguturu,MADHIRAPADU,86,0,16,102,59,0,13,72,58,1818,0,309,2127,1141,0,0,0,0
6192,KRISHNA,Unguturu,MANIKONDA,414,39,111,564,242,0,0,242,235,5425,0,0,5425,3007,0,0,0,0
6193,KRISHNA,Unguturu,MUKKAPADU,141,3,111,255,108,0,65,173,143,5305,0,3610,8915,5053,15,0,11,26
6194,KRISHNA,Unguturu,NAGAVARAPPADU,84,0,187,271,6,0,85,91,91,26,0,1677,1703,857,0,0,0,0
6195,KRISHNA,Unguturu,NANDAMURU,152,2,161,315,71,1,72,144,122,2689,35,2511,5235,2836,2,0,2,4
6196,KRISHNA,Unguturu,NARAYAPPARAOPET,91,0,51,142,3,0,20,23,22,35,0,356,391,171,0,0,0,0
6197,KRISHNA,Unguturu,PEDOUTAPALLI,208,63,292,563,18,9,66,93,77,177,130,1131,1438,961,0,0,0,0
6198,KRISHNA,Unguturu,PONUKUMADU,1,0,156,157,0,0,0,0,0,0,0,0,0,0,0,0,0,0
6199,KRISHNA,Unguturu,POTTIPADU,221,15,196,432,144,9,121,274,253,5342,108,2825,8275,4111,3,0,2,5
6200,KRISHNA,Unguturu,TARIGOPPALA,136,4,228,368,58,1,104,163,144,1347,2,2268,3617,2259,0,0,0,0
6201,KRISHNA,Unguturu,TELAPROLU,526,0,548,1074,141,0,202,343,320,2038,0,8370,10408,6287,0,0,3,3
6202,KRISHNA,Unguturu,TUTTAGUNTA,49,0,32,81,41,0,27,68,57,1372,0,667,2039,906,0,0,0,0
6203,KRISHNA,Unguturu,UNGUTURU,183,15,330,528,18,7,23,48,41,93,46,178,317,165,0,0,0,0
6204,KRISHNA,Unguturu,VELDIPADU,218,0,95,313,182,0,55,237,226,2285,0,311,2596,1418,0,0,0,0
6205,KRISHNA,Unguturu,VELINUTHALA,4,0,152,156,2,0,99,101,85,8,0,3059,3067,1653,0,0,0,0
6206,KRISHNA,Unguturu,VEMANDA,126,1,129,256,89,0,78,167,142,1245,0,1509,2754,1541,0,0,0,0
6207,KRISHNA,Unguturu,VEMPADU,76,1,233,310,40,0,120,160,137,525,0,3017,3542,2040,0,0,0,0
6208,KRISHNA,Vatsavai,ALLURUPADU,164,0,162,326,71,0,79,150,135,2336,0,3835,6171,3929,1,0,9,10
6209,KRISHNA,Vatsavai,BHIMAVARAM,568,24,943,1535,161,2,173,336,329,2491,32,2281,4804,2737,1,0,0,1
6210,KRISHNA,Vatsavai,CHINA MODUGAPALLE,154,11,111,276,97,0,46,143,140,5935,0,2127,8062,4649,15,0,7,22
6211,KRISHNA,Vatsavai,CHITTELA,393,20,237,650,266,1,139,406,389,9650,5,3604,13259,7887,3,0,0,3
6212,KRISHNA,Vatsavai,DABBAKUPALLE,235,6,646,887,38,4,272,314,308,625,55,4689,5369,3260,0,0,0,0
6213,KRISHNA,Vatsavai,DECHUPALEM,140,1,190,331,66,1,91,158,145,1018,18,1395,2431,1835,0,0,0,0
6214,KRISHNA,Vatsavai,GOPINENIPALEM,237,278,171,686,112,130,20,262,262,4751,3095,330,8176,5096,10,0,0,10
6215,KRISHNA,Vatsavai,INDUGAPALLE,268,1,460,729,150,0,252,402,408,6454,0,10435,16889,10523,10,0,12,22
6216,KRISHNA,Vatsavai,KAKARAVAI,246,2,297,545,164,2,188,354,346,7653,75,6284,14012,7534,9,0,6,15
6217,KRISHNA,Vatsavai,KAMBAMPADU,413,18,792,1223,229,8,359,596,555,9350,209,9348,18907,12737,2,0,3,5
6218,KRISHNA,Vatsavai,KANNEVEEDU,215,185,215,615,2,68,89,159,151,52,2968,4593,7613,4301,0,6,3,9
6219,KRISHNA,Vatsavai,LINGALA,137,0,340,477,80,0,198,278,253,4925,0,11131,16056,10653,11,0,20,31
6220,KRISHNA,Vatsavai,MACHINENIPALEM,194,185,127,506,37,40,24,101,86,339,497,247,1083,525,0,0,0,0
6221,KRISHNA,Vatsavai,MAKKAPETA,318,128,534,980,136,69,294,499,510,2977,2347,9185,14509,10567,1,4,6,11
6222,KRISHNA,Vatsavai,MANGOLLU,392,4,423,819,115,0,126,241,250,1622,0,2111,3733,2492,0,0,0,0
6223,KRISHNA,Vatsavai,PEDA MODUGA PALLE,215,0,157,372,162,0,83,245,250,7122,0,3855,10977,6910,7,0,4,11
6224,KRISHNA,Vatsavai,PENTALAVARIGUDEM,74,3,339,416,49,0,197,246,237,2468,0,8708,11176,6191,4,0,9,13
6225,KRISHNA,Vatsavai,POCHAVARAM,143,8,145,296,90,2,43,135,122,3200,89,2035,5324,3191,0,0,3,3
6226,KRISHNA,Vatsavai,POLAMPALLE,344,37,615,996,212,15,256,483,512,5633,166,5554,11353,7168,1,0,5,6
6227,KRISHNA,Vatsavai,SINGAVARAM,128,7,148,283,93,0,77,170,183,3656,0,2343,5999,3514,0,0,1,1
6228,KRISHNA,Vatsavai,TALLURU,2,4,348,354,1,1,133,135,113,22,4,3204,3230,1697,0,0,0,0
6229,KRISHNA,Vatsavai,VATSAVAI,576,127,1058,1761,236,44,167,447,449,6358,1386,3832,11576,8177,2,1,3,6
6230,KRISHNA,Vatsavai,VEMAVARAM,277,10,264,551,164,2,69,235,224,5517,164,2474,8155,5312,3,0,0,3
6231,KRISHNA,Vatsavai,VEMULANARVA,152,13,286,451,109,10,109,228,233,4141,319,2008,6468,4699,2,0,1,3
6232,KRISHNA,Veerullapadu,ALLURU,653,47,739,1439,112,19,234,365,352,2123,209,5792,8124,4672,2,0,0,2
6233,KRISHNA,Veerullapadu,BODAVADA,200,14,152,366,92,1,37,130,124,4871,20,1382,6273,4039,12,0,4,16
6234,KRISHNA,Veerullapadu,CHATTANNAVARAM,236,0,5,241,37,0,0,37,36,1080,0,0,1080,648,1,0,0,1
6235,KRISHNA,Veerullapadu,CHAVATAPALLE,358,37,151,546,32,18,31,81,70,464,522,658,1644,956,0,1,0,1
6236,KRISHNA,Veerullapadu,CHENNARAO PALEM,149,110,188,447,82,31,17,130,123,1380,338,233,1951,1136,0,0,0,0
6237,KRISHNA,Veerullapadu,DACHAVARAM,93,6,195,294,42,0,50,92,84,521,0,494,1015,570,0,0,0,0
6238,KRISHNA,Veerullapadu,DODDA DEVARAPADU,262,1,481,744,155,0,40,195,179,9449,0,743,10192,5939,23,0,0,23
6239,KRISHNA,Veerullapadu,GOKARAJUPALLE,47,14,67,128,2,1,2,5,5,54,48,18,120,73,0,0,0,0
6240,KRISHNA,Veerullapadu,GUDEM MADHAVARAM,213,6,277,496,82,3,98,183,166,1839,137,2364,4340,2759,0,0,0,0
6241,KRISHNA,Veerullapadu,JAGANNADHAPURAM,149,0,32,181,37,0,1,38,38,387,0,6,393,225,0,0,0,0
6242,KRISHNA,Veerullapadu,JAMMAVARAM,221,9,82,312,58,5,41,104,98,1985,98,2637,4720,2918,0,0,14,14
6243,KRISHNA,Veerullapadu,JAYANTHI,465,0,951,1416,49,0,141,190,175,844,0,1832,2676,1822,0,0,0,0
6244,KRISHNA,Veerullapadu,JUJJURU,391,139,1002,1532,8,59,40,107,103,86,1385,581,2052,1089,0,0,0,0
6245,KRISHNA,Veerullapadu,KONATALAPALLE,373,0,434,807,18,0,21,39,40,322,0,393,715,390,0,0,0,0
6246,KRISHNA,Veerullapadu,NANDALURU,213,0,48,261,84,0,6,90,82,2980,0,335,3315,1894,7,0,1,8
6247,KRISHNA,Veerullapadu,NARASIMHARAO PALEM,81,0,456,537,40,0,205,245,236,773,0,6642,7415,4524,0,0,3,3
6248,KRISHNA,Veerullapadu,PEDDAPURAM,376,14,585,975,98,0,18,116,99,1707,0,293,2000,954,0,0,0,0
6249,KRISHNA,Veerullapadu,PONNAVARAM,332,6,283,621,197,0,15,212,219,1441,0,145,1586,886,0,0,0,0
6250,KRISHNA,Veerullapadu,THADIGUMMI,151,3,142,296,1,0,8,9,7,12,0,118,130,60,0,0,0,0
6251,KRISHNA,Veerullapadu,VAIRIDHARI ANNAVARAM,262,0,99,361,154,0,15,169,162,6811,0,476,7287,3941,14,0,0,14
6252,KRISHNA,Veerullapadu,VEERULLAPADU,723,41,240,1004,218,25,84,327,290,6397,1314,4833,12544,7512,8,4,15,27
6253,KRISHNA,Veerullapadu,VELLANKI,276,13,596,885,86,0,144,230,219,3303,0,4508,7811,5581,6,0,8,14
6254,KRISHNA,Vijayawada Rural,AMBAPURAM,234,2,92,328,95,0,51,146,121,655,0,321,976,582,0,0,0,0
6255,KRISHNA,Vijayawada Rural,ENIKEPADU,244,34,118,396,0,0,0,0,0,0,0,0,0,0,0,0,0,0
6256,KRISHNA,Vijayawada Rural,GOLLAPUDI,763,74,359,1196,0,0,0,0,0,0,0,0,0,0,0,0,0,0
6257,KRISHNA,Vijayawada Rural,GUDAVALLI,233,1,36,270,25,1,0,26,25,443,9,0,452,256,0,0,0,0
6258,KRISHNA,Vijayawada Rural,JAKKAMPUDI,234,27,334,595,46,10,206,262,210,697,90,2517,3304,1838,0,0,0,0
6259,KRISHNA,Vijayawada Rural,NIDAMANURU,222,3,34,259,0,0,0,0,0,0,0,0,0,0,0,0,0,0
6260,KRISHNA,Vijayawada Rural,NUNNA,396,23,148,567,0,0,58,58,54,0,0,4126,4126,2819,0,0,15,15
6261,KRISHNA,Vijayawada Rural,PAIDURUPADU,522,7,13,542,119,2,0,121,115,1010,22,0,1032,906,0,0,0,0
6262,KRISHNA,Vijayawada Rural,PATHAPADU,283,62,236,581,96,32,58,186,171,5116,1826,2559,9501,6757,9,4,1,14
6263,KRISHNA,Vijayawada Rural,PHIRYADI NAINAVARAM,126,4,252,382,34,0,2,36,35,690,0,35,725,326,0,0,0,0
6264,KRISHNA,Vijayawada Rural,PRASADAMPADU,369,1,143,513,0,0,0,0,0,0,0,0,0,0,0,0,0,0
6265,KRISHNA,Vijayawada Rural,RAMAVARAPPADU,133,20,327,480,0,0,0,0,0,0,0,0,0,0,0,0,0,0
6266,KRISHNA,Vijayawada Rural,RAYANAPADU,426,129,168,723,130,68,71,269,228,2108,954,963,4025,2669,0,0,0,0
6267,KRISHNA,Vijayawada Rural,TADEPALLI,453,106,112,671,85,23,7,115,105,5176,241,96,5513,3134,18,0,0,18
6268,KRISHNA,Vissannapet,CHANDRUPATLA,102,427,408,937,33,78,201,312,288,1191,4589,11279,17059,10296,3,13,24,40
6269,KRISHNA,Vissannapet,KALAGARA,579,97,770,1446,217,0,66,283,266,13307,0,3565,16872,9560,46,0,3,49
6270,KRISHNA,Vissannapet,KONDAPARVA,400,14,598,1012,161,4,180,345,324,6640,99,6913,13652,10451,6,0,8,14
6271,KRISHNA,Vissannapet,KORLAMANDA,163,10,641,814,82,3,161,246,237,3765,135,7343,11243,7183,8,0,15,23
6272,KRISHNA,Vissannapet,MAREMANDA,159,72,42,273,71,36,8,115,118,4111,2149,433,6693,4295,7,5,1,13
6273,KRISHNA,Vissannapet,NARASAPURAM,430,6,776,1212,72,1,288,361,351,4063,5,14076,18144,11725,6,0,28,34
6274,KRISHNA,Vissannapet,PUTRELA,1250,59,1273,2582,530,22,411,963,938,23681,622,11591,35894,19061,73,0,14,87
6275,KRISHNA,Vissannapet,TATAKUNTLA,753,50,383,1186,353,5,42,400,370,17779,134,743,18656,14527,26,0,0,26
6276,KRISHNA,Vissannapet,TELLADEVARAPALLE,656,186,214,1056,337,22,26,385,366,19095,527,531,20153,13200,33,0,0,33
6277,KRISHNA,Vissannapet,VEMIREDDIPALLE,416,168,750,1334,225,110,410,745,696,13541,5554,25116,44211,24897,40,15,78,133
6278,KRISHNA,Vissannapet,VISSANNAPET,1056,302,1489,2847,236,28,292,556,533,9285,715,10786,20786,17744,18,0,5,23
6279,KRISHNA,Vuyyuru,AKUNURU,311,3,204,518,179,0,24,203,202,4902,0,192,5094,2935,0,0,0,0
6280,KRISHNA,Vuyyuru,BOLLAPADU,99,31,158,288,74,24,102,200,181,1732,536,2307,4575,2367,0,0,0,0
6281,KRISHNA,Vuyyuru,CHINA OGIRALA,251,20,186,457,1,0,1,2,1,3,0,2,5,1,0,0,0,0
6282,KRISHNA,Vuyyuru,GANDIGUNTA,478,18,85,581,105,1,3,109,99,2466,23,46,2535,1632,1,0,0,1
6283,KRISHNA,Vuyyuru,JABARLAPUDI,49,0,0,49,31,0,0,31,26,2029,0,0,2029,1452,5,0,0,5
6284,KRISHNA,Vuyyuru,KADAVAKOLLU,250,10,236,496,157,0,116,273,264,5186,0,3629,8815,5496,0,0,2,2
6285,KRISHNA,Vuyyuru,KALAVAPAMULA,607,22,215,844,306,10,76,392,348,7186,235,1830,9251,4911,1,0,0,1
6286,KRISHNA,Vuyyuru,KATURU,820,62,522,1404,391,15,164,570,580,8116,197,3093,11406,7033,1,0,0,1
6287,KRISHNA,Vuyyuru,MUDUNURU,493,8,316,817,305,6,191,502,467,8521,126,3082,11729,6770,0,0,0,0
6288,KRISHNA,Vuyyuru,PEDA OGIRALA,196,68,149,413,110,31,59,200,186,1171,324,563,2058,1142,0,0,0,0
6289,KRISHNA,Vuyyuru,SAIPURAM,128,0,115,243,77,0,62,139,142,3211,0,1862,5073,3040,0,0,0,0
6290,KRISHNA,Vuyyuru,VUYYURU,554,95,680,1329,0,4,0,4,3,0,14,0,14,5,0,0,0,0
6291,KURNOOL,ADONI,AREKAL,60,0,461,521,33,0,176,209,239,1261,0,6970,8231,5340,1,0,9,10
6292,KURNOOL,ADONI,BALADUR,12,0,140,152,2,0,74,76,64,112,0,3808,3920,1871,0,0,13,13
6293,KURNOOL,ADONI,BASAPURAM,204,6,427,637,64,0,57,121,124,1485,0,1776,3261,1944,0,0,0,0
6294,KURNOOL,ADONI,BASARAKODU,175,0,547,722,71,0,215,286,275,3785,0,10707,14492,7654,7,0,25,32
6295,KURNOOL,ADONI,BILLEKALLU,78,1,439,518,52,1,161,214,222,1628,106,7853,9587,4618,2,1,5,8
6296,KURNOOL,ADONI,BYCHIGERI,225,4,887,1116,64,0,186,250,227,2436,0,8811,11247,6123,3,0,11,14
6297,KURNOOL,ADONI,CHINNA HARIVANAM,204,0,447,651,12,0,102,114,100,206,0,2403,2609,1353,0,0,1,1
6298,KURNOOL,ADONI,CHINNAPENDEKAL,79,0,551,630,48,0,337,385,371,1636,0,11262,12898,6762,0,0,3,3
6299,KURNOOL,ADONI,DHANAPURAM,153,1,434,588,38,0,128,166,158,2143,0,3137,5280,2788,7,0,1,8
6300,KURNOOL,ADONI,DIBBANAKAL,148,0,338,486,37,0,184,221,219,1381,0,9408,10789,6570,1,0,14,15
6301,KURNOOL,ADONI,DODDANAKERI,120,0,403,523,75,0,260,335,434,4285,0,18712,22997,11552,6,0,65,71
6302,KURNOOL,ADONI,G.HOSALLI,98,0,388,486,58,0,231,289,266,2404,0,9828,12232,6068,4,0,10,14
6303,KURNOOL,ADONI,GANEKAL,22,1,631,654,4,0,240,244,230,107,0,5705,5812,3127,0,0,0,0
6304,KURNOOL,ADONI,GONABAVI,131,0,238,369,34,0,49,83,78,645,0,892,1537,796,0,0,0,0
6305,KURNOOL,ADONI,HANAVALU,144,7,404,555,41,0,33,74,89,1269,0,626,1895,925,2,0,0,2
6306,KURNOOL,ADONI,ISVI,150,0,264,414,69,0,134,203,207,2109,0,5402,7511,5166,6,0,9,15
6307,KURNOOL,ADONI,JALIBENCHI,103,7,421,531,5,0,31,36,24,42,0,790,832,321,0,0,2,2
6308,KURNOOL,ADONI,KADITHOTA,115,0,175,290,86,0,130,216,211,6873,0,10497,17370,9667,30,0,52,82
6309,KURNOOL,ADONI,KAPATI,203,1,239,443,58,0,79,137,133,2448,0,3703,6151,3514,4,0,8,12
6310,KURNOOL,ADONI,KUPPAGAL,44,2,398,444,17,0,67,84,89,288,0,1230,1518,795,0,0,0,0
6311,KURNOOL,ADONI,MADIRE,355,1,799,1155,10,0,15,25,20,152,0,306,458,188,0,0,0,0
6312,KURNOOL,ADONI,MANDAGIRI,95,4,164,263,2,0,2,4,4,3,0,3,6,4,0,0,0,0
6313,KURNOOL,ADONI,MANTRIKI,46,0,452,498,9,0,162,171,173,246,0,5323,5569,2442,0,0,2,2
6314,KURNOOL,ADONI,NAGALAPURAM,0,0,292,292,0,0,74,74,99,0,0,3001,3001,1434,0,0,12,12
6315,KURNOOL,ADONI,NAGANATHANA HALLI,145,0,960,1105,7,0,233,240,187,114,0,7230,7344,3841,0,0,14,14
6316,KURNOOL,ADONI,NARANAPURAM,240,0,540,780,90,0,117,207,232,4177,0,5175,9352,6621,7,0,10,17
6317,KURNOOL,ADONI,NETTEKAL,79,1,466,546,39,0,127,166,149,1813,0,6235,8048,6784,5,0,18,23
6318,KURNOOL,ADONI,PANDAVAGALLU,41,0,565,606,10,0,326,336,314,604,0,19248,19852,11870,3,0,48,51
6319,KURNOOL,ADONI,PEDDA HARIVANAM,267,3,1249,1519,75,0,166,241,220,3210,0,7575,10785,5556,7,0,24,31
6320,KURNOOL,ADONI,PEDDA PENDEKAL,37,0,180,217,2,0,84,86,92,48,0,3400,3448,2047,0,0,5,5
6321,KURNOOL,ADONI,PEDDA THUMBALAM,289,4,1608,1901,116,0,395,511,536,2893,0,9817,12710,6883,1,0,6,7
6322,KURNOOL,ADONI,PESALABANDA,65,0,498,563,40,0,253,293,284,2211,0,15061,17272,9560,9,0,47,56
6323,KURNOOL,ADONI,SADAPURAM,225,0,533,758,20,0,112,132,124,553,0,2645,3198,2173,0,0,0,0
6324,KURNOOL,ADONI,SALAKALAKONDA,97,0,182,279,44,0,53,97,93,2462,0,2340,4802,2296,7,0,4,11
6325,KURNOOL,ADONI,SAMBAGALLU,129,0,253,382,68,0,129,197,185,1400,0,7771,9171,6336,0,0,22,22
6326,KURNOOL,ADONI,SANTHAKUDLUR,174,1,550,725,45,0,190,235,211,1253,0,7293,8546,4488,0,0,10,10
6327,KURNOOL,ADONI,VIRUPAPURAM,148,2,448,598,93,1,76,170,158,7045,94,2099,9238,5628,29,0,1,30
6328,KURNOOL,ALLAGADDA,AHOBILAM,157,567,445,1169,15,102,73,190,179,413,8796,2305,11514,7330,0,35,3,38
6329,KURNOOL,ALLAGADDA,ALLAGADDA,369,8,726,1103,0,0,0,0,0,0,0,0,0,0,0,0,0,0
6330,KURNOOL,ALLAGADDA,BACHEPALLE,262,124,929,1315,123,104,341,568,621,5809,4927,14539,25275,13726,8,7,18,33
6331,KURNOOL,ALLAGADDA,BATHALUR,390,3,822,1215,203,1,326,530,559,5495,34,8392,13921,7378,1,0,4,5
6332,KURNOOL,ALLAGADDA,CHINTA KOMMADINNE,79,187,218,484,53,71,114,238,255,3441,7931,8624,19996,12051,13,37,38,88
6333,KURNOOL,ALLAGADDA,G.JAMBULADINNE,167,7,411,585,93,2,108,203,208,4367,6,4852,9225,6503,5,0,9,14
6334,KURNOOL,ALLAGADDA,GOPALAPURAM,25,0,197,222,19,0,162,181,194,898,0,8997,9895,5206,0,0,6,6
6335,KURNOOL,ALLAGADDA,GUBAGUNDAM,44,0,197,241,25,0,129,154,154,1205,0,7656,8861,5093,0,0,16,16
6336,KURNOOL,ALLAGADDA,KOTHA KANDUKUR,187,0,886,1073,38,0,229,267,262,440,0,5741,6181,4159,0,0,4,4
6337,KURNOOL,ALLAGADDA,MARIPALLE,74,0,295,369,48,0,181,229,230,2739,0,9635,12374,7381,9,0,16,25
6338,KURNOOL,ALLAGADDA,MITTALAPALLE,154,1,335,490,65,0,144,209,202,2102,0,4693,6795,4149,1,0,0,1
6339,KURNOOL,ALLAGADDA,NALLAGATLA,149,1,397,547,109,1,183,293,312,6954,14,5091,12059,7477,20,0,0,20
6340,KURNOOL,ALLAGADDA,OBULAMPALLE,137,0,480,617,59,0,125,184,222,2258,0,5854,8112,6480,5,0,9,14
6341,KURNOOL,ALLAGADDA,PADAKANDLA,398,7,719,1124,143,0,26,169,163,2535,0,287,2822,2039,0,0,0,0
6342,KURNOOL,ALLAGADDA,PATHA KANDUKUR,176,1,229,406,110,1,135,246,256,3983,1,3611,7595,5637,2,0,0,2
6343,KURNOOL,ALLAGADDA,PEDDACHINTAKUNTA,586,13,1044,1643,153,0,185,338,329,2939,0,4356,7295,4967,2,0,0,2
6344,KURNOOL,ALLAGADDA,PERAIPALLI,108,0,191,299,94,0,106,200,206,6745,0,3497,10242,5362,13,0,2,15
6345,KURNOOL,ALLAGADDA,R.KRISHNAPURAM,108,0,439,547,50,0,224,274,271,2172,0,6399,8571,5447,4,0,1,5
6346,KURNOOL,ALLAGADDA,S.LINGAMDINNE,136,8,281,425,75,0,67,142,131,319,0,382,701,476,0,0,0,0
6347,KURNOOL,ALLAGADDA,YADAWADA,113,0,176,289,54,0,84,138,132,3179,0,4251,7430,4256,8,0,8,16
6348,KURNOOL,ALUR,ALUR,412,6,1134,1552,48,0,210,258,241,2601,0,11984,14585,10715,9,0,33,42
6349,KURNOOL,ALUR,ARIKERA,66,144,712,922,15,58,90,163,162,522,1396,2686,4604,2324,1,1,3,5
6350,KURNOOL,ALUR,HATHI BELGAL,155,0,885,1040,46,0,497,543,489,1387,0,20662,22049,12583,2,0,26,28
6351,KURNOOL,ALUR,HULEBEEDU,167,0,512,679,14,0,87,101,100,277,0,1540,1817,962,0,0,0,0
6352,KURNOOL,ALUR,KAMMARACHEDU,183,0,360,543,101,0,71,172,162,4394,0,1676,6070,3538,8,0,1,9
6353,KURNOOL,ALUR,KURUKUNDA,67,0,334,401,26,0,172,198,197,376,0,5351,5727,3173,0,0,9,9
6354,KURNOOL,ALUR,KURUVALLI,40,0,258,298,21,0,105,126,118,675,0,2729,3404,2064,1,0,1,2
6355,KURNOOL,ALUR,MANIKURTHI,62,0,381,443,17,0,125,142,144,599,0,5385,5984,4508,1,0,7,8
6356,KURNOOL,ALUR,MARAKATTU,69,0,284,353,21,0,34,55,48,394,0,615,1009,506,0,0,0,0
6357,KURNOOL,ALUR,MOLAGAVALLI,726,8,1304,2038,319,1,313,633,600,11292,18,8430,19740,10221,11,0,1,12
6358,KURNOOL,ALUR,MUDDANAGIRI,82,26,404,512,25,0,120,145,140,981,0,5816,6797,3638,2,0,15,17
6359,KURNOOL,ALUR,MUSANAHALLI,108,0,405,513,66,0,194,260,211,4710,0,8079,12789,6286,21,0,21,42
6360,KURNOOL,ALUR,PEDDAHOTHUR,207,0,991,1198,19,0,324,343,331,179,0,10371,10550,6545,0,0,4,4
6361,KURNOOL,ALUR,THUMBALABEEDU,33,0,348,381,20,0,178,198,194,865,0,8738,9603,4497,0,0,17,17
6362,KURNOOL,ASPARI,ASPARI,267,3,717,987,73,0,144,217,211,2049,0,3122,5171,2748,1,0,1,2
6363,KURNOOL,ASPARI,BANAVANUR,192,1,397,590,25,0,102,127,118,320,0,2310,2630,1331,0,0,0,0
6364,KURNOOL,ASPARI,BILLEKALLU,309,0,927,1236,81,0,192,273,238,3456,0,8084,11540,5877,12,0,20,32
6365,KURNOOL,ASPARI,CHIGELI,250,0,1078,1328,83,0,83,166,171,1838,0,1844,3682,2169,0,0,0,0
6366,KURNOOL,ASPARI,CHINNAHOTHUR,232,2,694,928,3,0,203,206,195,60,0,8055,8115,4738,0,0,10,10
6367,KURNOOL,ASPARI,CHIRAMANDODDI,36,0,317,353,6,0,71,77,85,64,0,2642,2706,1769,0,0,4,4
6368,KURNOOL,ASPARI,D. KOTAKONDA,115,2,490,607,50,2,182,234,235,2506,196,8213,10915,5914,6,1,13,20
6369,KURNOOL,ASPARI,HALIGERA,175,0,601,776,66,0,69,135,126,724,0,1284,2008,1085,0,0,0,0
6370,KURNOOL,ASPARI,JOHARAPURAM,186,1,926,1113,59,1,158,218,252,2077,20,4177,6274,3520,2,0,2,4
6371,KURNOOL,ASPARI,KARUMANCHI,148,0,639,787,82,0,186,268,243,3402,0,7319,10721,5183,2,0,16,18
6372,KURNOOL,ASPARI,KHYRUPPALA,374,6,874,1254,191,1,439,631,732,7032,22,22711,29765,15514,6,0,51,57
6373,KURNOOL,ASPARI,MULUGUNDAM,274,3,1200,1477,2,0,79,81,85,38,0,1240,1278,675,0,0,0,0
6374,KURNOOL,ASPARI,MUTHKUR,129,6,544,679,80,0,351,431,430,2671,0,19952,22623,13101,1,0,46,47
6375,KURNOOL,ASPARI,NAGARUR,380,8,593,981,146,2,224,372,394,4184,61,6236,10481,6438,7,0,3,10
6376,KURNOOL,ASPARI,PUTAKALAMARRI,124,1,274,399,23,0,67,90,89,266,0,2753,3019,1460,0,0,11,11
6377,KURNOOL,ASPARI,SANKARABANDA,70,0,380,450,45,0,211,256,236,1175,0,9676,10851,5915,1,0,18,19
6378,KURNOOL,ASPARI,TANGARADONA,276,0,961,1237,23,0,163,186,179,205,0,4729,4934,2721,0,0,1,1
6379,KURNOOL,ASPARI,THOGALAGALLU,78,1,389,468,34,0,77,111,141,673,0,1922,2595,1320,0,0,0,0
6380,KURNOOL,ASPARI,YATAKALLU,70,0,490,560,8,0,77,85,82,93,0,1747,1840,868,0,0,4,4
6381,KURNOOL,ATMAKUR,AMALAPURAM,93,102,430,625,24,1,121,146,141,633,163,5915,6711,2957,1,1,24,26
6382,KURNOOL,ATMAKUR,ATMAKUR,616,178,1077,1871,88,3,66,157,150,2930,179,1734,4843,3859,4,0,3,7
6383,KURNOOL,ATMAKUR,B.ANANTHAPURAM,427,42,339,808,162,15,89,266,246,5516,574,1891,7981,4413,7,0,0,7
6384,KURNOOL,ATMAKUR,INDIRESWARAM,165,163,396,724,59,58,150,267,251,3436,5922,7438,16796,9499,14,28,25,67
6385,KURNOOL,ATMAKUR,KARIVENA,681,40,963,1684,34,0,1,35,34,604,0,48,652,331,0,0,0,0
6386,KURNOOL,ATMAKUR,KRISHNAPURAM,107,26,391,524,45,10,169,224,246,765,398,7997,9160,5856,0,2,29,31
6387,KURNOOL,ATMAKUR,KURUKUNDA,403,839,1170,2412,51,138,91,280,251,1558,9030,1798,12386,7301,0,29,0,29
6388,KURNOOL,ATMAKUR,MUSTAPALLY,140,104,346,590,47,37,41,125,110,673,504,531,1708,908,0,0,0,0
6389,KURNOOL,ATMAKUR,NALLAKALVA,332,213,438,983,145,46,92,283,285,4832,2591,2488,9911,5563,9,11,4,24
6390,KURNOOL,ATMAKUR,PINNAPURAM,173,15,686,874,42,1,183,226,211,1180,10,6784,7974,5314,0,0,15,15
6391,KURNOOL,ATMAKUR,SIDDAPURAM,112,993,525,1630,32,261,171,464,477,603,24347,3622,28572,16619,0,112,4,116
6392,KURNOOL,ATMAKUR,SIDDEPALLE,85,2,246,333,43,2,81,126,114,489,25,2324,2838,1404,0,0,3,3
6393,KURNOOL,ATMAKUR,SREEPATHI RAO PETA,205,27,393,625,92,22,217,331,331,3773,1523,11757,17053,10827,5,6,26,37
6394,KURNOOL,ATMAKUR,SRISAILAM,451,281,513,1245,20,129,6,155,163,1786,9472,476,11734,6833,8,29,2,39
6395,KURNOOL,ATMAKUR,VADLA RAMAPURAM,522,0,649,1171,40,0,236,276,265,430,0,7847,8277,4401,0,0,14,14
6396,KURNOOL,BANAGANAPALLE,APPALAPURAM,120,0,297,417,62,0,78,140,123,1897,0,3555,5452,3255,1,0,8,9
6397,KURNOOL,BANAGANAPALLE,BANAGANAPALLE,539,145,2743,3427,7,16,154,177,178,258,948,9376,10582,8933,1,0,18,19
6398,KURNOOL,BANAGANAPALLE,BEERAVOLU,196,10,217,423,96,0,59,155,146,4018,0,1831,5849,4390,6,0,2,8
6399,KURNOOL,BANAGANAPALLE,CHERUVUPALLI,131,1,527,659,18,0,272,290,300,468,0,8954,9422,6601,1,0,5,6
6400,KURNOOL,BANAGANAPALLE,ENAKANDLA,375,10,358,743,196,0,79,275,297,4698,0,1812,6510,5490,1,0,0,1
6401,KURNOOL,BANAGANAPALLE,ILLURUKOTHAPETA,218,42,524,784,0,0,3,3,2,0,0,60,60,30,0,0,0,0
6402,KURNOOL,BANAGANAPALLE,KRISHNAGIRI,49,0,335,384,41,0,277,318,325,2632,0,18040,20672,11350,7,0,43,50
6403,KURNOOL,BANAGANAPALLE,KYAPA,303,23,415,741,140,0,100,240,249,5440,0,4177,9617,7126,2,0,1,3
6404,KURNOOL,BANAGANAPALLE,MEERAPURAM,137,0,436,573,81,0,117,198,206,2689,0,4087,6776,4424,2,0,6,8
6405,KURNOOL,BANAGANAPALLE,MITTAPALLE,93,0,157,250,49,0,43,92,84,1979,0,1676,3655,2513,2,0,1,3
6406,KURNOOL,BANAGANAPALLE,NANDAVARAM,246,22,1081,1349,80,5,450,535,535,2850,99,17377,20326,15555,0,0,6,6
6407,KURNOOL,BANAGANAPALLE,NANDIVARGAM,255,2,399,656,118,0,75,193,229,5612,0,2483,8095,5443,10,0,5,15
6408,KURNOOL,BANAGANAPALLE,PALUKUR,245,4,551,800,3,0,30,33,34,10,0,418,428,232,0,0,0,0
6409,KURNOOL,BANAGANAPALLE,PASUPULA,99,419,807,1325,65,211,289,565,544,4135,10131,12742,27008,14328,14,23,21,58
6410,KURNOOL,BANAGANAPALLE,PATHAPADU,170,22,628,820,73,0,171,244,247,2519,0,4303,6822,4263,3,0,3,6
6411,KURNOOL,BANAGANAPALLE,RAMATHEERTHAM,106,59,407,572,79,16,206,301,308,2454,325,8431,11210,7729,0,0,19,19
6412,KURNOOL,BANAGANAPALLE,TANGUTOOR,315,15,891,1221,54,4,251,309,293,1448,27,8330,9805,5929,3,0,8,11
6413,KURNOOL,BANAGANAPALLE,THAMMADAPALLE,135,113,271,519,101,83,114,298,308,3278,3075,4242,10595,6382,0,2,1,3
6414,KURNOOL,BANAGANAPALLE,THIMMAPURAM,154,0,472,626,83,0,17,100,86,2476,0,263,2739,1449,0,0,0,0
6415,KURNOOL,BANAGANAPALLE,VENKATAPURAM,195,0,316,511,69,0,89,158,179,2381,0,2607,4988,3223,2,0,0,2
6416,KURNOOL,BANAGANAPALLE,YAGANTIPALLE,150,1,356,507,3,0,6,9,9,68,0,120,188,90,0,0,0,0
6417,KURNOOL,BANAGANAPALLE,YERRAGUDI,165,0,424,589,46,0,152,198,201,936,0,6431,7367,5506,0,0,2,2
6418,KURNOOL,BANDI ATMAKUR,AYYAVARI KODUR,286,1,493,780,103,0,123,226,210,2764,0,4240,7004,5465,0,0,1,1
6419,KURNOOL,BANDI ATMAKUR,BANDI ATMAKUR,300,129,1119,1548,72,2,421,495,455,2120,13,11943,14076,9734,0,0,5,5
6420,KURNOOL,BANDI ATMAKUR,BAYYAPU KODUR,109,13,489,611,28,2,121,151,144,1437,32,4905,6374,5082,1,0,3,4
6421,KURNOOL,BANDI ATMAKUR,BHOJANAM,134,2,298,434,57,0,50,107,95,1696,0,596,2292,1079,2,0,0,2
6422,KURNOOL,BANDI ATMAKUR,CHINNADEVALAPURAM,321,255,504,1080,107,46,177,330,322,3805,3436,6953,14194,8333,3,16,8,27
6423,KURNOOL,BANDI ATMAKUR,ERNAPADU,192,76,704,972,74,0,171,245,256,2533,0,6602,9135,6292,5,0,15,20
6424,KURNOOL,BANDI ATMAKUR,G.LINGAPURAM,304,3,598,905,95,1,119,215,204,1721,22,1754,3497,2085,0,0,0,0
6425,KURNOOL,BANDI ATMAKUR,GALI CHENNAIAHPALEM,112,98,230,440,52,0,95,147,136,1662,0,3264,4926,3130,2,0,3,5
6426,KURNOOL,BANDI ATMAKUR,KADAMALAKALVA,176,7,459,642,22,0,54,76,70,339,0,650,989,544,0,0,0,0
6427,KURNOOL,BANDI ATMAKUR,KAKANUR,132,52,170,354,61,8,66,135,127,1553,133,1016,2702,1888,0,0,1,1
6428,KURNOOL,BANDI ATMAKUR,NARAYANAPURAM,214,3,309,526,108,0,126,234,231,1929,0,4074,6003,3945,0,0,3,3
6429,KURNOOL,BANDI ATMAKUR,PARAMATUR,71,0,422,493,4,0,74,78,84,63,0,1915,1978,1167,0,0,0,0
6430,KURNOOL,BANDI ATMAKUR,PARNAPALLE,247,23,396,666,64,0,81,145,142,2465,0,3280,5745,4544,2,0,2,4
6431,KURNOOL,BANDI ATMAKUR,PEDDA DEVALAPURAM,123,87,549,759,50,8,227,285,265,1547,299,7936,9782,5713,1,0,2,3
6432,KURNOOL,BANDI ATMAKUR,RAMAPURAM,0,0,242,242,0,0,110,110,114,0,0,2110,2110,1380,0,0,0,0
6433,KURNOOL,BANDI ATMAKUR,SANTHAJUTUR,153,5,781,939,67,0,113,180,168,3334,0,6517,9851,5952,5,0,17,22
6434,KURNOOL,BANDI ATMAKUR,SINGAVARAM,217,7,231,455,150,0,98,248,234,4434,0,3579,8013,5280,2,0,7,9
6435,KURNOOL,BANDI ATMAKUR,SOMAYAJULAPALLI,74,40,283,397,23,0,129,152,145,395,0,3431,3826,2424,0,0,0,0
6436,KURNOOL,BANDI ATMAKUR,YERRAGUNTLA,247,0,544,791,101,0,66,167,180,4511,0,2037,6548,4571,9,0,2,11
6437,KURNOOL,BETHAMCHERLA,AMBAPURAM,192,0,244,436,134,0,164,298,304,3964,0,6889,10853,9256,0,0,3,3
6438,KURNOOL,BETHAMCHERLA,BETHAMCHERLA,748,14,1371,2133,269,0,293,562,577,6431,0,14513,20944,18959,2,0,25,27
6439,KURNOOL,BETHAMCHERLA,BUGGANIPALLE,185,180,700,1065,65,92,287,444,473,1232,5301,9010,15543,11868,0,17,7,24
6440,KURNOOL,BETHAMCHERLA,CEMENTNAGAR,351,28,599,978,133,5,170,308,301,4313,116,5176,9605,7852,3,0,7,10
6441,KURNOOL,BETHAMCHERLA,EMBOY,311,0,646,957,139,0,55,194,206,7671,0,2239,9910,5724,21,0,6,27
6442,KURNOOL,BETHAMCHERLA,GORLAGUTTA,224,1,260,485,70,1,61,132,135,2415,20,1778,4213,3834,2,0,0,2
6443,KURNOOL,BETHAMCHERLA,GORUMANKONDA,69,88,353,510,37,53,170,260,250,1355,1959,7139,10453,5472,2,1,10,13
6444,KURNOOL,BETHAMCHERLA,GUTUPALLE,70,0,490,560,36,0,209,245,254,455,0,4773,5228,3467,0,0,0,0
6445,KURNOOL,BETHAMCHERLA,H.KOTTALA,6,10,442,458,0,2,198,200,213,0,45,7469,7514,6960,0,0,4,4
6446,KURNOOL,BETHAMCHERLA,K K KOTTALA,10,0,80,90,1,0,37,38,52,45,0,1425,1470,1043,0,0,2,2
6447,KURNOOL,BETHAMCHERLA,KOLUMULAPALLE,494,0,706,1200,75,0,208,283,296,1800,0,4418,6218,5452,0,0,0,0
6448,KURNOOL,BETHAMCHERLA,M.PENDEKAL,192,2,687,881,18,1,23,42,45,150,4,333,487,255,0,0,0,0
6449,KURNOOL,BETHAMCHERLA,MUDDAVARAM,203,10,680,893,69,6,257,332,330,1485,622,12405,14512,7729,1,4,54,59
6450,KURNOOL,BETHAMCHERLA,R.BUKKAPURAM,83,0,288,371,22,0,80,102,94,354,0,1150,1504,951,0,0,0,0
6451,KURNOOL,BETHAMCHERLA,R.KOTHAPALLI,56,1,277,334,37,0,183,220,203,1293,0,5283,6576,4805,0,0,1,1
6452,KURNOOL,BETHAMCHERLA,RAHIMANPURAM,52,0,503,555,20,0,272,292,278,750,0,13230,13980,7498,0,0,11,11
6453,KURNOOL,BETHAMCHERLA,RANGAPURAM,627,3,1114,1744,222,1,397,620,610,4542,1,7323,11866,9215,1,0,3,4
6454,KURNOOL,BETHAMCHERLA,SEETHARAMAPURAM,107,3,326,436,48,0,57,105,99,890,0,1745,2635,1612,0,0,1,1
6455,KURNOOL,BETHAMCHERLA,SHANKARAPURAM,164,3,346,513,25,1,23,49,46,663,10,490,1163,593,1,0,0,1
6456,KURNOOL,BETHAMCHERLA,THAVISIKONDA,83,0,215,298,65,0,130,195,184,1874,0,3157,5031,3044,4,0,1,5
6457,KURNOOL,C.BELAGAL,BRAHMANADODDI,284,0,1010,1294,140,0,384,524,540,6326,0,16264,22590,10718,8,0,35,43
6458,KURNOOL,C.BELAGAL,BURANDODDI,191,9,1723,1923,76,3,495,574,547,4756,24,17461,22241,11243,17,0,28,45
6459,KURNOOL,C.BELAGAL,C.BELAGAL,688,7,2368,3063,289,0,836,1125,1184,17306,0,34971,52277,26475,59,0,44,103
6460,KURNOOL,C.BELAGAL,ENAGANDLA,186,4,708,898,100,0,282,382,389,3835,0,12474,16309,8129,6,0,24,30
6461,KURNOOL,C.BELAGAL,GUNDREVULA,101,0,521,622,71,0,152,223,208,3897,0,5000,8897,4505,10,0,8,18
6462,KURNOOL,C.BELAGAL,KAMBADAHAL,169,6,912,1087,101,0,387,488,496,6738,0,16807,23545,12963,20,0,20,40
6463,KURNOOL,C.BELAGAL,KONDAPURAM,276,2,710,988,40,1,261,302,295,788,47,11695,12530,6702,0,0,21,21
6464,KURNOOL,C.BELAGAL,KOTHAKOTA,714,11,1010,1735,242,0,163,405,379,9354,0,4478,13832,6634,2,0,1,3
6465,KURNOOL,C.BELAGAL,MUDUMALA,293,0,695,988,179,0,226,405,368,9088,0,9713,18801,9615,25,0,20,45
6466,KURNOOL,C.BELAGAL,PALUKDODDI,112,1,217,330,80,0,128,208,203,5353,0,5044,10397,5885,18,0,12,30
6467,KURNOOL,C.BELAGAL,POLAKAL,1193,14,1652,2859,319,0,472,791,860,9130,0,16688,25818,12795,5,0,25,30
6468,KURNOOL,C.BELAGAL,SANGALA,220,0,970,1190,95,0,538,633,669,3466,0,29134,32600,16826,6,0,46,52
6469,KURNOOL,CHAGALAMARRI,BRAHMANAPALLE,95,0,119,214,58,0,33,91,86,1695,0,224,1919,1346,1,0,0,1
6470,KURNOOL,CHAGALAMARRI,CHAGALAMARRI,412,135,838,1385,131,29,27,187,194,7866,1805,793,10464,7597,22,4,2,28
6471,KURNOOL,CHAGALAMARRI,CHINNA BODHANAM,177,0,182,359,72,0,74,146,146,4092,0,2732,6824,4408,12,0,4,16
6472,KURNOOL,CHAGALAMARRI,CHINNA VANGALI,98,0,390,488,6,0,29,35,30,59,0,310,369,232,0,0,0,0
6473,KURNOOL,CHAGALAMARRI,CHINTALA CHERUVU,138,0,559,697,0,0,18,18,16,0,0,791,791,523,0,0,1,1
6474,KURNOOL,CHAGALAMARRI,D. VANIPENTA,158,339,512,1009,89,72,82,243,238,5763,6238,5087,17088,8169,17,34,15,66
6475,KURNOOL,CHAGALAMARRI,GODIGANURU,337,2,407,746,39,0,35,74,100,566,0,899,1465,760,0,0,0,0
6476,KURNOOL,CHAGALAMARRI,GOTLUR,114,3,168,285,84,1,105,190,187,3771,3,4786,8560,5785,11,0,5,16
6477,KURNOOL,CHAGALAMARRI,KALUGOTLAPALLE,85,0,239,324,29,0,13,42,42,296,0,89,385,225,0,0,0,0
6478,KURNOOL,CHAGALAMARRI,MADDURU,299,0,224,523,207,0,98,305,301,11766,0,4112,15878,8366,29,0,1,30
6479,KURNOOL,CHAGALAMARRI,MALLAVEMULA,156,1,173,330,114,1,102,217,237,3914,24,4665,8603,4792,6,0,6,12
6480,KURNOOL,CHAGALAMARRI,MUTHYALAPADU,297,185,1018,1500,122,152,76,350,357,4858,5879,1630,12367,7200,9,10,0,19
6481,KURNOOL,CHAGALAMARRI,NELAMPADU,168,2,239,409,114,0,94,208,207,3381,0,3407,6788,4233,3,0,0,3
6482,KURNOOL,CHAGALAMARRI,PEDDA BODHANAM,202,4,261,467,95,1,108,204,211,3418,64,6239,9721,6392,4,0,15,19
6483,KURNOOL,CHAGALAMARRI,PEDDA VANGALI,85,3,444,532,13,0,164,177,152,66,0,4971,5037,2973,0,0,4,4
6484,KURNOOL,CHAGALAMARRI,RAMPALLE,2,0,173,175,0,0,0,0,0,0,0,0,0,0,0,0,0,0
6485,KURNOOL,CHAGALAMARRI,SETTIVEEDU,359,208,352,919,154,3,12,169,173,8694,82,453,9229,5929,24,0,0,24
6486,KURNOOL,CHAGALAMARRI,THODENDLAPALLE,133,0,272,405,84,0,150,234,214,3251,0,4669,7920,4899,3,0,0,3
6487,KURNOOL,CHIPPAGIRI,BANTANAHAL,33,0,401,434,17,0,129,146,148,675,0,1762,2437,1577,1,0,0,1
6488,KURNOOL,CHIPPAGIRI,BELDONA,167,1,632,800,84,0,209,293,267,3706,0,7658,11364,6356,4,0,5,9
6489,KURNOOL,CHIPPAGIRI,CHIPPAGIRI,367,0,935,1302,68,0,201,269,260,2532,0,4439,6971,4365,5,0,3,8
6490,KURNOOL,CHIPPAGIRI,DEGALAHAL,31,0,345,376,4,0,112,116,109,34,0,2785,2819,1695,0,0,0,0
6491,KURNOOL,CHIPPAGIRI,DOULATHAPURAM,155,1,840,996,49,0,404,453,451,1616,0,20442,22058,13730,2,0,32,34
6492,KURNOOL,CHIPPAGIRI,GUMMANUR,60,0,287,347,21,0,77,98,93,534,0,2679,3213,1807,0,0,1,1
6493,KURNOOL,CHIPPAGIRI,KHAJIPURAM,38,0,179,217,15,0,92,107,113,911,0,4131,5042,2737,1,0,5,6
6494,KURNOOL,CHIPPAGIRI,KUNDANAGURTHI,74,0,317,391,36,0,113,149,145,1480,0,4827,6307,4129,4,0,4,8
6495,KURNOOL,CHIPPAGIRI,NAGARADONA,131,9,876,1016,47,0,343,390,351,1353,0,9877,11230,5971,1,0,9,10
6496,KURNOOL,CHIPPAGIRI,NEMAKAL,128,1,1063,1192,53,0,281,334,336,2288,0,10126,12414,6527,4,0,24,28
6497,KURNOOL,CHIPPAGIRI,RAMADURGAM,168,2,1034,1204,46,0,207,253,228,1135,0,6404,7539,3988,0,0,8,8
6498,KURNOOL,CHIPPAGIRI,YERUR,91,0,473,564,6,0,99,105,96,36,0,2256,2292,1281,0,0,1,1
6499,KURNOOL,DEVANAKONDA,ALARUDINNE,186,2,405,593,52,0,54,106,101,1730,0,1104,2834,1355,0,0,0,0
6500,KURNOOL,DEVANAKONDA,CHELLELICHELIMALA,176,8,736,920,26,1,79,106,109,1060,51,2074,3185,1675,0,0,0,0
6501,KURNOOL,DEVANAKONDA,DEVANAKONDA,476,28,1433,1937,71,0,113,184,183,1470,0,3808,5278,2760,0,0,2,2
6502,KURNOOL,DEVANAKONDA,GUNDLAKONDA,103,5,939,1047,5,0,68,73,68,54,0,1377,1431,739,0,0,0,0
6503,KURNOOL,DEVANAKONDA,IRANBANDA,128,1,278,407,75,1,98,174,146,2100,12,2795,4907,2384,1,0,4,5
6504,KURNOOL,DEVANAKONDA,JILLEDUBUDAKALA,98,1,449,548,48,0,283,331,356,1229,0,13891,15120,7494,0,0,19,19
6505,KURNOOL,DEVANAKONDA,K.VENKATAPURAM,66,0,400,466,29,0,161,190,178,1047,0,5685,6732,3266,0,0,4,4
6506,KURNOOL,DEVANAKONDA,KAPPATRALLA,78,1,850,929,0,0,198,198,217,0,0,9955,9955,4908,0,0,18,18
6507,KURNOOL,DEVANAKONDA,KARIVEMULA,232,5,651,888,89,0,221,310,281,2632,0,9506,12138,6295,3,0,22,25
6508,KURNOOL,DEVANAKONDA,KUNKANUR,155,12,748,915,47,1,102,150,138,1828,12,2669,4509,2384,1,0,0,1
6509,KURNOOL,DEVANAKONDA,MACHAPURAM,102,10,285,397,58,3,118,179,154,2242,40,4376,6658,2946,4,0,8,12
6510,KURNOOL,DEVANAKONDA,NALLACHELIMALA,198,9,760,967,158,7,457,622,631,10798,346,21450,32594,16391,42,1,40,83
6511,KURNOOL,DEVANAKONDA,NELATHALAMARRI,169,0,775,944,21,0,190,211,138,503,0,5154,5657,2175,0,0,4,4
6512,KURNOOL,DEVANAKONDA,NELLIBANDA,47,0,370,417,17,0,47,64,62,272,0,764,1036,576,0,0,0,0
6513,KURNOOL,DEVANAKONDA,P.KOTAKONDA,219,18,1723,1960,46,1,410,457,473,1271,27,19504,20802,9610,3,0,56,59
6514,KURNOOL,DEVANAKONDA,PALAKURTHY,76,10,246,332,45,0,62,107,103,1952,0,2329,4281,2235,0,0,4,4
6515,KURNOOL,DEVANAKONDA,PALLEDODDI,109,1,493,603,43,0,241,284,239,1214,0,5778,6992,3134,1,0,6,7
6516,KURNOOL,DEVANAKONDA,POTLAPADU,204,0,498,702,42,0,129,171,178,777,0,4091,4868,2338,0,0,1,1
6517,KURNOOL,DEVANAKONDA,TERNEKAL,777,35,1701,2513,55,3,271,329,351,1946,36,12285,14267,6940,3,0,36,39
6518,KURNOOL,DEVANAKONDA,VELAMAKURU,74,3,540,617,47,3,383,433,435,2292,154,14813,17259,8074,5,0,17,22
6519,KURNOOL,DHONE,AVULADODDI,237,2,122,361,72,0,14,86,81,2102,0,250,2352,1075,3,0,0,3
6520,KURNOOL,DHONE,CHANUGONDLA,51,1,1011,1063,26,0,631,657,1029,980,0,25128,26108,14357,0,0,20,20
6521,KURNOOL,DHONE,CHINNA MALAKAPURAM,478,11,2053,2542,268,4,1008,1280,1336,8908,172,38645,47725,25377,5,0,12,17
6522,KURNOOL,DHONE,DEVARABANDA,151,32,1147,1330,65,11,589,665,628,3273,328,17192,20793,10608,9,0,23,32
6523,KURNOOL,DHONE,DHARMAVARAM,147,3,550,700,43,1,153,197,205,1193,42,3952,5187,3255,0,0,0,0
6524,KURNOOL,DHONE,DHONE,0,0,0,0,0,0,0,0,0,0,0,0,0,0,0,0,0,0
6525,KURNOOL,DHONE,DORAPALLI,83,149,521,753,34,35,106,175,177,1591,1264,1848,4703,2754,5,3,0,8
6526,KURNOOL,DHONE,EDDUPENTA,156,6,1433,1595,41,0,188,229,253,670,0,3853,4523,2291,0,0,0,0
6527,KURNOOL,DHONE,GOSANIPALLI,6,0,636,642,0,0,0,0,0,0,0,0,0,0,0,0,0,0
6528,KURNOOL,DHONE,GUMMAKONDA,247,2,486,735,42,0,157,199,196,1836,0,7511,9347,5843,6,0,17,23
6529,KURNOOL,DHONE,JAGADURTHI,80,46,284,410,48,12,168,228,244,1531,278,6071,7880,4221,0,0,1,1
6530,KURNOOL,DHONE,KAMAGANIKUNTLA,85,1,650,736,48,0,160,208,192,1301,0,4985,6286,3314,0,0,4,4
6531,KURNOOL,DHONE,KAMALAPURAM,206,0,578,784,109,0,222,331,397,3543,0,5929,9472,5301,0,0,0,0
6532,KURNOOL,DHONE,KANNAPUKUNTA,247,2,266,515,123,0,93,216,232,3295,0,2581,5876,3494,2,0,1,3
6533,KURNOOL,DHONE,KOCHERUVU,295,5,1100,1400,64,1,40,105,105,1765,23,1497,3285,1708,3,0,4,7
6534,KURNOOL,DHONE,KOTHA BURUJU,92,59,320,471,64,39,164,267,263,1918,1518,4244,7680,3917,1,2,1,4
6535,KURNOOL,DHONE,KOTHAKOTA,238,54,631,923,82,4,196,282,300,3883,203,8078,12164,6348,10,0,6,16
6536,KURNOOL,DHONE,KOTRAI,61,19,704,784,18,3,161,182,238,320,140,3623,4083,2086,0,0,4,4
6537,KURNOOL,DHONE,MALLEMPALLI,111,16,529,656,58,4,349,411,496,3554,204,21684,25442,12675,7,0,36,43
6538,KURNOOL,DHONE,U. KOTHAPALLI,73,1,427,501,35,0,159,194,193,2386,0,8634,11020,6209,7,0,12,19
6539,KURNOOL,DHONE,UDUMULAPADU,142,2,647,791,45,1,214,260,262,1489,11,7871,9371,6273,0,0,5,5
6540,KURNOOL,DHONE,UNGARANIGUNDLA,158,56,764,978,72,19,416,507,534,3175,334,20998,24507,12679,3,0,30,33
6541,KURNOOL,DHONE,VENKATANAYUNIPALLI,70,4,442,516,20,1,205,226,260,487,21,5436,5944,3009,0,0,1,1
6542,KURNOOL,DHONE,VENKATAPURAM,224,10,1227,1461,68,0,290,358,415,1859,0,12443,14302,7700,0,0,26,26
6543,KURNOOL,DHONE,YAPADINNE,144,0,424,568,66,0,210,276,233,2788,0,8631,11419,6359,7,0,7,14
6544,KURNOOL,DHONE,YERRAGUNTLA,119,1,391,511,95,0,246,341,350,6833,0,14494,21327,12022,34,0,26,60
6545,KURNOOL,DORNIPADU,AMMIREDDINAGARAM,14,0,185,199,12,0,68,80,79,267,0,1884,2151,1060,0,0,0,0
6546,KURNOOL,DORNIPADU,ARJUNAPURAM,92,2,180,274,62,0,101,163,159,3170,0,4318,7488,3736,6,0,2,8
6547,KURNOOL,DORNIPADU,BURRAREDDIPALLE,24,0,406,430,14,0,259,273,315,1269,0,8174,9443,5023,5,0,2,7
6548,KURNOOL,DORNIPADU,CHAKARAJUVEMULA,277,0,782,1059,151,0,347,498,500,3875,0,7004,10879,6087,2,0,0,2
6549,KURNOOL,DORNIPADU,DORNIPADU,711,26,1627,2364,372,15,343,730,792,10688,187,5505,16380,8216,4,0,0,4
6550,KURNOOL,DORNIPADU,GUNDUPAPALA,191,2,428,621,112,0,155,267,251,4743,0,4756,9499,5236,2,0,2,4
6551,KURNOOL,DORNIPADU,KONDAPURAM,67,8,338,413,49,0,201,250,216,2200,0,10561,12761,7034,1,0,7,8
6552,KURNOOL,DORNIPADU,KRISTIPADU,222,1,528,751,144,1,299,444,412,7779,21,12141,19941,10588,5,0,6,11
6553,KURNOOL,DORNIPADU,RAMACHANDRAPURAM,95,1,497,593,73,1,219,293,279,3334,60,9507,12901,6928,2,0,2,4
6554,KURNOOL,DORNIPADU,W.GOVINDINNE,265,4,560,829,193,0,270,463,583,9778,0,12557,22335,11447,7,0,7,14
6555,KURNOOL,DORNIPADU,W.KOTHAPALLI,206,7,501,714,155,2,45,202,191,9928,32,1076,11036,5397,36,0,0,36
6556,KURNOOL,GADIVEMULA,BILAKALA GUDUR,330,10,854,1194,117,4,319,440,401,2727,120,8318,11165,7008,1,0,4,5
6557,KURNOOL,GADIVEMULA,BUJANUR,146,1,483,630,79,0,159,238,211,1475,0,2408,3883,2005,1,0,2,3
6558,KURNOOL,GADIVEMULA,CHINDUKURU,102,0,524,626,55,0,190,245,239,2027,0,8742,10769,6567,2,0,20,22
6559,KURNOOL,GADIVEMULA,DURVESI,271,3,568,842,114,1,191,306,305,2426,30,6537,8993,5773,1,0,6,7
6560,KURNOOL,GADIVEMULA,GADIGAREVULA,100,1,417,518,49,0,218,267,257,1901,0,8698,10599,5875,4,0,13,17
6561,KURNOOL,GADIVEMULA,GADIVEMULA,444,3,787,1234,96,2,53,151,146,1445,27,1134,2606,1486,0,0,0,0
6562,KURNOOL,GADIVEMULA,GANI,154,44,1094,1292,0,23,236,259,248,0,1842,5784,7626,4144,0,10,2,12
6563,KURNOOL,GADIVEMULA,K.BOLLAVARAM,14,23,237,274,3,17,164,184,172,242,965,11622,12829,7975,1,2,40,43
6564,KURNOOL,GADIVEMULA,KARIMADDALA,196,0,629,825,134,0,242,376,342,3372,0,8983,12355,6378,1,0,4,5
6565,KURNOOL,GADIVEMULA,KORATAMADDI,270,0,349,619,143,0,139,282,265,3705,0,2588,6293,3797,4,0,1,5
6566,KURNOOL,GADIVEMULA,KORRAPOLUR,100,3,241,344,44,0,105,149,134,880,0,2149,3029,1759,0,0,0,0
6567,KURNOOL,GADIVEMULA,LAXMAIAHKUNTA THANDA,1,428,0,429,0,221,0,221,226,0,8715,0,8715,4661,0,6,0,6
6568,KURNOOL,GADIVEMULA,MANCHALAKATTA,230,3,616,849,120,2,153,275,230,3088,79,5344,8511,4584,1,0,3,4
6569,KURNOOL,GADIVEMULA,ONDUTLA,67,1,322,390,22,0,169,191,191,318,0,9708,10026,5378,2,0,47,49
6570,KURNOOL,GADIVEMULA,PESARAVAYI,316,5,573,894,180,0,72,252,254,5550,0,1281,6831,3504,0,0,0,0
6571,KURNOOL,GADIVEMULA,THIRUPADU,82,0,274,356,51,0,104,155,143,2398,0,4292,6690,3700,2,0,6,8
6572,KURNOOL,GONEGANDLA,ALWALA,208,4,593,805,109,0,122,231,229,2702,0,1538,4240,2108,0,0,0,0
6573,KURNOOL,GONEGANDLA,B. AGRAHARAM,134,2,246,382,28,0,103,131,153,525,0,3747,4272,2002,0,0,3,3
6574,KURNOOL,GONEGANDLA,BYLUPPALA,127,0,416,543,6,0,68,74,76,60,0,716,776,427,0,0,0,0
6575,KURNOOL,GONEGANDLA,CHINNAMARRIVEEDU,141,0,434,575,60,0,158,218,219,1548,0,3608,5156,2537,0,0,0,0
6576,KURNOOL,GONEGANDLA,ERRABADU,76,0,426,502,16,0,12,28,22,286,0,238,524,195,0,0,0,0
6577,KURNOOL,GONEGANDLA,GAJULADINNE,157,0,306,463,79,0,91,170,188,2559,0,3017,5576,2652,2,0,4,6
6578,KURNOOL,GONEGANDLA,GANJIHALLI,205,4,718,927,81,0,86,167,196,2072,0,3130,5202,2517,2,0,5,7
6579,KURNOOL,GONEGANDLA,GONEGANDLA,774,3,3178,3955,22,1,247,270,242,747,126,10253,11126,5103,1,1,26,28
6580,KURNOOL,GONEGANDLA,HANDRI KHAIRAWADI,376,0,992,1368,8,0,158,166,160,152,0,2802,2954,1450,0,0,0,0
6581,KURNOOL,GONEGANDLA,IRANBANDA,152,4,394,550,63,0,31,94,102,3836,0,1398,5234,2504,16,0,2,18
6582,KURNOOL,GONEGANDLA,KULUMALA,301,0,680,981,114,0,73,187,184,3127,0,1659,4786,2269,3,0,3,6
6583,KURNOOL,GONEGANDLA,KURNUR,105,8,432,545,77,1,235,313,267,2723,12,9514,12249,5422,1,0,10,11
6584,KURNOOL,GONEGANDLA,LINGAMDINNE,59,1,383,443,17,0,39,56,16,287,0,141,428,99,0,0,0,0
6585,KURNOOL,GONEGANDLA,NERUDUPPALA,154,0,316,470,89,0,76,165,145,1879,0,1109,2988,1215,2,0,0,2
6586,KURNOOL,GONEGANDLA,ONTEDUDINNE,119,0,297,416,81,0,58,139,138,3033,0,1061,4094,2274,3,0,0,3
6587,KURNOOL,GONEGANDLA,PEDDA MARRIVEEDU,161,0,657,818,34,0,181,215,181,1509,0,6199,7708,3397,1,0,4,5
6588,KURNOOL,GONEGANDLA,PEDDA NELATUR,472,0,885,1357,84,0,19,103,130,1420,0,354,1774,949,0,0,0,0
6589,KURNOOL,GONEGANDLA,PUTTAPASAM,98,0,342,440,21,0,25,46,36,428,0,358,786,334,0,0,0,0
6590,KURNOOL,GONEGANDLA,THIPPANUR,130,7,548,685,13,1,242,256,227,148,19,4703,4870,2128,0,0,1,1
6591,KURNOOL,GONEGANDLA,VEMUGODU,188,1,511,700,59,0,251,310,333,1286,0,10432,11718,6379,0,0,21,21
6592,KURNOOL,GOSPADU,DEEBAGUNTLA,278,0,756,1034,259,0,693,952,1008,14155,0,20480,34635,18875,17,0,4,21
6593,KURNOOL,GOSPADU,GOSPADU,258,4,365,627,171,0,185,356,354,5349,0,5072,10421,5574,0,0,0,0
6594,KURNOOL,GOSPADU,JILLELA,318,2,629,949,225,1,354,580,586,11151,71,18918,30140,16468,11,0,21,32
6595,KURNOOL,GOSPADU,JULEPALLE,142,0,379,521,86,0,100,186,191,3928,0,3157,7085,4192,8,0,2,10
6596,KURNOOL,GOSPADU,KANALAPALLE,227,23,253,503,72,7,96,175,185,1986,324,5111,7421,3781,1,1,10,12
6597,KURNOOL,GOSPADU,M.CHINTAKUNTA,95,5,224,324,64,4,85,153,152,2802,128,2459,5389,3419,4,0,0,4
6598,KURNOOL,GOSPADU,M.KRISHNAPURAM,170,3,322,495,137,2,170,309,328,4532,32,5747,10311,5356,1,0,5,6
6599,KURNOOL,GOSPADU,NEHRU NAGAR,3,0,291,294,1,0,237,238,256,18,0,11446,11464,5730,0,0,6,6
6600,KURNOOL,GOSPADU,PASURAPADU,253,8,285,546,184,7,172,363,402,5463,224,6988,12675,7725,0,0,4,4
6601,KURNOOL,GOSPADU,RAYAPADU,157,0,153,310,69,0,76,145,153,1900,0,1611,3511,2110,0,0,0,0
6602,KURNOOL,GOSPADU,S.NAGULAVARAM,113,1,195,309,83,0,109,192,204,4171,0,4252,8423,4497,3,0,0,3
6603,KURNOOL,GOSPADU,SAMBAVARAM,306,6,362,674,287,3,323,613,718,15886,67,16791,32744,17982,27,0,23,50
6604,KURNOOL,GOSPADU,TELLAPURI,167,0,153,320,101,0,83,184,193,4624,0,3536,8160,4624,7,0,4,11
6605,KURNOOL,GOSPADU,VANTIVELAGALA,199,0,252,451,136,0,113,249,252,5902,0,5107,11009,5615,12,0,7,19
6606,KURNOOL,GOSPADU,YALLURU,693,10,1242,1945,310,3,207,520,550,3418,21,2524,5963,3213,0,0,0,0
6607,KURNOOL,GUDUR,BUDIDAPADU,111,1,570,682,14,0,55,69,64,211,0,669,880,484,0,0,0,0
6608,KURNOOL,GUDUR,CHANUGONDLA,293,2,1485,1780,54,0,452,506,513,1050,0,19490,20540,10355,2,0,22,24
6609,KURNOOL,GUDUR,GUDIPADU,387,2,445,834,324,0,220,544,598,27021,0,14875,41896,21630,150,0,59,209
6610,KURNOOL,GUDUR,GUDUR,1107,2,2511,3620,14,0,0,14,12,125,0,0,125,49,0,0,0,0
6611,KURNOOL,GUDUR,JULAKALLU,127,0,497,624,62,0,162,224,232,1673,0,5006,6679,3397,0,0,5,5
6612,KURNOOL,GUDUR,K.NAGALAPURAM,302,2,381,685,171,0,32,203,226,9111,0,248,9359,5241,27,0,0,27
6613,KURNOOL,GUDUR,MALLAPURAM,9,0,211,220,6,0,143,149,139,255,0,5628,5883,3206,0,0,4,4
6614,KURNOOL,GUDUR,MUNAGALA,211,0,588,799,34,0,64,98,80,526,0,1559,2085,976,0,0,0,0
6615,KURNOOL,GUDUR,PENCHIKALAPADU,63,1,523,587,43,0,293,336,314,1575,0,15766,17341,9796,2,0,24,26
6616,KURNOOL,GUDUR,REGADI KHANAPURAM,0,0,283,283,0,0,248,248,256,0,0,16515,16515,8316,0,0,36,36
6617,KURNOOL,HALAHARVI,BAPURAM,196,0,568,764,116,0,285,401,335,6537,0,14151,20688,11326,14,0,28,42
6618,KURNOOL,HALAHARVI,BEVINAHAL,40,0,288,328,24,0,162,186,172,832,0,7269,8101,5068,1,0,12,13
6619,KURNOOL,HALAHARVI,BILEHAL,67,0,362,429,12,0,174,186,166,241,0,5454,5695,2652,0,0,2,2
6620,KURNOOL,HALAHARVI,CHINTHAKUNTA,367,10,1504,1881,171,2,751,924,867,8578,63,26456,35097,20219,10,0,20,30
6621,KURNOOL,HALAHARVI,GULYAM,327,2,1759,2088,47,0,264,311,246,2787,0,13935,16722,8592,11,0,16,27
6622,KURNOOL,HALAHARVI,HALAHARVI,333,30,952,1315,231,2,458,691,636,15329,39,31965,47333,27219,45,0,100,145
6623,KURNOOL,HALAHARVI,HARDAGIRI,96,5,515,616,46,0,308,354,320,1410,0,16118,17528,9909,1,0,18,19
6624,KURNOOL,HALAHARVI,KAMINHAL,118,0,362,480,47,0,207,254,234,2634,0,11567,14201,7945,7,0,36,43
6625,KURNOOL,HALAHARVI,KOKKARACHEDU,52,2,290,344,14,0,127,141,125,489,0,4894,5383,3254,0,0,4,4
6626,KURNOOL,HALAHARVI,MALLIKARJUNAHAL,54,1,318,373,33,0,133,166,136,1505,0,4460,5965,2893,4,0,5,9
6627,KURNOOL,HALAHARVI,MEDEHAL,126,1,392,519,50,1,188,239,200,3051,100,9547,12698,7788,5,1,6,12
6628,KURNOOL,HALAHARVI,NITRAVATTI,53,0,560,613,46,0,389,435,450,2109,0,18982,21091,12519,0,0,21,21
6629,KURNOOL,HALAHARVI,SIDDAPURAM,38,0,755,793,22,0,413,435,434,1056,0,25091,26147,13454,3,0,81,84
6630,KURNOOL,HALAHARVI,TSAKIBANDA,59,1,241,301,34,1,112,147,134,1922,26,6222,8170,5338,5,0,13,18
6631,KURNOOL,HALAHARVI,VIRUPAPURAM,81,8,891,980,43,1,467,511,542,2729,17,21646,24392,12970,6,0,31,37
6632,KURNOOL,HOLAGUNDA,CHINNAHYTA,169,3,561,733,97,0,291,388,374,3422,0,14089,17511,9368,9,0,41,50
6633,KURNOOL,HOLAGUNDA,GAJJEHALLI,108,0,444,552,50,0,193,243,246,1742,0,8265,10007,6039,3,0,16,19
6634,KURNOOL,HOLAGUNDA,H.KOTTALA,64,0,130,194,39,0,32,71,73,2742,0,1513,4255,2223,13,0,4,17
6635,KURNOOL,HOLAGUNDA,HEBBATAM,219,12,793,1024,77,5,280,362,337,2246,124,10224,12594,6394,2,0,23,25
6636,KURNOOL,HOLAGUNDA,HOLAGUNDA,338,13,2001,2352,63,0,425,488,460,3708,0,21129,24837,13639,9,0,53,62
6637,KURNOOL,HOLAGUNDA,INGALADAHAL,141,0,198,339,52,0,82,134,83,817,0,2394,3211,1459,0,0,5,5
6638,KURNOOL,HOLAGUNDA,KOGILATHOTA,148,0,371,519,107,0,259,366,325,4373,0,13919,18292,8778,2,0,31,33
6639,KURNOOL,HOLAGUNDA,LINGADAHALLI,94,6,337,437,47,4,129,180,134,1972,126,3601,5699,2767,2,0,1,3
6640,KURNOOL,HOLAGUNDA,MADDI LINGADAHALLI,92,0,211,303,26,0,88,114,108,468,0,3791,4259,2095,0,0,6,6
6641,KURNOOL,HOLAGUNDA,MARLAMADIKI,146,0,438,584,88,0,178,266,278,4275,0,6715,10990,6167,11,0,22,33
6642,KURNOOL,HOLAGUNDA,NERANIKI,129,35,529,693,57,0,116,173,169,1937,0,4302,6239,3221,1,0,1,2
6643,KURNOOL,HOLAGUNDA,NERANIKI THANDA,0,297,0,297,0,212,0,212,200,0,7207,0,7207,3371,0,9,0,9
6644,KURNOOL,HOLAGUNDA,PEDDA GONEHAL,69,0,277,346,38,0,107,145,120,997,0,5166,6163,3230,0,0,13,13
6645,KURNOOL,HOLAGUNDA,SAMMATHAGIRI,28,3,214,245,15,2,113,130,130,1143,28,4214,5385,2250,7,0,4,11
6646,KURNOOL,HOLAGUNDA,SULUVOY,102,0,390,492,47,0,144,191,203,2865,0,7993,10858,5746,11,0,23,34
6647,KURNOOL,HOLAGUNDA,VANDAVAGALI,145,2,456,603,40,0,27,67,82,2357,0,609,2966,1566,5,0,1,6
6648,KURNOOL,HOLAGUNDA,YELLARTHY,186,0,416,602,106,0,105,211,173,3274,0,3183,6457,3050,2,0,4,6
6649,KURNOOL,JUPADU BUNGALOW,BANNUR,473,69,796,1338,160,4,113,277,242,7431,86,3519,11036,5426,10,0,2,12
6650,KURNOOL,JUPADU BUNGALOW,BHASKARAPURAM,284,2,270,556,160,0,116,276,276,6695,0,3484,10179,5690,13,0,2,15
6651,KURNOOL,JUPADU BUNGALOW,JUPADU BUNGALOW,628,4,676,1308,181,1,210,392,384,4590,11,6280,10881,6435,0,0,1,1
6652,KURNOOL,JUPADU BUNGALOW,LINGAPURAM,213,9,252,474,119,3,44,166,167,6364,60,2072,8496,5110,16,0,6,22
6653,KURNOOL,JUPADU BUNGALOW,MANDLEM,574,24,1196,1794,50,1,70,121,122,890,6,1981,2877,1676,0,0,3,3
6654,KURNOOL,JUPADU BUNGALOW,PARUMANCHALA,598,6,1018,1622,154,0,50,204,181,6227,0,1471,7698,3684,16,0,0,16
6655,KURNOOL,JUPADU BUNGALOW,POTULAPADU,217,1,299,517,70,0,69,139,122,2573,0,1328,3901,1829,7,0,0,7
6656,KURNOOL,JUPADU BUNGALOW,TANGADANCHA,333,0,758,1091,115,0,27,142,132,6728,0,554,7282,3768,27,0,0,27
6657,KURNOOL,JUPADU BUNGALOW,TARIGOPULA,301,10,1326,1637,57,1,247,305,302,1260,1,4764,6025,3204,0,0,0,0
6658,KURNOOL,JUPADU BUNGALOW,TARTUR,226,0,538,764,91,0,98,189,177,2378,0,3068,5446,2817,2,0,4,6
6659,KURNOOL,JUPADU BUNGALOW,TATIPADU,119,1,605,725,59,1,146,206,183,1385,9,3860,5254,2751,1,0,7,8
6660,KURNOOL,JUPADU BUNGALOW,THUDICHERLA,285,7,887,1179,125,0,490,615,583,4535,0,15702,20237,10414,9,0,16,25
6661,KURNOOL,KALLUR,A.GOKULAPADU,302,1,639,942,168,0,99,267,286,5670,0,2651,8321,5727,1,0,0,1
6662,KURNOOL,KALLUR,BASTIPADU,181,0,857,1038,106,0,102,208,209,5310,0,4055,9365,5123,13,0,2,15
6663,KURNOOL,KALLUR,BOLLAVARAM,80,16,670,766,0,1,72,73,56,0,5,2835,2840,1588,0,0,5,5
6664,KURNOOL,KALLUR,CHETLA MALLAPURAM,60,0,224,284,35,0,122,157,154,993,0,3761,4754,3581,1,0,3,4
6665,KURNOOL,KALLUR,CHINNA TEKUR,229,1,746,976,27,0,115,142,117,1219,0,3896,5115,2649,1,0,3,4
6666,KURNOOL,KALLUR,K.MARKAPURAM,125,0,373,498,1,0,78,79,77,17,0,1365,1382,756,0,0,0,0
6667,KURNOOL,KALLUR,KONGANAPADU,217,3,1065,1285,57,0,179,236,243,1093,0,1885,2978,2562,0,0,0,0
6668,KURNOOL,KALLUR,LAXMIPURAM,484,42,1058,1584,149,2,165,316,301,2446,55,4781,7282,4813,1,0,4,5
6669,KURNOOL,KALLUR,NAYAKALLU,114,0,442,556,49,0,160,209,206,1442,0,3161,4603,3522,0,0,0,0
6670,KURNOOL,KALLUR,NERAWADA,48,0,246,294,16,0,53,69,67,89,0,299,388,304,0,0,0,0
6671,KURNOOL,KALLUR,PANDIPADU,121,1,644,766,45,1,154,200,225,798,26,4175,4999,4394,0,0,1,1
6672,KURNOOL,KALLUR,PARLA,437,2,1329,1768,187,0,220,407,359,4678,0,4374,9052,5445,0,0,0,0
6673,KURNOOL,KALLUR,PEDDA TEKUR,207,0,734,941,50,0,35,85,80,2030,0,1261,3291,2756,3,0,0,3
6674,KURNOOL,KALLUR,PEDDAKOTTALA.,53,0,167,220,16,0,22,38,38,397,0,502,899,447,0,0,1,1
6675,KURNOOL,KALLUR,PEDDAPADU,336,0,903,1239,30,0,257,287,272,801,0,8646,9447,8016,0,0,3,3
6676,KURNOOL,KALLUR,PUSULUR,119,3,538,660,8,0,137,145,132,172,0,2512,2684,1488,0,0,1,1
6677,KURNOOL,KALLUR,REMADUR,61,1,274,336,32,0,66,98,86,1558,0,1784,3342,1596,4,0,0,4
6678,KURNOOL,KALLUR,SALKAPURAM,85,1,424,510,36,0,93,129,114,999,0,1931,2930,1636,1,0,2,3
6679,KURNOOL,KALLUR,THADAKANAPALLE,231,64,682,977,65,2,40,107,103,2085,28,756,2869,2192,3,0,0,3
6680,KURNOOL,KALLUR,ULINDAKONDA,293,124,1093,1510,3,24,203,230,217,61,388,6830,7279,5279,0,0,4,4
6681,KURNOOL,KALLUR,YAPARLAPADU,60,1,397,458,15,0,141,156,144,458,0,4951,5409,2943,1,0,10,11
6682,KURNOOL,KODUMUR,AMADAGUNTLA,153,1,1128,1282,5,0,149,154,161,161,0,4152,4313,2262,0,0,5,5
6683,KURNOOL,KODUMUR,ANUGONDA,168,0,671,839,68,0,394,462,453,2681,0,19318,21999,11521,4,0,40,44
6684,KURNOOL,KODUMUR,GORANTLA,231,2,1364,1597,3,0,159,162,157,7,0,1956,1963,1108,0,0,0,0
6685,KURNOOL,KODUMUR,KALLAPARRI,104,0,518,622,63,0,224,287,281,1064,0,6466,7530,4159,0,0,3,3
6686,KURNOOL,KODUMUR,KODUMUR,477,17,2479,2973,55,0,370,425,413,1676,0,10108,11784,8486,1,0,6,7
6687,KURNOOL,KODUMUR,KRISHNAPURAM,90,0,368,458,44,0,218,262,259,1458,0,7529,8987,5271,0,0,0,0
6688,KURNOOL,KODUMUR,LADDAGIRI,490,0,2008,2498,50,0,725,775,791,1161,0,24588,25749,13787,0,0,20,20
6689,KURNOOL,KODUMUR,MUDUMALAGURTHY,108,0,453,561,59,0,279,338,347,2373,0,15906,18279,9630,4,0,55,59
6690,KURNOOL,KODUMUR,PULAKURTHY,393,21,1707,2121,67,0,333,400,438,2476,0,12614,15090,8141,4,0,29,33
6691,KURNOOL,KODUMUR,PYALAKURTHY,399,0,1913,2312,64,0,129,193,189,949,0,3672,4621,2502,0,0,0,0
6692,KURNOOL,KODUMUR,VARKUR,363,2,1143,1508,232,0,525,757,769,8187,0,11472,19659,10857,5,0,3,8
6693,KURNOOL,KODUMUR,VENKATAGIRI,116,0,643,759,71,0,224,295,299,1103,0,7381,8484,5052,0,0,13,13
6694,KURNOOL,KODUMUR,YERRADODDI,115,4,853,972,37,0,243,280,273,2256,0,12278,14534,7424,7,0,21,28
6695,KURNOOL,KOILKUNTLA,AMADALA,133,0,268,401,74,0,147,221,225,3126,0,5871,8997,6695,2,0,3,5
6696,KURNOOL,KOILKUNTLA,BHEEMUNIPADU,212,2,412,626,117,0,136,253,236,2666,0,5284,7950,5301,0,0,5,5
6697,KURNOOL,KOILKUNTLA,BIJINAVEMULA,73,0,284,357,21,0,118,139,153,863,0,6585,7448,5313,2,0,19,21
6698,KURNOOL,KOILKUNTLA,CHINNA KOPPERLA,90,0,172,262,77,0,120,197,199,3515,0,4133,7648,4346,1,0,3,4
6699,KURNOOL,KOILKUNTLA,GULLADURTHI,265,2,710,977,78,0,231,309,297,4952,0,9715,14667,8621,13,0,6,19
6700,KURNOOL,KOILKUNTLA,GUNJALAPADU,28,0,145,173,20,0,65,85,86,547,0,1777,2324,1603,0,0,0,0
6701,KURNOOL,KOILKUNTLA,JOLADARASI,115,0,228,343,100,0,140,240,230,4376,0,5319,9695,5683,12,0,2,14
6702,KURNOOL,KOILKUNTLA,KALUGOTLA,80,0,544,624,41,0,96,137,137,1801,0,2498,4299,2454,4,0,0,4
6703,KURNOOL,KOILKUNTLA,KAMPAMALLA,115,0,323,438,78,0,92,170,172,2272,0,2870,5142,3276,0,0,3,3
6704,KURNOOL,KOILKUNTLA,KOILKUNTLA,644,106,850,1600,306,29,204,539,535,12894,963,8140,21997,19811,8,0,0,8
6705,KURNOOL,KOILKUNTLA,LINGALA,75,0,312,387,31,0,71,102,93,1098,0,2282,3380,1933,0,0,0,0
6706,KURNOOL,KOILKUNTLA,PEDDA KOPPERLA,45,0,162,207,36,0,101,137,153,1867,0,5150,7017,4610,3,0,4,7
6707,KURNOOL,KOILKUNTLA,POTTIPADU,59,1,160,220,36,0,49,85,87,1329,0,1303,2632,2026,0,0,0,0
6708,KURNOOL,KOILKUNTLA,REVANUR,190,38,378,606,56,0,132,188,184,2788,0,7454,10242,5945,8,0,25,33
6709,KURNOOL,KOILKUNTLA,SOUDERDINNE,180,0,280,460,54,0,88,142,142,1924,0,5285,7209,4752,4,0,7,11
6710,KURNOOL,KOILKUNTLA,VALLAMPADU,56,0,176,232,48,0,119,167,159,2337,0,6180,8517,4781,1,0,6,7
6711,KURNOOL,KOILKUNTLA,VELAGATUR,61,3,205,269,15,0,11,26,31,230,0,184,414,328,0,0,0,0
6712,KURNOOL,KOLIMIGUNDLA,ABDULLAPURAM,120,7,477,604,68,2,244,314,316,3711,22,5555,9288,7177,6,0,1,7
6713,KURNOOL,KOLIMIGUNDLA,ANKIREDDIPALLI,35,3,568,606,14,0,97,111,110,525,0,2305,2830,2743,0,0,0,0
6714,KURNOOL,KOLIMIGUNDLA,BANDARLAPALLE,31,1,555,587,16,0,216,232,227,421,0,6451,6872,5687,0,0,4,4
6715,KURNOOL,KOLIMIGUNDLA,BELUM,402,1,358,761,135,0,54,189,203,2397,0,1727,4124,3955,0,0,1,1
6716,KURNOOL,KOLIMIGUNDLA,BELUMSINGAVARAM,106,0,152,258,46,0,84,130,140,938,0,2481,3419,2828,1,0,0,1
6717,KURNOOL,KOLIMIGUNDLA,BOYALA UPPALUR,109,70,436,615,4,3,55,62,53,157,45,1518,1720,980,0,0,0,0
6718,KURNOOL,KOLIMIGUNDLA,CHINTALAYAPALLE,86,2,721,809,50,1,286,337,351,984,6,2931,3921,3483,0,0,0,0
6719,KURNOOL,KOLIMIGUNDLA,ERRAGUDI,161,26,500,687,64,4,260,328,329,1542,100,6320,7962,4943,0,0,0,0
6720,KURNOOL,KOLIMIGUNDLA,GORVIMANUPALLI,96,18,902,1016,50,8,363,421,444,1235,193,8694,10122,8535,0,0,0,0
6721,KURNOOL,KOLIMIGUNDLA,ITIKALA,122,2,193,317,45,0,68,113,119,1634,0,2530,4164,3978,0,0,1,1
6722,KURNOOL,KOLIMIGUNDLA,KALVATALA,175,0,151,326,89,0,60,149,142,4648,0,2844,7492,6025,10,0,2,12
6723,KURNOOL,KOLIMIGUNDLA,KAMMAVARIPALLI,15,0,239,254,0,0,33,33,33,0,0,1408,1408,753,0,0,1,1
6724,KURNOOL,KOLIMIGUNDLA,KANAKADRI PALLE,126,9,586,721,57,3,218,278,291,1591,87,4358,6036,5725,0,0,0,0
6725,KURNOOL,KOLIMIGUNDLA,KOLIMIGUNDLA,213,21,870,1104,90,7,294,391,367,2628,112,6459,9199,8487,0,0,0,0
6726,KURNOOL,KOLIMIGUNDLA,KOTAPADU,132,0,390,522,57,0,97,154,160,734,0,1323,2057,1256,0,0,0,0
6727,KURNOOL,KOLIMIGUNDLA,MIRJAPURAM,1,0,325,326,0,0,182,182,176,0,0,3187,3187,2617,0,0,0,0
6728,KURNOOL,KOLIMIGUNDLA,NANDIPADU,98,6,301,405,44,3,151,198,194,1255,80,4238,5573,4310,0,0,0,0
6729,KURNOOL,KOLIMIGUNDLA,PEDDAVENTHURLA,78,0,282,360,41,0,111,152,149,2269,0,4755,7024,4408,5,0,8,13
6730,KURNOOL,KOLIMIGUNDLA,PETNIKOTA,185,1,542,728,7,1,163,171,178,420,52,9680,10152,9931,0,0,7,7
6731,KURNOOL,KOLIMIGUNDLA,THIMMANAYUNIPETA,90,2,556,648,46,0,292,338,313,1848,0,11569,13417,10601,0,0,2,2
6732,KURNOOL,KOLIMIGUNDLA,THOLLAMADUGU,70,184,364,618,35,161,208,404,365,2138,5905,8498,16541,10938,3,0,2,5
6733,KURNOOL,KOLIMIGUNDLA,THUMMALAPENTA,184,7,345,536,84,1,129,214,211,2485,4,4265,6754,6612,0,0,1,1
6734,KURNOOL,KOSIGI,AGASANUR,43,3,500,546,0,0,14,14,11,0,0,42,42,22,0,0,0,0
6735,KURNOOL,KOSIGI,ARLABANDA,41,2,576,619,23,0,266,289,303,686,0,15581,16267,10214,0,0,56,56
6736,KURNOOL,KOSIGI,BELAGALLU,78,0,483,561,23,0,260,283,252,514,0,11584,12098,6074,0,0,45,45
6737,KURNOOL,KOSIGI,CHINTAKUNTA,56,0,338,394,32,0,125,157,98,1744,0,4384,6128,2637,5,0,2,7
6738,KURNOOL,KOSIGI,CHIRTHANAKAL,36,0,557,593,18,0,313,331,286,517,0,16676,17193,8070,0,0,47,47
6739,KURNOOL,KOSIGI,DUDDI,80,0,546,626,34,0,407,441,490,1695,0,18788,20483,10309,2,0,40,42
6740,KURNOOL,KOSIGI,IRANGAL,89,1,248,338,49,0,171,220,225,3157,0,10634,13791,7101,9,0,25,34
6741,KURNOOL,KOSIGI,JAMPAPURAM,117,6,485,608,67,2,323,392,405,2778,30,15661,18469,11848,1,0,40,41
6742,KURNOOL,KOSIGI,KAMANDODDI,58,0,423,481,0,0,5,5,1,0,0,36,36,6,0,0,0,0
6743,KURNOOL,KOSIGI,KANDUKUR,140,2,718,860,30,0,280,310,290,629,0,12670,13299,7173,0,0,21,21
6744,KURNOOL,KOSIGI,KOSIGI,701,13,3381,4095,50,0,201,251,260,721,0,5141,5862,3069,1,0,9,10
6745,KURNOOL,KOSIGI,PALLIPADU,42,0,584,626,5,0,363,368,430,76,0,29627,29703,14600,0,0,142,142
6746,KURNOOL,KOSIGI,PEDDA BOMPALLI,203,6,1157,1366,29,0,422,451,582,2554,0,34647,37201,17271,14,0,177,191
6747,KURNOOL,KOSIGI,SAJJALAGUDDAM,94,0,391,485,52,0,215,267,264,2422,0,10678,13100,6696,5,0,22,27
6748,KURNOOL,KOSIGI,SATHANUR,102,0,461,563,29,0,222,251,280,1354,0,11344,12698,7523,4,0,37,41
6749,KURNOOL,KOSIGI,VANDAGALLU,145,15,609,769,40,0,178,218,228,1543,0,6706,8249,4302,3,0,15,18
6750,KURNOOL,KOSIGI,ZUMALADINNE,139,0,604,743,11,0,87,98,155,180,0,2075,2255,1117,0,0,1,1
6751,KURNOOL,KOTHAPALLE,DUDYALA,407,8,756,1171,199,1,133,333,301,7823,1,2385,10209,5608,17,0,0,17
6752,KURNOOL,KOTHAPALLE,EDURUPADU,222,10,504,736,69,0,89,158,132,3461,0,1253,4714,2204,12,0,0,12
6753,KURNOOL,KOTHAPALLE,ERRAMATAM,319,373,1111,1803,36,44,106,186,168,277,2626,1248,4151,2393,0,8,0,8
6754,KURNOOL,KOTHAPALLE,G.VEERAPURAM,158,4,352,514,65,2,102,169,167,1348,43,1037,2428,1381,0,0,0,0
6755,KURNOOL,KOTHAPALLE,GOKAVARAM,372,15,548,935,174,1,86,261,265,6418,20,2929,9367,5006,14,0,5,19
6756,KURNOOL,KOTHAPALLE,GUMMADAPURAM,262,77,620,959,91,29,34,154,147,3274,1371,875,5520,2664,9,1,1,11
6757,KURNOOL,KOTHAPALLE,GUVVLAKUNTA,198,314,687,1199,70,99,208,377,364,2717,11386,5232,19335,10305,9,46,0,55
6758,KURNOOL,KOTHAPALLE,KOKKERANCHA,379,0,411,790,155,0,86,241,222,5742,0,2025,7767,4080,2,0,1,3
6759,KURNOOL,KOTHAPALLE,KOTHAPALLE,342,175,1112,1629,188,53,425,666,675,9048,1960,12119,23127,12207,9,2,2,13
6760,KURNOOL,KOTHAPALLE,MUSALIMADUGU,282,36,773,1091,80,1,74,155,129,2990,52,1880,4922,2446,5,0,1,6
6761,KURNOOL,KOTHAPALLE,NANDIKUNTA,71,0,485,556,23,0,115,138,113,195,0,942,1137,621,0,0,0,0
6762,KURNOOL,KOTHAPALLE,SIVAPURAM,180,224,480,884,44,44,42,130,126,722,6335,1770,8827,4764,0,33,3,36
6763,KURNOOL,KOWTHALAM,BADINEHAL,421,37,377,835,113,12,107,232,242,2508,113,1833,4454,2424,0,0,0,0
6764,KURNOOL,KOWTHALAM,BAPURAM,383,4,648,1035,98,0,140,238,244,4844,0,5651,10495,5769,19,0,9,28
6765,KURNOOL,KOWTHALAM,CHIRTAPALLE,82,0,341,423,24,0,107,131,109,1096,0,2081,3177,1454,2,0,0,2
6766,KURNOOL,KOWTHALAM,CHUDI,199,1,829,1029,18,0,72,90,68,147,0,1401,1548,675,0,0,0,0
6767,KURNOOL,KOWTHALAM,GOTHULADODDI,1,0,572,573,0,0,174,174,188,0,0,6839,6839,3647,0,0,14,14
6768,KURNOOL,KOWTHALAM,GUDIKAMBALI,139,4,354,497,33,1,85,119,106,693,15,1715,2423,1284,1,0,1,2
6769,KURNOOL,KOWTHALAM,HALVI,242,8,1088,1338,25,0,302,327,355,205,0,5486,5691,3173,0,0,0,0
6770,KURNOOL,KOWTHALAM,KAMAVARAM,208,0,528,736,57,0,18,75,62,3764,0,1179,4943,2491,19,0,6,25
6771,KURNOOL,KOWTHALAM,KATRIKI,188,6,237,431,12,0,17,29,22,348,0,655,1003,476,1,0,0,1
6772,KURNOOL,KOWTHALAM,KOWTHALAM,771,41,1686,2498,48,2,103,153,140,2002,80,2779,4861,2463,7,0,5,12
6773,KURNOOL,KOWTHALAM,KUMBALANUR,194,18,514,726,9,0,79,88,76,98,0,2317,2415,1105,0,0,3,3
6774,KURNOOL,KOWTHALAM,KUNTANAHAL,146,2,416,564,6,0,4,10,10,16,0,116,132,68,0,0,1,1
6775,KURNOOL,KOWTHALAM,LINGALADINNE,248,2,568,818,109,1,204,314,287,2249,16,4233,6498,3377,0,0,0,0
6776,KURNOOL,KOWTHALAM,MALLANAHATTI,49,0,220,269,1,0,91,92,73,11,0,5944,5955,2700,0,0,24,24
6777,KURNOOL,KOWTHALAM,NADICHAGI,82,1,665,748,4,0,31,35,35,36,0,404,440,249,0,0,0,0
6778,KURNOOL,KOWTHALAM,PODALAKUNTA,84,7,345,436,15,0,15,30,30,236,0,120,356,178,0,0,0,0
6779,KURNOOL,KOWTHALAM,ROWDUR,156,0,394,550,62,0,136,198,184,1397,0,3640,5037,2640,1,0,3,4
6780,KURNOOL,KOWTHALAM,SULAKERI,252,9,443,704,0,0,0,0,0,0,0,0,0,0,0,0,0,0
6781,KURNOOL,KOWTHALAM,THOVI,131,0,449,580,0,0,127,127,121,0,0,4101,4101,2090,0,0,2,2
6782,KURNOOL,KOWTHALAM,UPPARAHAL,147,1,405,553,33,0,72,105,111,1626,0,3264,4890,2884,6,0,12,18
6783,KURNOOL,KOWTHALAM,URUKUNDA,470,28,1093,1591,76,0,59,135,115,1414,0,1115,2529,1080,0,0,0,0
6784,KURNOOL,KOWTHALAM,VALLURU,72,5,331,408,1,0,49,50,41,6,0,1150,1156,529,0,0,0,0
6785,KURNOOL,KOWTHALAM,YERIGIRI,184,20,667,871,59,0,18,77,69,1519,0,171,1690,1002,2,0,0,2
6786,KURNOOL,KRISHNAGIRI,AGAVELI,54,12,331,397,21,0,136,157,165,719,0,2886,3605,1817,0,0,0,0
6787,KURNOOL,KRISHNAGIRI,ALAMKONDA,228,1,1620,1849,28,0,308,336,312,453,0,8857,9310,4378,0,0,4,4
6788,KURNOOL,KRISHNAGIRI,AMAKATHADU,227,5,1537,1769,97,0,568,665,626,1774,0,16036,17810,8922,0,0,3,3
6789,KURNOOL,KRISHNAGIRI,CHITYALA,172,36,515,723,0,0,4,4,1,0,0,24,24,6,0,0,0,0
6790,KURNOOL,KRISHNAGIRI,CHUNCHU YERRAGUDI,331,21,1535,1887,0,0,4,4,3,0,0,42,42,18,0,0,0,0
6791,KURNOOL,KRISHNAGIRI,KAMBALAPADU,315,0,1102,1417,84,0,425,509,484,2364,0,16520,18884,10026,1,0,10,11
6792,KURNOOL,KRISHNAGIRI,KATARIKONDA,142,1,927,1070,19,0,82,101,85,259,0,809,1068,481,0,0,0,0
6793,KURNOOL,KRISHNAGIRI,KOILKONDA,65,1,743,809,3,0,78,81,76,67,0,1730,1797,911,0,0,0,0
6794,KURNOOL,KRISHNAGIRI,KRISHNAGIRI,126,88,859,1073,93,76,515,684,706,2953,2303,16266,21522,11093,0,0,3,3
6795,KURNOOL,KRISHNAGIRI,LAKKASAGARAM,385,6,1269,1660,25,0,50,75,68,352,0,650,1002,474,0,0,0,0
6796,KURNOOL,KRISHNAGIRI,POTHUGAL,162,4,1070,1236,137,1,829,967,809,3256,20,19033,22309,10772,0,0,1,1
6797,KURNOOL,KRISHNAGIRI,SHO. YERRAGUDI,264,8,608,880,7,2,96,105,94,58,22,1029,1109,553,0,0,0,0
6798,KURNOOL,KRISHNAGIRI,TALLAGOKULAPADU,90,0,467,557,66,0,249,315,280,1407,0,5364,6771,3895,0,0,0,0
6799,KURNOOL,KRISHNAGIRI,THOGARCHEDU,133,1,617,751,82,0,334,416,386,2820,0,17826,20646,10943,1,0,22,23
6800,KURNOOL,KRISHNAGIRI,YERUKALACHERUVU,123,15,591,729,8,0,125,133,129,220,0,2033,2253,1261,0,0,0,0
6801,KURNOOL,KURNOOL,B.THANDRAPADU,168,0,183,351,0,0,4,4,6,0,0,32,32,24,0,0,0,0
6802,KURNOOL,KURNOOL,BASAVAPURAM,116,0,387,503,91,0,166,257,223,6432,0,8491,14923,8006,30,0,6,36
6803,KURNOOL,KURNOOL,DEVAMADA,106,0,319,425,2,0,2,4,5,22,0,40,62,34,0,0,0,0
6804,KURNOOL,KURNOOL,DIGUVAPADU,134,1,418,553,21,0,59,80,83,602,0,1728,2330,1767,0,0,1,1
6805,KURNOOL,KURNOOL,DINNEDEVARAPADU,267,2,357,626,59,0,101,160,158,2311,0,6067,8378,6606,3,0,13,16
6806,KURNOOL,KURNOOL,E.THANDRAPADU,440,1,2301,2742,27,0,117,144,124,238,0,1909,2147,1416,0,0,0,0
6807,KURNOOL,KURNOOL,EDURUR,44,0,310,354,15,0,136,151,146,854,0,7689,8543,5140,3,0,32,35
6808,KURNOOL,KURNOOL,G.SINGAVARAM,480,5,902,1387,35,0,9,44,34,875,0,128,1003,628,0,0,0,0
6809,KURNOOL,KURNOOL,GARGEYAPURAM,633,4,536,1173,198,0,0,198,200,6523,0,0,6523,5083,4,0,0,4
6810,KURNOOL,KURNOOL,GONDIPARLA,335,0,1424,1759,24,0,108,132,115,411,0,2062,2473,1875,0,0,0,0
6811,KURNOOL,KURNOOL,MAMIDALAPADU,0,0,1,1,0,0,0,0,0,0,0,0,0,0,0,0,0,0
6812,KURNOOL,KURNOOL,MUNAGALAPADU,199,0,218,417,0,0,0,0,0,0,0,0,0,0,0,0,0,0
6813,KURNOOL,KURNOOL,NANDANAPALLI,459,79,569,1107,149,3,132,284,266,4274,108,3330,7712,5312,3,0,4,7
6814,KURNOOL,KURNOOL,NIDZUR,243,4,1007,1254,81,0,174,255,246,3457,0,8727,12184,9645,1,0,13,14
6815,KURNOOL,KURNOOL,PADIDEMPADU,337,7,263,607,59,0,30,89,81,2816,0,877,3693,1859,7,0,2,9
6816,KURNOOL,KURNOOL,PANCHALINGALA,616,2,1347,1965,14,1,129,144,141,279,20,4764,5063,4262,0,0,4,4
6817,KURNOOL,KURNOOL,PASUPULA,677,12,784,1473,56,0,44,100,94,1870,0,608,2478,1668,2,0,0,2
6818,KURNOOL,KURNOOL,PUDUR,131,6,230,367,89,3,98,190,179,1606,62,2021,3689,2532,0,0,1,1
6819,KURNOOL,KURNOOL,R.K.DUDYALA,188,1,232,421,115,0,52,167,163,6021,0,2458,8479,4308,22,0,5,27
6820,KURNOOL,KURNOOL,R.KONTHALAPADU,280,0,1079,1359,33,0,170,203,170,1017,0,7477,8494,4229,2,0,18,20
6821,KURNOOL,KURNOOL,REMATA,241,0,775,1016,121,0,272,393,387,5395,0,7080,12475,7264,6,0,2,8
6822,KURNOOL,KURNOOL,RUDRAVARAM,103,3,395,501,57,0,195,252,236,2774,0,7620,10394,6078,7,0,14,21
6823,KURNOOL,KURNOOL,SIVARAMAPURAM,0,2,155,157,0,1,102,103,95,0,35,6505,6540,3738,0,0,28,28
6824,KURNOOL,KURNOOL,STANTAMPURAM,130,0,142,272,0,0,0,0,0,0,0,0,0,0,0,0,0,0
6825,KURNOOL,KURNOOL,SUNKESULA,261,0,544,805,0,0,0,0,0,0,0,0,0,0,0,0,0,0
6826,KURNOOL,KURNOOL,ULCHALA,706,10,1531,2247,348,7,91,446,390,18875,251,1510,20636,11731,61,1,2,64
6827,KURNOOL,MADDIKERA EAST,BASINEPALLI,72,68,533,673,51,8,345,404,410,2241,108,12316,14665,7738,0,0,5,5
6828,KURNOOL,MADDIKERA EAST,BURUJULA,76,0,371,447,51,0,231,282,254,2805,0,5747,8552,4553,6,0,3,9
6829,KURNOOL,MADDIKERA EAST,HAMPA,97,6,518,621,36,1,324,361,346,875,75,10430,11380,6255,1,0,4,5
6830,KURNOOL,MADDIKERA EAST,MADDIKERA (EAST),425,19,2445,2889,125,5,741,871,823,3468,149,25104,28721,17071,1,0,15,16
6831,KURNOOL,MADDIKERA EAST,MADDIKERA AGRAHARAM,93,5,1630,1728,56,1,470,527,519,2257,20,16684,18961,9686,1,0,20,21
6832,KURNOOL,MADDIKERA EAST,PERAVALI,218,33,1935,2186,55,13,707,775,740,987,418,15764,17169,9128,0,1,10,11
6833,KURNOOL,MADDIKERA EAST,YEDAVALI,46,1,260,307,13,1,160,174,161,399,21,7380,7800,4203,0,0,8,8
6834,KURNOOL,MAHANANDI,ABBIPURAM,94,19,399,512,14,0,102,116,118,459,0,4459,4918,3345,0,0,5,5
6835,KURNOOL,MAHANANDI,BOLLAVARAM,132,0,540,672,79,0,117,196,197,3154,0,3884,7038,4524,3,0,2,5
6836,KURNOOL,MAHANANDI,BUKKAPURAM,202,14,542,758,109,3,121,233,218,4850,111,3920,8881,5178,6,0,5,11
6837,KURNOOL,MAHANANDI,GAJULAPALLE,398,65,459,922,114,0,67,181,173,3172,0,1624,4796,2973,2,0,0,2
6838,KURNOOL,MAHANANDI,GOPAVARAM,426,101,740,1267,4,2,17,23,19,125,95,869,1089,481,0,0,3,3
6839,KURNOOL,MAHANANDI,MAHANANDI,62,72,384,518,23,19,96,138,133,1475,806,5094,7375,5896,5,3,13,21
6840,KURNOOL,MAHANANDI,MASEEDUPURAM,271,1,257,529,109,0,57,166,191,3463,0,1924,5387,3171,2,0,1,3
6841,KURNOOL,MAHANANDI,NANDIPALLE,73,0,195,268,41,0,104,145,133,995,0,1920,2915,1743,0,0,0,0
6842,KURNOOL,MAHANANDI,SEETHARAMPURAM,114,0,297,411,29,0,152,181,172,961,0,7754,8715,5197,1,0,10,11
6843,KURNOOL,MAHANANDI,THAMMADAPALLE,277,1,254,532,93,0,54,147,136,943,0,593,1536,939,0,0,0,0
6844,KURNOOL,MAHANANDI,THIMMAPURAM,337,4,676,1017,88,0,10,98,99,5270,0,262,5532,3972,16,0,0,16
6845,KURNOOL,MANTRALAYAM,BASAPURAM,109,0,375,484,75,0,124,199,216,4964,0,4157,9121,6344,19,0,4,23
6846,KURNOOL,MANTRALAYAM,BUDUR,220,0,351,571,116,0,65,181,166,8345,0,1458,9803,5012,37,0,3,40
6847,KURNOOL,MANTRALAYAM,CHETNIHALLI,84,1,497,582,34,0,146,180,185,1553,0,5799,7352,5077,3,0,2,5
6848,KURNOOL,MANTRALAYAM,CHILAKALADONA,89,1,433,523,17,0,108,125,142,247,0,4037,4284,2347,0,0,5,5
6849,KURNOOL,MANTRALAYAM,KACHAPURAM,114,22,556,692,63,2,220,285,302,4420,34,5557,10011,6329,20,0,2,22
6850,KURNOOL,MANTRALAYAM,KAGGALLU,53,0,308,361,23,0,189,212,213,1270,0,8625,9895,6974,2,0,21,23
6851,KURNOOL,MANTRALAYAM,KALLUDEVAKUNTA,45,1,300,346,0,0,151,151,154,0,0,6585,6585,4171,0,0,8,8
6852,KURNOOL,MANTRALAYAM,MADHAVARAM,155,103,626,884,14,45,241,300,322,302,1931,9447,11680,5740,0,3,17,20
6853,KURNOOL,MANTRALAYAM,MALAPALLE,103,1,446,550,46,0,160,206,235,1220,0,6350,7570,3953,0,0,9,9
6854,KURNOOL,MANTRALAYAM,MANCHALA,172,3,1895,2070,74,0,143,217,232,4965,0,4149,9114,7906,14,0,0,14
6855,KURNOOL,MANTRALAYAM,PARAMANDODDI,78,75,129,282,65,41,97,203,231,4962,1558,5728,12248,6112,12,1,5,18
6856,KURNOOL,MANTRALAYAM,RACHUMARRI,188,0,580,768,56,0,217,273,286,1179,0,7816,8995,4636,0,0,10,10
6857,KURNOOL,MANTRALAYAM,RAMPURAM,157,4,287,448,59,0,130,189,172,1524,0,5896,7420,3821,2,0,15,17
6858,KURNOOL,MANTRALAYAM,SUGUR,125,1,480,606,18,0,202,220,212,777,0,8137,8914,4623,1,0,5,6
6859,KURNOOL,MANTRALAYAM,SUNKESWARI,72,2,386,460,48,0,171,219,268,1552,0,8064,9616,5036,1,0,26,27
6860,KURNOOL,MANTRALAYAM,V.THIMMAPURAM,74,0,187,261,64,0,154,218,204,3565,0,7423,10988,5783,6,0,8,14
6861,KURNOOL,MANTRALAYAM,VAGARURU,186,0,798,984,117,0,324,441,461,6291,0,13616,19907,10803,16,0,33,49
6862,KURNOOL,MIDTHUR,ALAGANUR,272,0,310,582,111,0,115,226,202,2513,0,3367,5880,2758,2,0,2,4
6863,KURNOOL,MIDTHUR,BANNUR,136,3,251,390,45,1,73,119,112,2005,90,3916,6011,3156,5,0,9,14
6864,KURNOOL,MIDTHUR,BYRAPURAM,16,0,298,314,11,0,153,164,148,162,0,6439,6601,3261,0,0,1,1
6865,KURNOOL,MIDTHUR,CHERUKUCHERLA,373,0,445,818,182,0,146,328,324,5725,0,5936,11661,6272,4,0,3,7
6866,KURNOOL,MIDTHUR,CHINTALAPALLE,180,1,917,1098,14,0,30,44,40,443,0,588,1031,525,0,0,1,1
6867,KURNOOL,MIDTHUR,CHOWTAKUR,197,8,539,744,87,1,137,225,224,2629,41,6871,9541,5543,0,0,6,6
6868,KURNOOL,MIDTHUR,DEVANUR,87,5,506,598,28,0,87,115,97,1011,0,1906,2917,1474,1,0,0,1
6869,KURNOOL,MIDTHUR,JALAKANUR,155,0,385,540,73,0,147,220,199,2941,0,4726,7667,3728,0,0,0,0
6870,KURNOOL,MIDTHUR,KADUMUR,352,1,775,1128,109,0,21,130,126,2410,0,327,2737,1586,0,0,0,0
6871,KURNOOL,MIDTHUR,KALAMANDALAPADU,3,0,13,16,0,0,0,0,0,0,0,0,0,0,0,0,0,0
6872,KURNOOL,MIDTHUR,MASAPETA,200,1,841,1042,107,1,413,521,499,5977,115,19068,25160,14628,18,1,34,53
6873,KURNOOL,MIDTHUR,MIDTHUR,476,3,1380,1859,123,0,179,302,300,5712,0,7937,13649,7406,19,0,22,41
6874,KURNOOL,MIDTHUR,NAGALOOTY,190,2,389,581,114,1,202,317,323,6115,30,7290,13435,8363,13,0,1,14
6875,KURNOOL,MIDTHUR,PAIPALEM,17,0,223,240,10,0,106,116,120,660,0,3726,4386,2928,1,0,4,5
6876,KURNOOL,MIDTHUR,ROLLAPADU,99,0,247,346,26,0,77,103,100,651,0,1837,2488,1438,1,0,0,1
6877,KURNOOL,MIDTHUR,SUNKESULA,246,0,286,532,83,0,80,163,163,1418,0,1829,3247,1785,0,0,0,0
6878,KURNOOL,MIDTHUR,TALAMUDIPI,321,4,744,1069,142,1,46,189,183,6921,77,848,7846,4487,18,0,0,18
6879,KURNOOL,MIDTHUR,THIMMAPURAM,96,2,242,340,62,0,125,187,173,3204,0,3972,7176,3650,7,0,0,7
6880,KURNOOL,MIDTHUR,VEEPANAGANDLA,303,9,461,773,93,1,57,151,141,4696,54,2827,7577,4070,9,0,4,13
6881,KURNOOL,NANDAVARAM,CHAMALAGUDURU,334,3,771,1108,191,0,235,426,409,10025,0,7073,17098,9948,25,0,4,29
6882,KURNOOL,NANDAVARAM,GURUJALA,172,4,472,648,139,3,359,501,478,3782,51,7840,11673,5948,1,0,0,1
6883,KURNOOL,NANDAVARAM,HALAHARVI,366,0,1490,1856,108,0,636,744,932,1621,0,18656,20277,10283,1,0,12,13
6884,KURNOOL,NANDAVARAM,IBRAHIMPURAM,160,1,681,842,140,1,507,648,825,5222,16,15090,20328,10679,2,0,1,3
6885,KURNOOL,NANDAVARAM,KANAKAVEEDU,235,1,1642,1878,111,0,571,682,744,3446,0,15352,18798,9977,0,0,1,1
6886,KURNOOL,NANDAVARAM,MACHAPURAM,241,0,400,641,197,0,142,339,330,6795,0,7922,14717,7304,1,0,13,14
6887,KURNOOL,NANDAVARAM,MITTASOMPURAM,91,0,364,455,39,0,123,162,193,864,0,2834,3698,1939,0,0,1,1
6888,KURNOOL,NANDAVARAM,MUGUTHI,197,6,1036,1239,1,0,59,60,61,20,0,1037,1057,541,0,0,0,0
6889,KURNOOL,NANDAVARAM,NADIKHAIRAVADI,73,0,513,586,19,0,219,238,223,365,0,4675,5040,2727,0,0,0,0
6890,KURNOOL,NANDAVARAM,NAGALADINNE,292,5,1905,2202,139,1,425,565,594,4131,38,9428,13597,7953,2,0,1,3
6891,KURNOOL,NANDAVARAM,NANDAVARAM,540,2,1942,2484,4,0,459,463,521,102,0,13921,14023,7293,0,0,15,15
6892,KURNOOL,NANDAVARAM,PEDDAKOTHILIKI,185,0,704,889,71,0,141,212,190,1728,0,1338,3066,1645,2,0,0,2
6893,KURNOOL,NANDAVARAM,PONAKALADINNE,80,0,395,475,45,0,252,297,275,2033,0,12724,14757,7852,0,0,10,10
6894,KURNOOL,NANDAVARAM,POOLACHINTA,175,1,284,460,126,0,184,310,311,5277,0,7863,13140,6851,5,0,9,14
6895,KURNOOL,NANDI KOTKUR,ALLUR,240,14,743,997,93,1,325,419,390,2406,14,14087,16507,11237,0,0,18,18
6896,KURNOOL,NANDI KOTKUR,BIJINAVEMULA (KOTHA),151,0,434,585,88,0,300,388,403,3797,0,11504,15301,9747,7,0,8,15
6897,KURNOOL,NANDI KOTKUR,BOLLAVARAM,281,2,451,734,50,0,43,93,84,1179,0,1050,2229,1137,1,0,2,3
6898,KURNOOL,NANDI KOTKUR,BRAHMANAKOTKUR,1198,7,2406,3611,53,0,96,149,136,541,0,797,1338,1066,0,0,0,0
6899,KURNOOL,NANDI KOTKUR,DAMAGATLA,332,0,456,788,67,0,91,158,169,2175,0,2283,4458,3380,3,0,2,5
6900,KURNOOL,NANDI KOTKUR,KOLLABAVAPURAM,3,125,152,280,1,62,86,149,143,70,3355,5937,9362,6254,0,5,20,25
6901,KURNOOL,NANDI KOTKUR,KONETAMMAPALLI,232,0,144,376,57,0,24,81,74,1583,0,324,1907,1174,2,0,0,2
6902,KURNOOL,NANDI KOTKUR,KONIDELA,668,2,1518,2188,82,0,48,130,129,3540,0,1227,4767,3074,5,0,0,5
6903,KURNOOL,NANDI KOTKUR,MALYALA,178,2,731,911,56,0,122,178,167,2393,0,2859,5252,2933,11,0,2,13
6904,KURNOOL,NANDI KOTKUR,NAGATOOR,413,1,507,921,102,0,136,238,246,2923,0,4390,7313,4515,1,0,3,4
6905,KURNOOL,NANDI KOTKUR,NANDIKOTKUR,1293,21,2178,3492,0,0,0,0,0,0,0,0,0,0,0,0,0,0
6906,KURNOOL,NANDI KOTKUR,SANTHANIKOTA,133,54,570,757,56,21,79,156,152,2175,343,952,3470,2088,5,0,1,6
6907,KURNOOL,NANDI KOTKUR,VADDAMANU,121,0,958,1079,73,0,190,263,252,2663,0,8302,10965,6868,2,0,8,10
6908,KURNOOL,NANDYAL,AYYALUR,176,0,582,758,117,0,14,131,141,2993,0,228,3221,2087,0,0,0,0
6909,KURNOOL,NANDYAL,BHEEMAVARAM,193,7,357,557,94,3,75,172,144,2093,95,1155,3343,2422,0,0,0,0
6910,KURNOOL,NANDYAL,BILLALAPURAM,145,0,329,474,76,0,116,192,186,2315,0,3410,5725,3676,0,0,0,0
6911,KURNOOL,NANDYAL,BRAHMANAPALLE,40,14,76,130,23,2,20,45,44,411,25,295,731,510,0,0,0,0
6912,KURNOOL,NANDYAL,CHABOLU,329,2,506,837,185,0,54,239,226,8484,0,2138,10622,8309,4,0,1,5
6913,KURNOOL,NANDYAL,CHAPIREVULA,521,1,795,1317,170,0,116,286,292,1992,0,1352,3344,1959,0,0,0,0
6914,KURNOOL,NANDYAL,GUNTHANALA,131,1,172,304,102,0,96,198,206,7172,0,5118,12290,7056,31,0,11,42
6915,KURNOOL,NANDYAL,KANALA,272,0,1052,1324,186,0,452,638,652,6605,0,16409,23014,13136,5,0,19,24
6916,KURNOOL,NANDYAL,KOTHAPALLI,249,95,468,812,0,1,0,1,1,0,20,0,20,10,0,0,0,0
6917,KURNOOL,NANDYAL,KOTTALA,223,3,572,798,105,0,16,121,114,3394,0,431,3825,2372,3,0,0,3
6918,KURNOOL,NANDYAL,MITNALA,167,1,280,448,115,0,112,227,225,7000,0,5574,12574,6822,15,0,3,18
6919,KURNOOL,NANDYAL,MUNAGALA,98,3,161,262,69,0,72,141,127,4370,0,5080,9450,6363,13,0,13,26
6920,KURNOOL,NANDYAL,PANDURANGAPURAM,133,4,444,581,52,0,68,120,113,1766,0,1804,3570,2257,3,0,1,4
6921,KURNOOL,NANDYAL,POLUR,421,1,549,971,125,0,91,216,219,2904,0,2607,5511,3668,0,0,0,0
6922,KURNOOL,NANDYAL,PONNAPURAM,322,19,473,814,0,0,0,0,0,0,0,0,0,0,0,0,0,0
6923,KURNOOL,NANDYAL,PULIMADDI,178,1,334,513,81,0,101,182,203,2578,0,3957,6535,5045,2,0,1,3
6924,KURNOOL,NANDYAL,PUSULUR,148,1,355,504,125,0,164,289,286,7236,0,5562,12798,7300,20,0,11,31
6925,KURNOOL,NANDYAL,RAYAMALPURAM,164,10,154,328,108,0,47,155,158,1927,0,1081,3008,2286,0,0,1,1
6926,KURNOOL,NANDYAL,RYOTHUNAGARAM,37,2,415,454,14,1,222,237,212,369,11,4711,5091,2890,0,0,2,2
6927,KURNOOL,NANDYAL,UDUMALPURAM,170,0,442,612,4,0,6,10,7,70,0,48,118,31,0,0,0,0
6928,KURNOOL,ORVAKAL,BODDUVANIPALLE,179,0,97,276,136,0,67,203,212,10686,0,4504,15190,8086,44,0,16,60
6929,KURNOOL,ORVAKAL,BRAHMANAPALLE,114,134,230,478,58,75,94,227,237,2638,3935,4978,11551,5900,4,5,12,21
6930,KURNOOL,ORVAKAL,GUTTAPADU,114,0,176,290,27,0,68,95,94,655,0,2338,2993,1805,1,0,5,6
6931,KURNOOL,ORVAKAL,HUSAINAPURAM,161,27,934,1122,28,4,241,273,284,1690,304,18580,20574,12306,8,1,66,75
6932,KURNOOL,ORVAKAL,KALVA,68,209,841,1118,25,58,113,196,206,1191,696,4513,6400,4030,1,0,6,7
6933,KURNOOL,ORVAKAL,KANNAMADAKALA,42,1,539,582,18,0,171,189,204,1430,0,5859,7289,3909,8,0,2,10
6934,KURNOOL,ORVAKAL,KETHAVARAM,67,3,330,400,27,1,89,117,112,1605,6,4777,6388,4929,3,0,4,7
6935,KURNOOL,ORVAKAL,KOMAROLU,79,0,608,687,39,0,105,144,136,2414,0,4573,6987,3987,5,0,5,10
6936,KURNOOL,ORVAKAL,LODDIPALLE,388,0,604,992,147,0,273,420,408,5685,0,10622,16307,10583,9,0,5,14
6937,KURNOOL,ORVAKAL,MEEDIVEMULA,86,1,440,527,48,1,152,201,199,2099,34,3640,5773,4068,3,0,1,4
6938,KURNOOL,ORVAKAL,N.KONTHALAPADU,89,0,176,265,61,0,93,154,161,3320,0,5455,8775,6333,15,0,15,30
6939,KURNOOL,ORVAKAL,NANNUR,517,4,1609,2130,60,0,185,245,249,1753,0,5058,6811,4808,1,0,3,4
6940,KURNOOL,ORVAKAL,ORVAKAL,219,14,560,793,107,4,237,348,355,3786,118,7023,10927,8290,3,0,3,6
6941,KURNOOL,ORVAKAL,PALAKOLANU,102,0,148,250,86,0,82,168,187,3069,0,3484,6553,4305,0,0,5,5
6942,KURNOOL,ORVAKAL,PURICHERLA,92,5,490,587,16,0,116,132,121,205,0,3039,3244,1902,0,0,1,1
6943,KURNOOL,ORVAKAL,SAKUNALA,174,0,548,722,85,0,280,365,364,2567,0,11546,14113,7007,2,0,22,24
6944,KURNOOL,ORVAKAL,SOMYAJULAPALLE,126,5,465,596,31,3,165,199,215,1098,202,7902,9202,5767,2,1,17,20
6945,KURNOOL,ORVAKAL,THIPPAYAPALLE,30,0,259,289,9,0,37,46,54,229,0,1043,1272,767,0,0,1,1
6946,KURNOOL,ORVAKAL,UPPALAPADU,324,0,431,755,159,0,129,288,282,2291,0,1608,3899,2043,0,0,0,0
6947,KURNOOL,ORVAKAL,UYYALAWADA,314,3,779,1096,104,2,246,352,351,3482,34,11018,14534,8901,10,0,26,36
6948,KURNOOL,OWK,ANNAVARAM,103,0,289,392,69,0,158,227,218,1555,0,4069,5624,3048,0,0,0,0
6949,KURNOOL,OWK,CHANUGONDLA,173,0,329,502,84,0,39,123,123,3100,0,822,3922,2758,7,0,2,9
6950,KURNOOL,OWK,CHENNAMPALLE,243,1,335,579,144,0,61,205,207,5340,0,861,6201,4763,3,0,0,3
6951,KURNOOL,OWK,CHERLOPALLE,115,21,173,309,0,0,0,0,0,0,0,0,0,0,0,0,0,0
6952,KURNOOL,OWK,GUNDLA SINGAVARAM,233,7,512,752,85,3,116,204,202,1411,14,1278,2703,1731,0,0,0,0
6953,KURNOOL,OWK,JUNUTHALA,73,31,358,462,42,4,150,196,212,307,16,1129,1452,1157,0,0,0,0
6954,KURNOOL,OWK,KONDAMANAYUNIPALLI,3,457,225,685,0,213,115,328,355,0,4083,2871,6954,5069,0,0,0,0
6955,KURNOOL,OWK,KUNUKUNTLA,117,304,267,688,62,174,124,360,353,453,2868,1580,4901,3334,0,0,0,0
6956,KURNOOL,OWK,MANGAMPETA,132,151,268,551,95,116,182,393,379,6651,8311,12021,26983,15735,22,27,33,82
6957,KURNOOL,OWK,METTUPALLE,265,3,347,615,143,1,120,264,262,7959,19,4667,12645,7918,19,0,5,24
6958,KURNOOL,OWK,OWK,422,47,2120,2589,190,2,47,239,244,7414,12,880,8306,6015,9,0,0,9
6959,KURNOOL,OWK,RAMAPURAM,103,2,190,295,0,0,0,0,0,0,0,0,0,0,0,0,0,0
6960,KURNOOL,OWK,RAMAVARAM,98,67,319,484,39,0,164,203,201,1573,0,2211,3784,2235,7,0,0,7
6961,KURNOOL,OWK,SANGAPATNAM,85,4,441,530,9,0,96,105,103,14,0,3032,3046,2751,0,0,2,2
6962,KURNOOL,OWK,SINGANAPALLE,195,6,468,669,38,0,41,79,78,437,0,375,812,650,0,0,0,0
6963,KURNOOL,OWK,SIVAVARAM,165,0,206,371,111,0,20,131,124,5294,0,112,5406,3430,9,0,0,9
6964,KURNOOL,OWK,SUNKESULA,109,4,409,522,35,0,23,58,61,328,0,213,541,439,0,0,0,0
6965,KURNOOL,OWK,UPPALAPADU,103,10,428,541,44,4,123,171,179,152,15,772,939,771,0,0,0,0
6966,KURNOOL,OWK,VEMULAPADU,172,0,305,477,97,0,147,244,238,3528,0,6692,10220,6076,2,0,5,7
6967,KURNOOL,PAGIDYALA,KOTHA MUCHUMARRI,307,2,355,664,156,0,37,193,183,5670,0,1050,6720,3891,3,0,0,3
6968,KURNOOL,PAGIDYALA,LAXMAPURAM,674,11,1886,2571,328,0,278,606,593,12401,0,10115,22516,11838,7,0,11,18
6969,KURNOOL,PAGIDYALA,M.GANAPURAM,106,11,532,649,62,4,273,339,326,1705,63,8386,10154,5137,0,0,10,10
6970,KURNOOL,PAGIDYALA,MUCHUMARRI,280,1,916,1197,93,1,198,292,262,3315,50,8217,11582,6571,2,0,10,12
6971,KURNOOL,PAGIDYALA,NEHRU NAGAR,746,24,1954,2724,137,4,327,468,470,3747,64,7268,11079,5803,4,0,2,6
6972,KURNOOL,PAGIDYALA,PAGIDIYALA,1208,31,1709,2948,596,7,565,1168,1192,16323,210,13575,30108,15042,3,0,9,12
6973,KURNOOL,PAGIDYALA,SANKIRENI PALLI,155,0,556,711,39,0,69,108,81,1489,0,2257,3746,1766,0,0,2,2
6974,KURNOOL,PAMULAPADU,BHANUMUKKALA,221,44,514,779,84,6,84,174,157,3470,104,1941,5515,3194,6,0,0,6
6975,KURNOOL,PAMULAPADU,CHELIMILLA,271,13,401,685,111,0,147,258,254,4452,0,5465,9917,4712,15,0,9,24
6976,KURNOOL,PAMULAPADU,ERRAGUDUR,239,189,637,1065,75,25,225,325,302,1712,504,5350,7566,5041,0,0,0,0
6977,KURNOOL,PAMULAPADU,ISKALA,470,0,686,1156,28,0,63,91,85,516,0,1070,1586,752,0,0,0,0
6978,KURNOOL,PAMULAPADU,JUTUR,650,5,1724,2379,96,1,142,239,218,1366,20,3166,4552,2248,0,0,2,2
6979,KURNOOL,PAMULAPADU,KOTHABANAKACHERLA,143,8,485,636,58,0,143,201,195,1755,0,5010,6765,3972,0,0,3,3
6980,KURNOOL,PAMULAPADU,LINGALA,99,2,461,562,59,1,167,227,208,2585,20,7678,10283,5422,4,0,14,18
6981,KURNOOL,PAMULAPADU,MADDUR,255,51,1049,1355,83,32,255,370,333,1673,1227,8606,11506,6313,0,1,8,9
6982,KURNOOL,PAMULAPADU,MITTAKANDALA,418,40,1121,1579,50,5,150,205,199,1371,480,4692,6543,3371,2,1,4,7
6983,KURNOOL,PAMULAPADU,PAMULAPADU,1026,27,1134,2187,142,0,83,225,229,4473,0,2432,6905,3653,2,0,0,2
6984,KURNOOL,PAMULAPADU,RUDRAVARAM,240,1,686,927,88,0,123,211,207,5215,0,2835,8050,4602,11,0,0,11
6985,KURNOOL,PAMULAPADU,VANALA,201,64,605,870,69,12,120,201,202,2678,432,2863,5973,3363,3,0,0,3
6986,KURNOOL,PAMULAPADU,VEMPENTA,1148,236,1051,2435,161,7,246,414,386,3509,94,6833,10436,5665,1,0,6,7
6987,KURNOOL,PANYAM,ALAMUR,193,0,410,603,89,0,186,275,260,3293,0,5791,9084,5879,7,0,1,8
6988,KURNOOL,PANYAM,ANUPUR,203,0,409,612,62,0,88,150,133,3139,0,4671,7810,4133,10,0,15,25
6989,KURNOOL,PANYAM,BALAPANUR,316,5,1253,1574,90,0,234,324,303,3994,0,12761,16755,10041,11,0,42,53
6990,KURNOOL,PANYAM,BHUPANAPADU,170,0,430,600,96,0,176,272,254,6692,0,8306,14998,8664,25,0,9,34
6991,KURNOOL,PANYAM,GAGGATUR,49,1,285,335,14,0,112,126,120,592,0,6437,7029,4669,0,0,14,14
6992,KURNOOL,PANYAM,GONAVARAM,213,0,230,443,167,0,109,276,282,10042,0,3843,13885,7942,26,0,4,30
6993,KURNOOL,PANYAM,GORUKALLU,58,99,404,561,24,0,95,119,115,1929,0,5028,6957,5549,8,0,12,20
6994,KURNOOL,PANYAM,KANDIKAYAPALLI,23,13,834,870,9,1,345,355,298,588,35,24702,25325,15905,2,0,76,78
6995,KURNOOL,PANYAM,KONDAJUTUR,176,7,260,443,147,3,186,336,382,8676,203,9871,18750,10437,19,0,14,33
6996,KURNOOL,PANYAM,KONIDEDU,219,0,510,729,49,0,161,210,218,1456,0,4981,6437,4299,2,0,3,5
6997,KURNOOL,PANYAM,KOTHURU,31,0,197,228,20,0,70,90,82,1455,0,3026,4481,2548,5,0,7,12
6998,KURNOOL,PANYAM,KOWLUR,192,0,226,418,118,0,62,180,175,8194,0,3856,12050,9866,32,0,13,45
6999,KURNOOL,PANYAM,MADDUR,322,0,643,965,93,0,72,165,167,1959,0,2116,4075,2475,0,0,4,4
7000,KURNOOL,PANYAM,NERAWADA,126,0,213,339,67,0,15,82,86,3222,0,361,3583,2745,4,0,0,4
7001,KURNOOL,PANYAM,PANYAM,242,437,829,1508,106,27,212,345,338,3835,584,12706,17125,11762,1,1,38,40
7002,KURNOOL,PANYAM,PINNAPURAM,15,1,526,542,7,0,181,188,207,266,0,7775,8041,5542,0,0,13,13
7003,KURNOOL,PANYAM,THAMMARAJUPALLE,138,2,567,707,68,0,237,305,296,5441,0,14729,20170,13407,29,0,51,80
7004,KURNOOL,PANYAM,THOGARCHEDU,174,0,384,558,62,0,29,91,75,2433,0,1015,3448,1789,3,0,0,3
7005,KURNOOL,PATTIKANDA,CHAKKARALLA,11,109,476,596,1,73,202,276,346,5,2041,6234,8280,4020,0,1,8,9
7006,KURNOOL,PATTIKANDA,CHANDOLI,54,195,499,748,40,29,302,371,382,2365,603,13172,16140,8017,7,0,29,36
7007,KURNOOL,PATTIKANDA,CHINNAHULTHI,111,8,641,760,58,0,256,314,297,4314,0,10365,14679,7251,16,0,10,26
7008,KURNOOL,PATTIKANDA,DEVANABANDA,174,2,563,739,71,0,198,269,253,3903,0,9424,13327,6831,8,0,19,27
7009,KURNOOL,PATTIKANDA,DUDEKONDA,186,103,858,1147,5,61,65,131,150,40,3538,1195,4773,2565,0,4,0,4
7010,KURNOOL,PATTIKANDA,HOSUR,402,6,1684,2092,113,1,424,538,495,4278,11,10839,15128,6979,9,0,3,12
7011,KURNOOL,PATTIKANDA,JUTUR,72,0,474,546,28,0,149,177,203,772,0,4841,5613,2622,0,0,10,10
7012,KURNOOL,PATTIKANDA,KOTHIRALLA,66,1,450,517,34,0,296,330,322,1557,0,15323,16880,8102,2,0,15,17
7013,KURNOOL,PATTIKANDA,MANDAGIRI,104,5,344,453,73,0,253,326,325,2756,0,15955,18711,9924,5,0,61,66
7014,KURNOOL,PATTIKANDA,NALAKADODDI,163,1,985,1149,21,0,287,308,284,480,0,10647,11127,5083,1,0,20,21
7015,KURNOOL,PATTIKANDA,PANDIKONA,129,1,681,811,13,0,140,153,144,234,0,4470,4704,2292,0,0,6,6
7016,KURNOOL,PATTIKANDA,PATTIKONDA,555,254,2262,3071,111,121,384,616,600,3459,5352,14369,23180,15704,11,11,12,34
7017,KURNOOL,PATTIKANDA,PEDDA HULTHI,138,1,326,465,83,0,216,299,289,3677,0,11088,14765,7384,13,0,29,42
7018,KURNOOL,PATTIKANDA,PULIKONDA,76,0,726,802,18,0,109,127,122,506,0,3747,4253,2099,0,0,8,8
7019,KURNOOL,PATTIKANDA,PUTCHAKAYALAMADA,77,0,459,536,35,0,195,230,196,555,0,4860,5415,2523,0,0,1,1
7020,KURNOOL,PEAPALLY,BAVIPALLI,4,0,384,388,0,0,127,127,115,0,0,1186,1186,863,0,0,0,0
7021,KURNOOL,PEAPALLY,BOINCHERUVUPALLI,51,60,353,464,3,45,67,115,121,6,469,429,904,643,0,0,0,0
7022,KURNOOL,PEAPALLY,BURUGULA,122,177,346,645,25,78,29,132,137,477,712,851,2040,1079,0,0,0,0
7023,KURNOOL,PEAPALLY,CHANDRAPALLE,87,0,371,458,13,0,100,113,111,232,0,3291,3523,1677,0,0,3,3
7024,KURNOOL,PEAPALLY,CHINNAPODILLA,55,0,261,316,7,0,72,79,70,138,0,1945,2083,1093,0,0,0,0
7025,KURNOOL,PEAPALLY,GUDIPADU,171,1,866,1038,72,1,361,434,385,1613,74,15329,17016,8162,1,0,25,26
7026,KURNOOL,PEAPALLY,HUSSAINAPURAM,331,0,699,1030,21,0,46,67,54,249,0,379,628,347,0,0,0,0
7027,KURNOOL,PEAPALLY,JAKKASANIKUNTLA,415,85,2009,2509,74,0,55,129,71,1733,0,457,2190,1139,0,0,0,0
7028,KURNOOL,PEAPALLY,JALADURGAM,257,23,1713,1993,102,1,382,485,451,3906,12,12275,16193,8798,7,0,5,12
7029,KURNOOL,PEAPALLY,KALACHATLA,437,65,736,1238,210,42,418,670,695,11658,1366,15272,28296,13989,36,0,6,42
7030,KURNOOL,PEAPALLY,KOMMEMARRI,59,2,507,568,45,0,331,376,359,2465,0,20184,22649,11262,10,0,65,75
7031,KURNOOL,PEAPALLY,KOWLAPALLE,2,0,321,323,0,0,152,152,137,0,0,2610,2610,1317,0,0,1,1
7032,KURNOOL,PEAPALLY,MADHAVARAM,236,5,709,950,90,0,90,180,166,2719,0,2984,5703,3229,5,0,5,10
7033,KURNOOL,PEAPALLY,METTUPALLE,54,18,339,411,1,3,22,26,15,12,5,422,439,160,0,0,0,0
7034,KURNOOL,PEAPALLY,MUNIMADUGU,75,289,500,864,46,143,266,455,468,3170,8667,16003,27840,13927,14,19,30,63
7035,KURNOOL,PEAPALLY,N.RANGAPURAM,117,0,389,506,15,0,54,69,77,99,0,865,964,453,0,0,0,0
7036,KURNOOL,PEAPALLY,NEREDUCHERLA,40,19,509,568,0,0,93,93,76,0,0,2612,2612,1409,0,0,0,0
7037,KURNOOL,PEAPALLY,P. RANGAREDDIPALLI,54,2,565,621,35,2,444,481,492,1198,74,14086,15358,7462,0,0,0,0
7038,KURNOOL,PEAPALLY,PEAPALLY,320,33,2237,2590,69,0,289,358,341,1105,0,7971,9076,5447,0,0,3,3
7039,KURNOOL,PEAPALLY,PEDDAPAYA,70,0,78,148,45,0,44,89,92,2461,0,1880,4341,2260,3,0,0,3
7040,KURNOOL,PEAPALLY,PEDDAPODILLA,117,1,550,668,32,0,81,113,104,431,0,449,880,449,0,0,0,0
7041,KURNOOL,PEAPALLY,POTHIDODDI,96,87,1260,1443,21,1,98,120,106,183,9,4751,4943,2347,0,0,8,8
7042,KURNOOL,PEAPALLY,RACHERLA,118,2,551,671,94,0,144,238,234,3472,0,2420,5892,3179,0,0,0,0
7043,KURNOOL,PEAPALLY,UTAKONDA,189,5,452,646,96,2,46,144,183,3825,25,1648,5498,2863,4,0,3,7
7044,KURNOOL,PEAPALLY,VENGALAMPALLE,94,3,534,631,41,0,115,156,146,1581,0,4291,5872,2821,3,0,15,18
7045,KURNOOL,PEAPALLY,YENUGUMARRI,53,2,255,310,26,1,113,140,126,1706,18,7630,9354,4717,5,0,28,33
7046,KURNOOL,PEDDA KADUBUR,BASALADODDI,88,0,1219,1307,0,0,39,39,34,0,0,593,593,258,0,0,0,0
7047,KURNOOL,PEDDA KADUBUR,CHINNATUMBALAM,344,2,2206,2552,135,0,704,839,859,5978,0,33003,38981,21067,5,0,18,23
7048,KURNOOL,PEDDA KADUBUR,DODDIMEKALA,31,3,983,1017,15,0,281,296,326,261,0,4765,5026,2338,0,0,2,2
7049,KURNOOL,PEDDA KADUBUR,GAVIGATTU,59,0,517,576,6,0,181,187,193,285,0,9603,9888,4853,1,0,26,27
7050,KURNOOL,PEDDA KADUBUR,H.MURAVANI,282,2,1195,1479,82,0,180,262,325,3233,0,6719,9952,5015,2,0,7,9
7051,KURNOOL,PEDDA KADUBUR,HANUMAPURAM,2,0,538,540,0,0,300,300,347,0,0,11309,11309,5903,0,0,6,6
7052,KURNOOL,PEDDA KADUBUR,JALVADI,92,0,625,717,66,0,314,380,434,4432,0,11979,16411,8134,17,0,13,30
7053,KURNOOL,PEDDA KADUBUR,KALLUKUNTA,119,1,945,1065,17,0,155,172,147,944,0,7177,8121,3457,2,0,14,16
7054,KURNOOL,PEDDA KADUBUR,KAMBADAHAL,105,0,578,683,5,0,370,375,392,194,0,14517,14711,7135,0,0,15,15
7055,KURNOOL,PEDDA KADUBUR,KAMBALADINNE,169,0,903,1072,143,0,570,713,760,11308,0,18811,30119,14518,48,0,9,57
7056,KURNOOL,PEDDA KADUBUR,MYAKADONA,112,0,460,572,87,0,193,280,288,5733,0,12555,18288,9674,12,0,26,38
7057,KURNOOL,PEDDA KADUBUR,NOWLEKAL,29,4,1544,1577,0,0,406,406,514,0,0,13797,13797,6616,0,0,5,5
7058,KURNOOL,PEDDA KADUBUR,PEDDA KADUBUR,839,2,1233,2074,372,0,446,818,892,22183,0,23810,45993,22083,66,0,65,131
7059,KURNOOL,PEDDA KADUBUR,PEEKALABETTA,48,1,661,710,7,1,256,264,237,269,4,15255,15528,8403,0,0,57,57
7060,KURNOOL,PEDDA KADUBUR,TARAPURAM,251,0,745,996,42,0,311,353,389,1920,0,18225,20145,10281,7,0,63,70
7061,KURNOOL,RUDRAVARAM,ALAMUR,192,75,791,1058,36,10,108,154,144,772,247,3579,4598,2623,0,0,3,3
7062,KURNOOL,RUDRAVARAM,BEERAVOLU,91,1,115,207,57,0,71,128,128,2802,0,2427,5229,3302,2,0,2,4
7063,KURNOOL,RUDRAVARAM,CHANDALUR,192,2,442,636,82,2,126,210,203,3312,93,2354,5759,3026,1,0,1,2
7064,KURNOOL,RUDRAVARAM,CHILAKALOOR,49,0,232,281,25,0,56,81,63,1463,0,1533,2996,1730,7,0,1,8
7065,KURNOOL,RUDRAVARAM,CHINNAKAMBALOOR,152,0,528,680,83,0,170,253,246,1681,0,6047,7728,4568,0,0,4,4
7066,KURNOOL,RUDRAVARAM,CHITRENIPALLI.,284,232,350,866,44,61,8,113,134,1340,7845,1133,10318,4799,6,25,3,34
7067,KURNOOL,RUDRAVARAM,D.KOTTALA.,6,1,201,208,2,1,107,110,99,52,54,2387,2493,1513,0,0,1,1
7068,KURNOOL,RUDRAVARAM,ERRAGUDIDINNE,193,2,347,542,108,0,178,286,261,2613,0,3692,6305,3563,0,0,0,0
7069,KURNOOL,RUDRAVARAM,KONDAMAYAPALLE,169,2,269,440,56,0,78,134,134,1891,0,2553,4444,2972,1,0,6,7
7070,KURNOOL,RUDRAVARAM,KOTAKONDA,162,68,335,565,74,5,117,196,174,3074,141,5308,8523,4933,5,0,6,11
7071,KURNOOL,RUDRAVARAM,MANDALOOR,262,0,525,787,22,0,143,165,128,157,0,3077,3234,1869,0,0,2,2
7072,KURNOOL,RUDRAVARAM,MUTHALOOR,155,0,619,774,61,0,137,198,184,2297,0,2129,4426,3041,2,0,1,3
7073,KURNOOL,RUDRAVARAM,NARASAPURAM,308,2,357,667,93,1,59,153,148,3638,46,2077,5761,3547,9,0,4,13
7074,KURNOOL,RUDRAVARAM,PEDDA KAMBALOOR,346,7,317,670,126,0,6,132,124,3932,0,86,4018,2417,6,0,0,6
7075,KURNOOL,RUDRAVARAM,PERUR,336,4,288,628,175,2,124,301,273,4618,89,4311,9018,4558,2,0,1,3
7076,KURNOOL,RUDRAVARAM,R.NAGULAVARAM,129,0,188,317,42,0,5,47,43,363,0,88,451,248,0,0,0,0
7077,KURNOOL,RUDRAVARAM,RUDRAVARAM,684,10,884,1578,210,0,140,350,337,10429,0,4498,14927,9627,20,0,1,21
7078,KURNOOL,RUDRAVARAM,SREERANGAPURAM,71,14,363,448,41,8,164,213,219,925,105,5007,6037,3975,0,0,5,5
7079,KURNOOL,RUDRAVARAM,T.LINGAMDINNE,132,2,256,390,71,0,115,186,188,1574,0,2707,4281,2510,0,0,5,5
7080,KURNOOL,RUDRAVARAM,YELLAVATHULA,178,0,314,492,31,0,73,104,100,345,0,1673,2018,1177,0,0,1,1
7081,KURNOOL,SANJAMALA,AKKAMPALLI,30,1,284,315,24,1,137,162,163,1201,45,6204,7450,5598,1,0,4,5
7082,KURNOOL,SANJAMALA,AKUMALLA,264,40,568,872,138,5,102,245,248,7412,273,2448,10133,5496,16,0,3,19
7083,KURNOOL,SANJAMALA,ALVAKONDA,408,3,933,1344,200,2,305,507,506,8940,39,8658,17637,10759,14,0,17,31
7084,KURNOOL,SANJAMALA,EGGONI,92,0,213,305,73,0,127,200,178,4298,0,6480,10778,6123,11,0,17,28
7085,KURNOOL,SANJAMALA,GIDDALUR,154,44,674,872,10,2,267,279,286,118,37,5244,5399,3988,0,0,0,0
7086,KURNOOL,SANJAMALA,KAMALAPURI,126,1,165,292,86,0,39,125,115,5609,0,1330,6939,4449,14,0,3,17
7087,KURNOOL,SANJAMALA,KANALA,267,0,771,1038,112,0,108,220,211,4807,0,2855,7662,5361,9,0,2,11
7088,KURNOOL,SANJAMALA,MUDIGEDU,56,0,248,304,39,0,109,148,148,1966,0,6207,8173,5300,2,0,5,7
7089,KURNOOL,SANJAMALA,MUKKAMALLA,144,0,407,551,118,0,230,348,338,4906,0,5779,10685,6105,2,0,1,3
7090,KURNOOL,SANJAMALA,NATLA KOTHUR,9,0,80,89,4,0,26,30,33,143,0,958,1101,656,0,0,2,2
7091,KURNOOL,SANJAMALA,NOSSAM,333,10,563,906,11,0,21,32,24,220,0,215,435,215,0,0,0,0
7092,KURNOOL,SANJAMALA,PERUSOMULA,364,25,1218,1607,116,7,458,581,575,3256,334,11393,14983,11919,3,1,3,7
7093,KURNOOL,SANJAMALA,R.LINGAM DINNE,120,8,311,439,42,3,92,137,124,1500,73,3327,4900,3169,1,0,1,2
7094,KURNOOL,SANJAMALA,SANJAMALA,230,7,817,1054,97,1,169,267,250,4628,20,8917,13565,9397,5,0,16,21
7095,KURNOOL,SANJAMALA,VASANTHAPURAM,138,0,369,507,54,0,129,183,181,1378,0,6421,7799,4346,0,0,1,1
7096,KURNOOL,SIRVEL,BOYALAKUNTLA,175,7,558,740,135,0,250,385,364,5615,0,8394,14009,8071,2,0,1,3
7097,KURNOOL,SIRVEL,CHENNUR,316,2,520,838,146,0,134,280,264,5402,0,3913,9315,4053,1,0,3,4
7098,KURNOOL,SIRVEL,GANGAVARAM,94,1,429,524,51,0,205,256,257,1311,0,4108,5419,3083,0,0,1,1
7099,KURNOOL,SIRVEL,GOVINDPALLE,777,37,636,1450,195,2,97,294,287,9748,96,5212,15056,9004,21,0,3,24
7100,KURNOOL,SIRVEL,GUMPARAMANDINNE,226,1,393,620,189,1,294,484,534,6370,45,14047,20462,10455,0,0,25,25
7101,KURNOOL,SIRVEL,GUNDAMPADU,228,0,206,434,98,0,76,174,163,2153,0,2951,5104,3207,0,0,7,7
7102,KURNOOL,SIRVEL,JEENEPALLE,97,0,266,363,72,0,144,216,202,4965,0,9643,14608,8008,20,0,32,52
7103,KURNOOL,SIRVEL,KAMINENIPALLE,202,11,134,347,143,9,87,239,269,8425,502,5819,14746,8268,16,1,27,44
7104,KURNOOL,SIRVEL,KOTAPADU,432,4,503,939,202,1,169,372,369,10224,91,9129,19444,10096,12,0,9,21
7105,KURNOOL,SIRVEL,MAHADEVAPURAM,217,98,498,813,48,0,92,140,137,2007,0,1932,3939,2518,4,0,0,4
7106,KURNOOL,SIRVEL,SIRVEL,442,10,1522,1974,151,3,525,679,683,6194,60,19430,25684,14441,16,0,27,43
7107,KURNOOL,SIRVEL,VANIKEMDINNE,98,0,170,268,75,0,106,181,170,3174,0,5336,8510,4962,0,0,4,4
7108,KURNOOL,SIRVEL,YERRAGUNTLA,295,7,792,1094,76,0,202,278,247,1992,0,5858,7850,3960,0,0,1,1
7109,KURNOOL,TUGGALI,BONDIMADUGULA,126,5,647,778,68,2,231,301,292,3406,21,8911,12338,5683,6,0,15,21
7110,KURNOOL,TUGGALI,CHENNAMPALLE,123,179,617,919,95,92,431,618,684,3760,2059,16509,22328,11104,4,1,13,18
7111,KURNOOL,TUGGALI,EDDULADODDI,112,7,639,758,68,0,134,202,201,2142,0,3888,6030,2743,2,0,5,7
7112,KURNOOL,TUGGALI,GIRIGETLA,8,0,517,525,3,0,331,334,328,24,0,9750,9774,5128,0,0,3,3
7113,KURNOOL,TUGGALI,GOOTY ERRAGUDI,144,522,523,1189,12,11,116,139,142,115,186,3982,4283,2777,0,0,1,1
7114,KURNOOL,TUGGALI,JONNAGIRI,264,45,1051,1360,60,0,68,128,141,1017,0,1260,2277,1111,0,0,0,0
7115,KURNOOL,TUGGALI,KANDAMAKUNTLA,89,265,458,812,51,119,221,391,414,1973,6181,9000,17154,8490,3,9,15,27
7116,KURNOOL,TUGGALI,MARELLA,107,0,529,636,29,0,259,288,281,509,0,9603,10112,5401,0,0,5,5
7117,KURNOOL,TUGGALI,MUKKELLA,173,2,549,724,63,0,244,307,273,1120,0,4844,5964,2626,0,0,1,1
7118,KURNOOL,TUGGALI,NUNUSURALLA,30,3,410,443,3,2,106,111,110,80,15,2264,2359,1172,0,0,0,0
7119,KURNOOL,TUGGALI,PAGIDIROY,219,10,1053,1282,76,4,222,302,301,2948,167,7857,10972,5768,4,0,9,13
7120,KURNOOL,TUGGALI,PENDEKALLU,193,0,454,647,9,0,9,18,12,136,0,124,260,107,0,0,0,0
7121,KURNOOL,TUGGALI,RAMAPURAM,24,0,421,445,16,0,360,376,355,883,0,19575,20458,10186,0,0,29,29
7122,KURNOOL,TUGGALI,RAMKONDA,163,4,381,548,19,0,120,139,123,408,0,2983,3391,1647,0,0,0,0
7123,KURNOOL,TUGGALI,RAMPALLI,195,1,722,918,165,0,568,733,812,9751,0,26273,36024,18410,18,0,17,35
7124,KURNOOL,TUGGALI,RATANA,171,0,875,1046,34,0,198,232,220,1169,0,4435,5604,2735,0,0,3,3
7125,KURNOOL,TUGGALI,SABHASHPURAM,84,83,958,1125,60,49,627,736,761,2215,2199,22152,26566,12573,3,1,15,19
7126,KURNOOL,TUGGALI,TUGGALI,243,22,1351,1616,70,6,489,565,532,2052,122,19855,22029,10855,2,0,44,46
7127,KURNOOL,TUGGALI,UPPARLAPALLI,108,296,268,672,37,89,157,283,288,1058,2217,8751,12026,6758,1,2,20,23
7128,KURNOOL,UYYALAWADA,ALLUR,396,0,569,965,95,0,160,255,254,998,0,3957,4955,3035,0,0,0,0
7129,KURNOOL,UYYALAWADA,BODEMMANUR,213,0,516,729,84,0,75,159,165,3728,0,3153,6881,4538,6,0,2,8
7130,KURNOOL,UYYALAWADA,GOVINDAPALLE,20,1,95,116,11,0,40,51,49,264,0,1390,1654,1158,0,0,0,0
7131,KURNOOL,UYYALAWADA,HARIVARAM,333,0,589,922,155,0,267,422,428,2867,0,5452,8319,4440,0,0,1,1
7132,KURNOOL,UYYALAWADA,INJEDU,74,0,314,388,27,0,99,126,120,436,0,2078,2514,1493,0,0,1,1
7133,KURNOOL,UYYALAWADA,KAKARAWADA,155,7,252,414,21,0,43,64,54,631,0,896,1527,975,0,0,2,2
7134,KURNOOL,UYYALAWADA,KONDUPALLE,108,0,397,505,71,0,5,76,75,1212,0,79,1291,763,0,0,0,0
7135,KURNOOL,UYYALAWADA,MAYALUR,130,0,338,468,38,0,8,46,39,475,0,110,585,338,0,0,0,0
7136,KURNOOL,UYYALAWADA,NARSEPALLE,88,0,195,283,61,0,122,183,155,2227,0,2673,4900,2516,0,0,2,2
7137,KURNOOL,UYYALAWADA,PEDDA EMMANUR,177,0,429,606,58,0,143,201,181,1014,0,5625,6639,3579,0,0,6,6
7138,KURNOOL,UYYALAWADA,R. JAMBULADINNE,77,0,323,400,53,0,61,114,106,1523,0,1684,3207,1833,2,0,0,2
7139,KURNOOL,UYYALAWADA,R.PAPAMPALLE,100,0,311,411,78,0,176,254,245,3801,0,9653,13454,7462,1,0,23,24
7140,KURNOOL,UYYALAWADA,RUPANAGUDI,152,1,203,356,69,0,50,119,107,1921,0,1745,3666,2242,0,0,0,0
7141,KURNOOL,UYYALAWADA,SARVAIPALLE,156,0,202,358,85,0,84,169,167,4229,0,2339,6568,3584,9,0,0,9
7142,KURNOOL,UYYALAWADA,SUDDAMALLA,129,0,331,460,45,0,102,147,132,1421,0,3446,4867,2753,0,0,0,0
7143,KURNOOL,UYYALAWADA,THUDUMULADINNE,94,0,215,309,60,0,115,175,188,1721,0,3205,4926,3104,0,0,0,0
7144,KURNOOL,UYYALAWADA,UYYALAWADA,283,1,779,1063,66,0,111,177,169,2775,0,3802,6577,4329,6,0,0,6
7145,KURNOOL,VELDURTHI,ALLUGUNDU,145,1,372,518,7,0,15,22,18,68,0,150,218,121,0,0,0,0
7146,KURNOOL,VELDURTHI,BHOGOLU,74,1,445,520,0,0,0,0,0,0,0,0,0,0,0,0,0,0
7147,KURNOOL,VELDURTHI,Bingidoddi,60,0,180,240,0,0,0,0,0,0,0,0,0,0,0,0,0,0
7148,KURNOOL,VELDURTHI,Bommireddipalli,145,1,238,384,0,0,0,0,0,0,0,0,0,0,0,0,0,0
7149,KURNOOL,VELDURTHI,BUKKAPURAM,97,1,392,490,70,1,309,380,388,725,3,6047,6775,3610,0,0,0,0
7150,KURNOOL,VELDURTHI,CHERUKULAPADU,179,3,890,1072,108,0,319,427,404,3795,0,8296,12091,5934,0,0,0,0
7151,KURNOOL,VELDURTHI,GOVARDHANAGIRI,546,9,917,1472,203,2,178,383,352,2347,9,1329,3685,1940,0,0,0,0
7152,KURNOOL,VELDURTHI,KALUGOTLA,481,4,1560,2045,1,0,248,249,220,6,0,4476,4482,2209,0,0,0,0
7153,KURNOOL,VELDURTHI,LAXMINGARAM,162,135,1330,1627,6,35,63,104,94,64,444,963,1471,744,0,0,0,0
7154,KURNOOL,VELDURTHI,MADAR PURAM,0,0,135,135,0,0,49,49,48,0,0,1477,1477,1265,0,0,0,0
7155,KURNOOL,VELDURTHI,MALLEPALLE,19,0,378,397,11,0,142,153,144,231,0,4416,4647,3482,0,0,4,4
7156,KURNOOL,VELDURTHI,NARASAPURAM,89,11,292,392,46,2,166,214,182,1168,41,3997,5206,2826,3,0,0,3
7157,KURNOOL,VELDURTHI,NARLAPURAM,158,1,474,633,6,0,56,62,56,120,0,777,897,420,0,0,0,0
7158,KURNOOL,VELDURTHI,PULLAGUMMI,136,1,780,917,12,0,241,253,243,188,0,4182,4370,2803,0,0,1,1
7159,KURNOOL,VELDURTHI,RAMALLAKOTA,154,8,1047,1209,27,0,172,199,194,517,0,3794,4311,2134,0,0,0,0
7160,KURNOOL,VELDURTHI,RATNAPALLI,186,2,561,749,51,0,247,298,247,455,0,4160,4615,2403,0,0,0,0
7161,KURNOOL,VELDURTHI,SARPARAJAPURAM,133,0,241,374,107,0,195,302,265,3496,0,5787,9283,4592,0,0,0,0
7162,KURNOOL,VELDURTHI,SHO.BOYANAPALLE,162,0,277,439,29,0,86,115,94,573,0,2560,3133,1611,0,0,0,0
7163,KURNOOL,VELDURTHI,SHO.PEREMULA,55,1,88,144,28,0,54,82,88,1174,0,1729,2903,1467,1,0,1,2
7164,KURNOOL,VELDURTHI,SRIRANGAPURAM,16,5,589,610,0,1,143,144,134,0,8,2241,2249,1073,0,0,0,0
7165,KURNOOL,VELDURTHI,SUDEPALLE,339,1,977,1317,187,1,318,506,445,3926,20,7635,11581,6091,4,0,2,6
7166,KURNOOL,VELDURTHI,VELDURTHI,1011,36,1448,2495,179,1,180,360,341,3823,20,5012,8855,6325,3,0,5,8
7167,KURNOOL,VELGODU,ABDULLAPURAM,309,2,308,619,243,1,155,399,432,9994,22,4333,14349,8877,12,0,1,13
7168,KURNOOL,VELGODU,BOYAREVULA,177,18,561,756,109,8,295,412,391,1769,151,8566,10486,5801,0,0,3,3
7169,KURNOOL,VELGODU,GUNTHAKANDALA,227,110,477,814,107,54,274,435,424,2770,627,5795,9192,5226,4,0,4,8
7170,KURNOOL,VELGODU,MADHAVARAM.,50,0,351,401,32,0,198,230,217,1500,0,7810,9310,5423,2,0,14,16
7171,KURNOOL,VELGODU,MOTHUKUR,184,5,509,698,126,0,334,460,454,3372,0,10760,14132,7596,0,0,7,7
7172,KURNOOL,VELGODU,REGADIGUDUR,439,3,1170,1612,182,0,392,574,580,6150,0,11236,17386,9869,5,0,1,6
7173,KURNOOL,VELGODU,VELGODU,754,324,3270,4348,115,115,496,726,710,3916,8621,13142,25679,15823,3,34,7,44
7174,KURNOOL,VELGODU,VELPANUR,502,3,1458,1963,49,2,399,450,430,864,10,5932,6806,3747,2,0,0,2
7175,KURNOOL,YEMMIGANUR,BANAVASI,266,0,694,960,110,0,185,295,302,5263,0,8779,14042,8105,12,0,30,42
7176,KURNOOL,YEMMIGANUR,DEVIBETTA,89,0,338,427,17,0,61,78,70,592,0,1396,1988,966,1,0,1,2
7177,KURNOOL,YEMMIGANUR,DIVAMDINNE,236,1,848,1085,3,0,36,39,46,54,0,747,801,395,0,0,0,0
7178,KURNOOL,YEMMIGANUR,ENIGABALA,319,1,261,581,48,0,50,98,97,1393,0,828,2221,1068,3,0,0,3
7179,KURNOOL,YEMMIGANUR,GUDIKAL,442,3,776,1221,25,0,106,131,111,462,0,2723,3185,1582,0,0,1,1
7180,KURNOOL,YEMMIGANUR,K.THIMMAPURAM,73,1,550,624,13,0,189,202,199,511,0,8166,8677,4531,0,0,13,13
7181,KURNOOL,YEMMIGANUR,KADIMETLA,393,0,1948,2341,90,0,344,434,226,1274,0,6584,7858,2093,0,0,1,1
7182,KURNOOL,YEMMIGANUR,KADIVELLA,331,8,1221,1560,77,0,536,613,644,789,0,11810,12599,6173,0,0,13,13
7183,KURNOOL,YEMMIGANUR,KALUGOTLA,367,1,612,980,146,0,347,493,484,2268,0,9358,11626,5426,0,0,9,9
7184,KURNOOL,YEMMIGANUR,KANDANATHI,220,1,1529,1750,23,0,425,448,501,311,0,17291,17602,8657,0,0,21,21
7185,KURNOOL,YEMMIGANUR,KOTEKAL,82,0,1334,1416,23,0,337,360,348,374,0,20183,20557,10220,0,0,28,28
7186,KURNOOL,YEMMIGANUR,MALAKAPURAM,136,1,389,526,9,0,60,69,50,90,0,1167,1257,435,0,0,0,0
7187,KURNOOL,YEMMIGANUR,PARLAPALLE,248,6,964,1218,41,0,111,152,109,1086,0,1994,3080,1369,0,0,0,0
7188,KURNOOL,YEMMIGANUR,PESALADINNE,158,1,410,569,45,0,148,193,191,533,0,3817,4350,2177,0,0,0,0
7189,KURNOOL,YEMMIGANUR,SOGANUR,124,0,450,574,83,0,44,127,106,1746,0,1194,2940,1302,0,0,0,0
7190,KURNOOL,YEMMIGANUR,TSALLAKUDLUR,139,0,406,545,114,0,328,442,479,3843,0,9147,12990,6712,0,0,0,0
7191,NELLORE,Allur,ALLURU,832,1972,758,3562,62,447,3,512,449,1321,17763,5,19089,10474,0,46,0,46
7192,NELLORE,Allur,BATRAKAGOLLU,124,108,265,497,49,11,110,170,117,1568,171,2221,3960,2079,0,0,0,0
7193,NELLORE,Allur,BEERAMGUNTA,333,134,165,632,5,0,1,6,1,36,0,6,42,6,0,0,0,0
7194,NELLORE,Allur,EAST GOGULAPALLE,443,40,408,891,134,1,136,271,237,1684,29,2286,3999,2563,0,0,0,0
7195,NELLORE,Allur,GRADDAGUNTA,187,3,309,499,114,0,111,225,188,4387,0,5137,9524,4999,0,0,0,0
7196,NELLORE,Allur,INDUPURU,203,132,314,649,66,3,64,133,62,910,9,1221,2140,522,0,0,0,0
7197,NELLORE,Allur,ISKAPALLI,988,183,1577,2748,15,13,27,55,28,200,155,334,689,315,0,0,0,0
7198,NELLORE,Allur,NORTH AMULURU,93,22,362,477,44,8,68,120,99,1086,206,797,2089,1375,0,0,0,0
7199,NELLORE,Allur,NORTH MOPURU,485,158,392,1035,150,0,19,169,79,1923,0,94,2017,583,0,0,0,0
7200,NELLORE,Allur,PURINI,354,220,350,924,150,45,88,283,254,1958,826,956,3740,2063,0,0,0,0
7201,NELLORE,Allur,SINGAPETA,268,461,73,802,4,45,1,50,29,29,811,5,845,340,0,0,0,0
7202,NELLORE,Allur,VELICHERLA,115,70,30,215,23,12,17,52,45,339,362,727,1428,820,0,0,0,0
7203,NELLORE,Allur,WEST GOGULA PALLE,397,88,107,592,0,0,0,0,0,0,0,0,0,0,0,0,0,0
7204,NELLORE,Ananthasagaram,A.CHIRUVELLA,58,15,492,565,30,0,130,160,150,1114,0,5639,6753,5433,1,0,2,3
7205,NELLORE,Ananthasagaram,ANANTHASAGARAM,326,90,1137,1553,140,21,347,508,449,4991,886,8322,14199,8118,3,1,4,8
7206,NELLORE,Ananthasagaram,BEDUSUPALLE,4,0,64,68,0,0,0,0,0,0,0,0,0,0,0,0,0,0
7207,NELLORE,Ananthasagaram,BOMMAVARAM,299,36,686,1021,159,8,229,396,352,7329,101,12458,19888,10650,17,0,10,27
7208,NELLORE,Ananthasagaram,CHILAKALAMARRI,5,103,371,479,0,35,8,43,40,0,1320,288,1608,924,0,1,0,1
7209,NELLORE,Ananthasagaram,DEVARAYAPALLI BIT-I,159,23,364,546,66,0,108,174,161,1461,0,2848,4309,3010,0,0,0,0
7210,NELLORE,Ananthasagaram,DEVARAYAPALLI BIT-II,368,89,573,1030,51,14,78,143,134,733,204,1574,2511,1573,0,0,0,0
7211,NELLORE,Ananthasagaram,GOWRAVARAM,168,28,231,427,85,0,130,215,233,3763,0,5627,9390,5199,12,0,4,16
7212,NELLORE,Ananthasagaram,GUDIGUNTA,22,20,355,397,1,4,130,135,121,20,71,4503,4594,2360,0,0,0,0
7213,NELLORE,Ananthasagaram,INAGALUR,112,1,68,181,60,0,22,82,90,1472,0,520,1992,1403,0,0,0,0
7214,NELLORE,Ananthasagaram,ISKAPALLI,54,20,320,394,11,0,99,110,101,143,0,1124,1267,823,0,0,1,1
7215,NELLORE,Ananthasagaram,KAMIREDDIPADU,62,40,199,301,25,16,93,134,134,1489,573,5030,7092,5465,4,1,8,13
7216,NELLORE,Ananthasagaram,LINGAMGUNTA,126,28,146,300,24,3,41,68,56,382,48,987,1417,914,0,0,0,0
7217,NELLORE,Ananthasagaram,MANCHALAPALLI,25,0,329,354,4,0,8,12,9,9,0,36,45,42,0,0,0,0
7218,NELLORE,Ananthasagaram,MANGUPALLE,255,45,77,377,99,15,8,122,116,2834,305,138,3277,1947,0,0,0,0
7219,NELLORE,Ananthasagaram,MINAGALLU,159,48,385,592,59,2,233,294,281,2473,22,9015,11510,6495,5,0,36,41
7220,NELLORE,Ananthasagaram,MUSTHAPURAM,42,30,225,297,12,0,73,85,71,192,0,1249,1441,941,0,0,0,0
7221,NELLORE,Ananthasagaram,PADAMATIKAMBHAMPADU,538,10,721,1269,175,0,54,229,223,7153,0,1326,8479,5154,10,0,1,11
7222,NELLORE,Ananthasagaram,PATHALLAPALLE,44,18,359,421,22,3,265,290,280,250,28,4376,4654,2561,0,0,0,0
7223,NELLORE,Ananthasagaram,REVURU,157,28,369,554,99,0,213,312,311,4651,0,4786,9437,5814,4,0,0,4
7224,NELLORE,Ananthasagaram,SOMASILA,221,65,607,893,0,0,0,0,0,0,0,0,0,0,0,0,0,0
7225,NELLORE,Ananthasagaram,UPPALAPADU,76,0,225,301,0,0,30,30,27,0,0,298,298,235,0,0,0,0
7226,NELLORE,Ananthasagaram,VAREKUNTAPADU,107,3,155,265,0,0,0,0,0,0,0,0,0,0,0,0,0,0
7227,NELLORE,Ananthasagaram,VENGAMPALLE,14,1,210,225,0,0,40,40,39,0,0,392,392,232,0,0,0,0
7228,NELLORE,Anumasamudrampeta,A.S. PETA,121,27,1032,1180,33,3,311,347,358,1049,151,15193,16393,13570,0,0,18,18
7229,NELLORE,Anumasamudrampeta,AKBARABAD,19,1,189,209,15,0,113,128,127,689,0,6479,7168,5303,1,0,9,10
7230,NELLORE,Anumasamudrampeta,ANUMASAMUDRAM,346,77,521,944,130,5,198,333,303,6345,177,10893,17415,11662,15,0,15,30
7231,NELLORE,Anumasamudrampeta,CHOUTA BHEEMAVARAM,69,65,497,631,6,7,121,134,119,157,108,5069,5334,4579,0,0,2,2
7232,NELLORE,Anumasamudrampeta,CIHRAMANA,113,5,474,592,55,0,177,232,221,2744,0,8953,11697,10524,4,0,4,8
7233,NELLORE,Anumasamudrampeta,DUBAGUNTA,25,3,304,332,0,0,0,0,0,0,0,0,0,0,0,0,0,0
7234,NELLORE,Anumasamudrampeta,GUDIPADU,243,62,502,807,66,2,136,204,157,3227,57,9359,12643,7327,6,0,32,38
7235,NELLORE,Anumasamudrampeta,GUMPARLAPADU,47,43,491,581,2,2,112,116,95,146,160,6591,6897,4990,0,1,8,9
7236,NELLORE,Anumasamudrampeta,HASANAPURAM,54,2,532,588,7,0,268,275,247,162,0,9913,10075,7034,0,0,9,9
7237,NELLORE,Anumasamudrampeta,K. YADAVALLI,91,14,602,707,34,0,162,196,168,1994,0,7844,9838,6028,7,0,20,27
7238,NELLORE,Anumasamudrampeta,K.KONDURU,37,9,163,209,13,4,88,105,85,224,41,3658,3923,2352,0,0,1,1
7239,NELLORE,Anumasamudrampeta,KUPPURUPADU,54,1,152,207,0,0,0,0,0,0,0,0,0,0,0,0,0,0
7240,NELLORE,Anumasamudrampeta,PANDIPADU,43,4,194,241,0,0,102,102,92,0,0,4320,4320,3093,0,0,4,4
7241,NELLORE,Anumasamudrampeta,PEDABBIPURAM,66,0,418,484,41,0,261,302,273,3103,0,16565,19668,11972,12,0,23,35
7242,NELLORE,Anumasamudrampeta,PONUGODU,45,37,307,389,23,14,187,224,207,1587,391,10579,12557,9464,3,0,14,17
7243,NELLORE,Anumasamudrampeta,RAJAVOLU,82,72,550,704,24,36,210,270,249,1181,1451,10497,13129,9844,3,3,16,22
7244,NELLORE,Anumasamudrampeta,SRIKOLANU,170,31,567,768,41,3,244,288,263,1544,59,11365,12968,9691,1,0,4,5
7245,NELLORE,Anumasamudrampeta,VELPULAGUNTA,69,5,61,135,26,0,4,30,29,546,0,111,657,342,0,0,0,0
7246,NELLORE,Anumasamudrampeta,ZAMMAVARAM,102,29,446,577,64,7,233,304,271,3405,147,11954,15506,10043,3,0,14,17
7247,NELLORE,Atmakur,APPARAO PAELM,242,126,284,652,61,46,32,139,103,2516,4211,599,7326,4168,5,16,2,23
7248,NELLORE,Atmakur,ARAVEDU,72,37,394,503,35,0,189,224,177,1647,0,6237,7884,4220,4,0,5,9
7249,NELLORE,Atmakur,ATMAKUR,743,325,552,1620,29,34,1,64,59,759,1198,38,1995,1180,0,0,0,0
7250,NELLORE,Atmakur,BANDARUPALLE,248,58,230,536,95,1,45,141,121,5003,69,1650,6722,3716,12,0,0,12
7251,NELLORE,Atmakur,BATTEPADU,217,33,190,440,32,0,29,61,0,444,0,258,702,0,0,0,0,0
7252,NELLORE,Atmakur,BOILA CHIRUVELLA,117,18,669,804,17,6,199,222,207,267,85,3944,4296,2695,0,0,0,0
7253,NELLORE,Atmakur,CHERLOYADAVALLI,62,11,170,243,10,3,23,36,13,183,30,403,616,147,0,0,0,0
7254,NELLORE,Atmakur,KANUPURUPALLE,39,12,228,279,17,0,121,138,126,328,0,4296,4624,3421,0,0,0,0
7255,NELLORE,Atmakur,KARATAMPADU,263,53,459,775,40,5,103,148,134,1035,139,2112,3286,2685,0,0,0,0
7256,NELLORE,Atmakur,MAHIMALUR,381,50,755,1186,114,2,331,447,351,2724,64,8787,11575,5238,0,0,2,2
7257,NELLORE,Atmakur,MURAGALLA,156,6,208,370,82,2,39,123,110,3164,96,733,3993,2508,2,0,0,2
7258,NELLORE,Atmakur,NAGULAPADU,30,7,113,150,15,5,77,97,87,747,212,3758,4717,3043,0,0,1,1
7259,NELLORE,Atmakur,NALLAPAREDDI PALLI,84,6,179,269,36,5,84,125,76,687,224,4479,5390,2048,0,0,15,15
7260,NELLORE,Atmakur,NARAMPETA,102,0,54,156,70,0,34,104,102,4189,0,2819,7008,3822,7,0,13,20
7261,NELLORE,Atmakur,NELLOREPALEM,113,110,409,632,5,13,81,99,93,215,668,2087,2970,1963,0,1,0,1
7262,NELLORE,Atmakur,NUVVURUPADU,160,40,347,547,53,10,104,167,113,637,86,1453,2176,1049,0,0,0,0
7263,NELLORE,Atmakur,NUVVURUPADU(H),174,32,409,615,66,0,136,202,183,1467,0,3220,4687,3018,0,0,2,2
7264,NELLORE,Atmakur,PADAKANDLA,219,32,598,849,134,4,270,408,357,4313,41,6666,11020,5443,3,0,1,4
7265,NELLORE,Atmakur,PAMIDIPADU,2,4,129,135,0,0,80,80,75,0,0,2888,2888,1782,0,0,0,0
7266,NELLORE,Atmakur,RAMASWAMIPALLE,53,80,531,664,16,41,300,357,334,1167,2730,15579,19476,12511,4,9,29,42
7267,NELLORE,Atmakur,RAVULAKOLLU,37,7,69,113,25,5,55,85,80,1447,125,2764,4336,3251,2,0,0,2
7268,NELLORE,Atmakur,VASILI,348,64,318,730,43,0,107,150,91,1199,0,4147,5346,2598,0,0,2,2
7269,NELLORE,Atmakur,VENKATARAO PALLI,145,114,502,761,80,0,150,230,208,1526,0,5592,7118,4550,0,0,2,2
7270,NELLORE,Atmakur,VENNAWADA,57,4,243,304,12,0,109,121,94,135,0,1333,1468,816,0,0,0,0
7271,NELLORE,Balayapalle,ALIMILI,467,247,487,1201,141,31,128,300,276,4457,394,4427,9278,5324,0,0,0,0
7272,NELLORE,Balayapalle,BALAYAPALLI,416,36,491,943,56,8,93,157,144,2819,304,2812,5935,3345,2,0,3,5
7273,NELLORE,Balayapalle,BHYRAVARAM,291,134,186,611,155,55,97,307,322,7758,2899,2358,13015,7205,2,2,0,4
7274,NELLORE,Balayapalle,CHILAMANURU,161,32,197,390,88,13,134,235,221,3984,146,5117,9247,5023,1,0,2,3
7275,NELLORE,Balayapalle,GOTTIKADU,119,60,120,299,53,0,26,79,67,1533,0,392,1925,1090,0,0,0,0
7276,NELLORE,Balayapalle,HASTHAKAVERI,140,29,373,542,73,15,159,247,209,2107,390,4539,7036,3145,1,0,4,5
7277,NELLORE,Balayapalle,JAYAMPU,302,115,417,834,78,36,121,235,228,1669,346,2006,4021,2138,0,0,0,0
7278,NELLORE,Balayapalle,KADAGUNTA,224,61,232,517,139,36,150,325,329,8985,608,7246,16839,9476,27,0,13,40
7279,NELLORE,Balayapalle,KALAGANDA,106,42,210,358,12,0,80,92,78,129,0,2084,2213,1067,0,0,2,2
7280,NELLORE,Balayapalle,KAMAKURU,145,45,190,380,64,27,103,194,161,2529,1589,6150,10268,5682,7,4,21,32
7281,NELLORE,Balayapalle,KATRAGUNTA,140,102,388,630,16,25,105,146,154,224,1629,4131,5984,3203,0,3,6,9
7282,NELLORE,Balayapalle,KAYYURU,225,58,315,598,133,32,210,375,348,3505,1076,6574,11155,6172,5,0,8,13
7283,NELLORE,Balayapalle,KOTAMBEDU,156,16,200,372,75,9,81,165,151,2830,504,4481,7815,4504,5,1,13,19
7284,NELLORE,Balayapalle,MANNURU,112,54,269,435,55,1,155,211,197,601,2,4760,5363,3202,0,0,8,8
7285,NELLORE,Balayapalle,NIDIGALLU,173,31,423,627,67,1,157,225,191,1362,8,2997,4367,2289,0,0,0,0
7286,NELLORE,Balayapalle,NINDALI,328,51,344,723,143,4,182,329,320,5860,80,9135,15075,9763,10,0,14,24
7287,NELLORE,Balayapalle,PAKAPUDI,97,17,90,204,51,10,55,116,100,1077,201,1711,2989,1604,0,0,1,1
7288,NELLORE,Balayapalle,PALLIPADU,75,13,133,221,34,0,45,79,70,290,0,528,818,437,0,0,0,0
7289,NELLORE,Balayapalle,PERIMIDI,529,188,372,1089,205,107,166,478,437,8614,4107,6424,19145,10445,7,1,5,13
7290,NELLORE,Balayapalle,PIGILAM,419,105,445,969,222,52,252,526,501,7488,1996,9737,19221,9747,5,0,7,12
7291,NELLORE,Balayapalle,SANGAVARAM,102,37,194,333,46,9,87,142,137,2913,118,3260,6291,3890,6,0,0,6
7292,NELLORE,Balayapalle,SIDDAGUNTA,118,12,87,217,54,4,58,116,94,1739,61,1735,3535,1836,1,0,0,1
7293,NELLORE,Balayapalle,UTLAPALLE,105,137,169,411,50,64,89,203,204,1133,1961,2231,5325,2765,0,0,0,0
7294,NELLORE,Balayapalle,VENGAMAMBAPURAM,246,38,348,632,53,2,28,83,85,679,25,195,899,509,0,0,0,0
7295,NELLORE,Bogole,A.B. KANDRIGA,29,2,211,242,24,1,117,142,116,1309,15,3422,4746,2239,2,0,6,8
7296,NELLORE,Bogole,ALLIMADUGU,365,210,297,872,216,79,61,356,334,7734,3528,2949,14211,7927,4,1,1,6
7297,NELLORE,Bogole,BITRAGUNTA,218,206,529,953,136,56,258,450,424,7395,1373,10190,18958,13871,22,0,10,32
7298,NELLORE,Bogole,BOGOLE,314,369,179,862,0,0,0,0,0,0,0,0,0,0,0,0,0,0
7299,NELLORE,Bogole,C.R. PALEM,141,38,1254,1433,26,11,113,150,159,692,207,4972,5871,3294,1,0,11,12
7300,NELLORE,Bogole,JAKKEPALLIGUDUR,167,63,372,602,40,24,134,198,170,411,850,3265,4526,2297,0,1,1,2
7301,NELLORE,Bogole,JUVVALADINNE,99,47,1341,1487,35,21,639,695,706,593,727,8111,9431,6264,0,1,2,3
7302,NELLORE,Bogole,KOVURUPALLE,201,121,164,486,56,41,35,132,133,2829,543,1332,4704,3517,4,0,1,5
7303,NELLORE,Bogole,MUNGAMUR,147,109,508,764,96,20,253,369,320,5344,429,5887,11660,6599,11,0,0,11
7304,NELLORE,Bogole,NAGULAVARAM,189,109,435,733,88,42,117,247,215,4124,2284,2689,9097,5804,5,4,1,10
7305,NELLORE,Bogole,S.G.V. KANDRIGA,95,10,293,398,52,0,148,200,180,1022,0,1902,2924,1572,0,0,0,0
7306,NELLORE,Bogole,S.V. PALEM,62,108,555,725,53,11,365,429,494,3636,524,12796,16956,9281,8,3,2,13
7307,NELLORE,Bogole,THALLURU,267,52,323,642,93,5,174,272,247,2389,86,4702,7177,5090,2,0,0,2
7308,NELLORE,Bogole,UMAMAHESWARAPURAM,170,14,96,280,88,2,67,157,155,3356,70,2976,6402,4061,0,0,0,0
7309,NELLORE,Bogole,V N R PET,253,161,106,520,0,6,0,6,7,0,117,0,117,65,0,0,0,0
7310,NELLORE,Bogole,YENUGULABAVI,103,60,279,442,37,14,49,100,97,2070,523,2073,4666,3553,3,0,3,6
7311,NELLORE,Butchireddipalem,BUCHIREDDIPALEM,369,246,470,1085,21,13,17,51,47,1218,576,520,2314,1097,0,1,0,1
7312,NELLORE,Butchireddipalem,CHELLAYAPALEM,315,68,238,621,72,0,0,72,14,3624,0,0,3624,533,4,0,0,4
7313,NELLORE,Butchireddipalem,DAMARAMADUGU,380,136,245,761,0,0,0,0,0,0,0,0,0,0,0,0,0,0
7314,NELLORE,Butchireddipalem,ISKAPALEM,390,337,681,1408,80,13,23,116,85,951,186,301,1438,759,0,0,0,0
7315,NELLORE,Butchireddipalem,JONNAWADA,216,124,225,565,1,0,0,1,1,20,0,0,20,10,0,0,0,0
7316,NELLORE,Butchireddipalem,KALAYAKAGOLLU,369,131,213,713,7,1,6,14,1,159,12,132,303,31,0,0,0,0
7317,NELLORE,Butchireddipalem,KATTUVADIPALEM,112,97,440,649,2,55,133,190,173,170,2776,2687,5633,2886,1,4,0,5
7318,NELLORE,Butchireddipalem,MINAGALLU,345,134,427,906,135,13,64,212,188,3290,366,2202,5858,3259,0,0,2,2
7319,NELLORE,Butchireddipalem,MUNULAPUDI,115,34,475,624,17,0,229,246,203,236,0,4497,4733,2912,0,0,1,1
7320,NELLORE,Butchireddipalem,NAGAIAHKUNTA,266,12,293,571,12,8,106,126,105,487,545,5329,6361,4023,0,0,0,0
7321,NELLORE,Butchireddipalem,NAGAMAMBAPURAM,212,87,297,596,83,2,7,92,76,2296,63,160,2519,1506,0,0,0,0
7322,NELLORE,Butchireddipalem,PANCHEDU,318,196,91,605,154,0,0,154,50,4579,0,0,4579,1249,5,0,0,5
7323,NELLORE,Butchireddipalem,PENUBALLE,296,190,347,833,33,78,38,149,111,1658,7533,1709,10900,4995,5,49,5,59
7324,NELLORE,Butchireddipalem,REBALA,342,230,511,1083,76,1,4,81,71,3231,20,72,3323,2105,6,0,0,6
7325,NELLORE,Butchireddipalem,VAVVERU,329,430,563,1322,73,16,64,153,140,1062,339,520,1921,1141,0,0,0,0
7326,NELLORE,Chejerla,ADURUPALLI,14,112,324,450,1,16,164,181,158,80,436,6882,7398,4812,0,0,5,5
7327,NELLORE,Chejerla,BODIPADU,51,6,124,181,27,1,68,96,89,675,56,1998,2729,1901,0,0,1,1
7328,NELLORE,Chejerla,CHEJERLA,356,96,487,939,33,0,35,68,52,314,0,692,1006,494,0,0,0,0
7329,NELLORE,Chejerla,CHITTALURU,139,8,249,396,19,0,23,42,37,1280,0,2015,3295,2462,7,0,12,19
7330,NELLORE,Chejerla,GOLLAPALLI,133,44,114,291,27,0,35,62,50,206,0,1448,1654,568,0,0,1,1
7331,NELLORE,Chejerla,KAKIVAYA,100,29,304,433,19,8,87,114,102,1003,379,5291,6673,4300,2,0,17,19
7332,NELLORE,Chejerla,KOTI THEERTHAM,98,12,110,220,78,3,55,136,118,2626,36,961,3623,1941,0,0,0,0
7333,NELLORE,Chejerla,MADAPALLI,129,55,557,741,36,2,130,168,140,1036,22,2568,3626,1927,0,0,1,1
7334,NELLORE,Chejerla,MAMUDURU,372,105,771,1248,57,0,173,230,148,1407,0,3802,5209,2187,0,0,0,0
7335,NELLORE,Chejerla,NAGULAVELLATUR,150,29,450,629,14,0,70,84,60,288,0,4353,4641,2180,0,0,11,11
7336,NELLORE,Chejerla,NERNOOR,115,31,259,405,0,0,5,5,4,0,0,64,64,16,0,0,0,0
7337,NELLORE,Chejerla,NUTHAKKIVARIKANDRIGA,109,81,497,687,0,0,0,0,0,0,0,0,0,0,0,0,0,0
7338,NELLORE,Chejerla,OBULAIAHPALLI,111,10,185,306,39,2,69,110,56,821,24,3343,4188,1247,0,0,4,4
7339,NELLORE,Chejerla,PADERU,55,18,324,397,3,0,53,56,52,30,0,1817,1847,883,0,0,2,2
7340,NELLORE,Chejerla,PATHAPADU,36,12,180,228,14,7,127,148,143,502,399,8593,9494,4490,3,1,36,40
7341,NELLORE,Chejerla,PELLERU,114,7,378,499,50,1,126,177,60,847,22,1829,2698,633,0,0,0,0
7342,NELLORE,Chejerla,PERUMALLAPADU,149,41,334,524,53,2,137,192,130,2114,18,4990,7122,3480,1,0,3,4
7343,NELLORE,Chejerla,THIMMAYAPALEM,40,7,312,359,6,1,92,99,80,371,132,6304,6807,4156,1,1,37,39
7344,NELLORE,Chejerla,TURPU KHAMBHAMPADU,203,46,285,534,73,3,78,154,116,2883,116,2769,5768,2894,4,0,1,5
7345,NELLORE,Chejerla,VAVILERU,150,67,382,599,49,0,0,49,41,800,0,0,800,456,0,0,0,0
7346,NELLORE,Chejerla,YANANADALA,80,42,116,238,0,0,0,0,0,0,0,0,0,0,0,0,0,0
7347,NELLORE,Chejerla,YETURU,118,40,231,389,0,0,0,0,0,0,0,0,0,0,0,0,0,0
7348,NELLORE,Chillakur,ANNAMBAKA,85,46,132,263,50,9,36,95,76,1929,246,1035,3210,1872,2,0,1,3
7349,NELLORE,Chillakur,BALLAVOLU,186,179,272,637,137,106,188,431,375,6302,7556,9338,23196,12345,3,32,14,49
7350,NELLORE,Chillakur,BUDANAM,317,64,138,519,130,2,34,166,133,3530,20,1209,4759,2996,3,0,1,4
7351,NELLORE,Chillakur,CHEDIMALA,203,97,179,479,145,32,68,245,226,8058,651,2903,11612,6933,24,1,5,30
7352,NELLORE,Chillakur,CHILLAKUR,419,268,99,786,153,100,3,256,220,9381,6437,131,15949,11749,29,25,0,54
7353,NELLORE,Chillakur,CHINTHAVARAM,195,104,425,724,119,54,181,354,306,5990,1912,8009,15911,9535,7,4,10,21
7354,NELLORE,Chillakur,EAST KANUPUR,72,32,295,399,0,0,0,0,0,0,0,0,0,0,0,0,0,0
7355,NELLORE,Chillakur,EGUVURAJU PALEM,59,63,96,218,51,48,50,149,133,3831,3957,4555,12343,6693,18,22,24,64
7356,NELLORE,Chillakur,KADIVEDU,190,90,131,411,134,13,30,177,141,9636,164,2176,11976,6431,42,0,10,52
7357,NELLORE,Chillakur,KALAVA KONDA,243,94,138,475,194,60,81,335,283,9825,3002,3177,16004,10303,10,2,1,13
7358,NELLORE,Chillakur,KAMMAVARIPALEM,96,28,59,183,55,8,38,101,88,3202,198,1056,4456,3006,4,0,0,4
7359,NELLORE,Chillakur,LINGAVARAM,112,97,223,432,67,0,0,67,53,6373,0,0,6373,3804,42,0,0,42
7360,NELLORE,Chillakur,MANNEGUNTA,1,6,248,255,1,1,146,148,119,13,110,8863,8986,5064,0,1,23,24
7361,NELLORE,Chillakur,MOMIDI,200,72,249,521,121,7,115,243,221,3842,133,2796,6771,5839,1,0,0,1
7362,NELLORE,Chillakur,MUTHYALAPADU,404,89,214,707,170,1,67,238,218,9081,6,1860,10947,7256,29,0,2,31
7363,NELLORE,Chillakur,NELABALLI,275,119,230,624,99,21,32,152,150,1983,375,836,3194,2056,0,0,0,0
7364,NELLORE,Chillakur,ODURU,289,176,325,790,185,83,160,428,366,12573,4063,9388,26024,14934,38,10,25,73
7365,NELLORE,Chillakur,P.C.VARI PALEM,10,191,394,595,3,86,128,217,193,122,2166,5356,7644,5856,0,0,2,2
7366,NELLORE,Chillakur,PALLAMALA,131,21,126,278,92,0,87,179,142,2865,0,1874,4739,2606,0,0,0,0
7367,NELLORE,Chillakur,PONNAVOLU,158,77,172,407,74,17,87,178,147,613,76,880,1569,807,0,0,0,0
7368,NELLORE,Chillakur,THAMMINAPATNAM,175,32,464,671,138,2,134,274,255,12064,181,8117,20362,13021,61,1,29,91
7369,NELLORE,Chillakur,THEEPANUR,52,8,147,207,32,1,107,140,133,2088,10,5688,7786,4149,4,0,9,13
7370,NELLORE,Chillakur,THIKKAVARAM,144,49,52,245,90,5,25,120,106,6022,193,1667,7882,4898,23,0,4,27
7371,NELLORE,Chillakur,THIMMANNAGARI PALEM,205,42,178,425,86,7,42,135,102,3345,264,1464,5073,3051,4,0,0,4
7372,NELLORE,Chillakur,THIPPAGUNTAPALEM,182,78,54,314,122,2,10,134,130,4408,76,632,5116,3724,2,0,0,2
7373,NELLORE,Chillakur,TONUKUMALA,230,35,193,458,109,1,100,210,198,3791,4,2798,6593,4585,2,0,2,4
7374,NELLORE,Chillakur,UDATHAVARIPALEM,227,169,489,885,82,18,291,391,311,4386,921,19416,24723,13603,12,3,79,94
7375,NELLORE,Chillakur,VALLIPADU,147,105,153,405,85,3,63,151,154,2142,29,1575,3746,2563,0,0,1,1
7376,NELLORE,Chillakur,VARAGALI,288,135,182,605,202,64,118,384,354,11662,3760,7406,22828,14689,21,14,17,52
7377,NELLORE,Chillakur,VELLAPALEM,83,101,233,417,69,66,210,345,346,4724,3470,12196,20390,10773,6,3,12,21
7378,NELLORE,Chillakur,YERURU,242,88,261,591,127,11,108,246,237,2980,502,3479,6961,4365,0,0,0,0
7379,NELLORE,Chittamur,ALETIPADU,138,93,150,381,84,38,102,224,146,3286,1374,5027,9687,6117,1,0,8,9
7380,NELLORE,Chittamur,ARAVAPALEM,215,186,302,703,125,87,126,338,316,3700,1600,1628,6928,3946,0,0,0,0
7381,NELLORE,Chittamur,ARURU,269,45,317,631,166,11,127,304,301,5596,631,4908,11135,6846,3,4,4,11
7382,NELLORE,Chittamur,BURADAGALI KOTHAPALEM,491,55,300,846,295,14,129,438,423,6726,343,4065,11134,6570,0,0,0,0
7383,NELLORE,Chittamur,CHILLAMURU,193,132,365,690,151,82,256,489,486,4875,1377,6787,13039,6792,0,1,0,1
7384,NELLORE,Chittamur,CHITTAMUR,374,43,396,813,148,0,0,148,131,3936,0,0,3936,2243,0,0,0,0
7385,NELLORE,Chittamur,ESWARAWAKA,532,251,306,1089,299,13,141,453,421,8568,311,3703,12582,6714,4,0,5,9
7386,NELLORE,Chittamur,GUNAPATHI PALEM,367,61,139,567,180,10,75,265,248,4324,104,2708,7136,5077,0,0,0,0
7387,NELLORE,Chittamur,GUNUPUDU,198,159,131,488,122,0,41,163,132,1427,0,1727,3154,1854,0,0,1,1
7388,NELLORE,Chittamur,JAKKALAVANIPALLI,126,77,24,227,73,36,13,122,133,4517,565,432,5514,3145,14,0,0,14
7389,NELLORE,Chittamur,KOGILI,338,44,402,784,224,34,209,467,387,6108,2172,7822,16102,8146,3,11,9,23
7390,NELLORE,Chittamur,MALLAM,665,197,331,1193,354,35,36,425,361,9419,787,834,11040,6213,15,0,0,15
7391,NELLORE,Chittamur,METTU,234,123,177,534,172,14,42,228,207,7475,492,1887,9854,5877,9,1,1,11
7392,NELLORE,Chittamur,MOLAKALA PUDI,129,83,121,333,113,20,80,213,157,4735,459,1749,6943,3305,1,0,0,1
7393,NELLORE,Chittamur,NORTH VARTHURU,40,41,70,151,28,31,51,110,111,1372,1639,2733,5744,3193,0,7,1,8
7394,NELLORE,Chittamur,PALLAMPATHY,162,2,27,191,116,0,11,127,91,3735,0,162,3897,2113,1,0,0,1
7395,NELLORE,Chittamur,PELLAKURU,294,75,134,503,137,4,27,168,108,6256,184,1242,7682,5228,15,0,0,15
7396,NELLORE,Chittamur,RANGANADHAPURAM,1,0,95,96,0,0,0,0,0,0,0,0,0,0,0,0,0,0
7397,NELLORE,Chittamur,TADIMEDU,119,9,82,210,85,5,47,137,120,3602,91,1742,5435,2871,3,0,1,4
7398,NELLORE,Chittamur,UPPALAMARTHI,416,17,308,741,277,13,188,478,408,14667,205,10930,25802,13098,30,0,24,54
7399,NELLORE,Chittamur,YAKASIRI,368,207,276,851,180,9,53,242,231,3785,150,1958,5893,3187,0,0,1,1
7400,NELLORE,Chittamur,YELLASIRI,167,175,184,526,114,49,76,239,212,2720,499,1711,4930,2545,0,0,0,0
7401,NELLORE,Chittamur,YELLORE,179,83,49,311,143,37,13,193,183,7361,1365,796,9522,5201,6,1,1,8
7402,NELLORE,Dagadarthi,ANANTHAVARAM,211,63,330,604,75,0,131,206,191,1793,0,3397,5190,3791,0,0,0,0
7403,NELLORE,Dagadarthi,BODAGUDIPADU,138,34,313,485,80,6,188,274,258,2229,64,6148,8441,4847,0,0,4,4
7404,NELLORE,Dagadarthi,CHENNURU,526,424,716,1666,115,84,183,382,345,2517,1740,3396,7653,3909,0,0,0,0
7405,NELLORE,Dagadarthi,CHOUTAPUTHEDU,151,21,216,388,57,0,96,153,129,2056,0,1367,3423,1763,5,0,1,6
7406,NELLORE,Dagadarthi,DAGADARTHI,331,225,549,1105,88,0,0,88,77,768,0,0,768,524,0,0,0,0
7407,NELLORE,Dagadarthi,DAMAVARAM,193,23,597,813,4,12,190,206,65,121,553,2012,2686,717,0,0,0,0
7408,NELLORE,Dagadarthi,DHARMAVARAM,182,21,557,760,84,3,311,398,325,1239,63,3671,4973,2609,0,0,0,0
7409,NELLORE,Dagadarthi,DUNDIGAM,215,15,330,560,72,4,66,142,107,1410,50,677,2137,1183,0,0,0,0
7410,NELLORE,Dagadarthi,K.K. GUNTA,298,98,383,779,54,19,158,231,213,2929,696,5697,9322,4988,4,1,6,11
7411,NELLORE,Dagadarthi,KATRAYAPADU,178,22,213,413,0,0,0,0,0,0,0,0,0,0,0,0,0,0
7412,NELLORE,Dagadarthi,MANUBOLUPADU,90,33,209,332,57,11,146,214,194,645,104,1730,2479,1411,0,0,0,0
7413,NELLORE,Dagadarthi,PEDAPUTHEDU,1014,216,516,1746,258,31,135,424,341,3603,441,1292,5336,2802,0,0,0,0
7414,NELLORE,Dagadarthi,RANGASAMUDRAM,160,25,289,474,90,9,180,279,250,2579,250,5378,8207,4222,0,0,0,0
7415,NELLORE,Dagadarthi,TADAKALURU,97,94,155,346,0,0,0,0,0,0,0,0,0,0,0,0,0,0
7416,NELLORE,Dagadarthi,THIRUVEEDHIPADU,36,1,110,147,7,0,0,7,5,42,0,0,42,15,0,0,0,0
7417,NELLORE,Dagadarthi,THURIMERLA,296,81,292,669,53,3,0,56,24,486,15,0,501,152,0,0,0,0
7418,NELLORE,Dagadarthi,UCHAGUNTA PALEM,60,27,160,247,26,10,107,143,127,357,151,3972,4480,2765,0,0,0,0
7419,NELLORE,Dagadarthi,ULAVAPALLA,253,67,298,618,108,18,59,185,166,4077,197,1019,5293,3698,2,0,0,2
7420,NELLORE,Dagadarthi,VELUPODU,20,12,621,653,11,0,282,293,256,318,0,7802,8120,3805,0,0,0,0
7421,NELLORE,Dagadarthi,YELAMANCHIPADU,41,2,188,231,1,0,3,4,3,8,0,30,38,16,0,0,0,0
7422,NELLORE,Dakkili,ALTHURUPADU,300,126,220,646,176,4,99,279,212,6782,195,3421,10398,4397,8,0,1,9
7423,NELLORE,Dakkili,AMUDURU,30,41,178,249,15,12,116,143,118,538,95,1943,2576,1164,1,0,0,1
7424,NELLORE,Dakkili,CHAPALAPALLI,123,53,138,314,77,18,108,203,199,3186,625,3623,7434,3660,1,0,3,4
7425,NELLORE,Dakkili,D UPPARAPALLI,147,24,64,235,78,11,31,120,82,2808,306,779,3893,2091,2,0,0,2
7426,NELLORE,Dakkili,D Vaddipalli,0,0,0,0,0,0,0,0,0,0,0,0,0,0,0,0,0,0
7427,NELLORE,Dakkili,D VELLAMPALLI,32,169,264,465,0,61,146,207,202,0,1780,3342,5122,3378,0,2,0,2
7428,NELLORE,Dakkili,DAGGAVOLU,243,43,706,992,45,0,156,201,152,1681,0,3227,4908,2987,1,0,2,3
7429,NELLORE,Dakkili,DAKKILI,161,209,280,650,77,83,49,209,130,3392,2213,1653,7258,3159,13,7,1,21
7430,NELLORE,Dakkili,DANDAVOLU,52,44,93,189,36,0,0,36,34,745,0,0,745,392,0,0,0,0
7431,NELLORE,Dakkili,DEVULAPALLI,279,53,686,1018,52,4,140,196,153,1787,32,2685,4504,2210,3,0,1,4
7432,NELLORE,Dakkili,K B PALLI,121,68,150,339,55,30,76,161,153,2760,1408,4152,8320,5247,3,2,4,9
7433,NELLORE,Dakkili,LINGASAMUDRAM,274,106,387,767,53,1,83,137,92,484,8,864,1356,549,0,0,0,0
7434,NELLORE,Dakkili,M VELLAMPALLI,181,92,110,383,54,0,0,54,41,899,0,0,899,472,0,0,0,0
7435,NELLORE,Dakkili,MADHAVAYA PALEM,145,57,111,313,60,1,28,89,72,1043,2,242,1287,733,0,0,0,0
7436,NELLORE,Dakkili,MARLAGUNTA,25,9,266,300,15,0,113,128,125,246,0,2368,2614,1162,0,0,0,0
7437,NELLORE,Dakkili,MATUMADUGU,102,57,171,330,16,27,76,119,93,631,693,1796,3120,1453,1,1,0,2
7438,NELLORE,Dakkili,MOPURU,5,12,258,275,0,0,0,0,0,0,0,0,0,0,0,0,0,0
7439,NELLORE,Dakkili,NADIMPALLI,55,18,111,184,36,3,53,92,63,2404,36,469,2909,1373,10,0,0,10
7440,NELLORE,Dakkili,NAGAVOLU,189,55,410,654,40,4,151,195,126,2041,29,4467,6537,3524,4,0,6,10
7441,NELLORE,Dakkili,PALUGODU,319,192,235,746,97,0,35,132,94,1933,0,690,2623,1294,1,0,0,1
7442,NELLORE,Dakkili,PATHANALAPADU,194,53,179,426,75,0,35,110,93,3936,0,710,4646,2341,9,0,0,9
7443,NELLORE,Dakkili,SANGANAPALLI,135,38,351,524,61,0,179,240,206,1013,0,3596,4609,2564,0,0,0,0
7444,NELLORE,Dakkili,SREEPURAM,202,10,145,357,124,0,8,132,129,3758,0,77,3835,2264,2,0,0,2
7445,NELLORE,Dakkili,THEERTHAMPADU,120,84,292,496,68,19,109,196,114,2903,384,2604,5891,2504,6,0,1,7
7446,NELLORE,Dakkili,V K Y SAMUDRAM,24,23,103,150,15,0,16,31,24,269,0,176,445,208,0,0,0,0
7447,NELLORE,Dakkili,VELIKALLU,229,53,325,607,50,26,73,149,127,2050,637,1474,4161,2471,0,0,0,0
7448,NELLORE,Dakkili,VEMBULURU,217,49,765,1031,57,0,282,339,333,2555,0,10499,13054,8573,5,0,1,6
7449,NELLORE,Doravarisatram,AKKARAPAKA,125,44,190,359,72,0,85,157,156,1478,0,513,1991,1278,0,0,0,0
7450,NELLORE,Doravarisatram,BUDURU,168,50,131,349,109,15,50,174,146,1821,91,746,2658,1692,0,0,0,0
7451,NELLORE,Doravarisatram,KALLURU,143,39,482,664,108,29,366,503,489,3432,426,9659,13517,7562,0,0,0,0
7452,NELLORE,Doravarisatram,KOTHAPALLI,242,72,80,394,163,14,44,221,189,2253,119,417,2789,1439,0,0,0,0
7453,NELLORE,Doravarisatram,MEEJURU,472,28,212,712,336,12,164,512,478,13143,260,7111,20514,11625,11,0,4,15
7454,NELLORE,Doravarisatram,MINAMANAMUDI,210,66,131,407,145,22,54,221,199,5117,605,1831,7553,5447,2,0,1,3
7455,NELLORE,Doravarisatram,MODUGULAPALEM,210,0,128,338,87,0,68,155,151,1383,0,1176,2559,1489,0,0,0,0
7456,NELLORE,Doravarisatram,NADIMIKANDRIGA,17,65,142,224,0,0,0,0,0,0,0,0,0,0,0,0,0,0
7457,NELLORE,Doravarisatram,NELABALLI,152,121,170,443,88,33,66,187,179,4818,381,1637,6836,5333,10,0,0,10
7458,NELLORE,Doravarisatram,NELAPATTU,227,73,102,402,186,44,50,280,301,4011,471,456,4938,2548,0,0,0,0
7459,NELLORE,Doravarisatram,NELLOREPALLE,105,27,69,201,46,6,3,55,48,599,48,38,685,371,0,0,0,0
7460,NELLORE,Doravarisatram,POLIREDDIPALEM,263,168,436,867,85,4,295,384,384,4255,198,7797,12250,6227,2,0,2,4
7461,NELLORE,Doravarisatram,POOLATHOTA,427,71,327,825,287,21,183,491,481,9269,411,5461,15141,7921,1,0,1,2
7462,NELLORE,Doravarisatram,SINGANALATHURU,216,12,138,366,137,5,99,241,225,5818,87,2161,8066,3945,3,0,0,3
7463,NELLORE,Doravarisatram,SRIDHANAMALLI,179,59,260,498,124,34,157,315,315,2783,565,4235,7583,4418,0,1,1,2
7464,NELLORE,Doravarisatram,THALLAMPADU,432,37,211,680,219,3,28,250,226,5386,57,378,5821,3431,0,0,0,0
7465,NELLORE,Doravarisatram,THANEYALI,322,91,192,605,160,2,85,247,221,1981,26,2417,4424,2471,1,0,1,2
7466,NELLORE,Doravarisatram,THOGARAMUDI,153,28,80,261,105,12,44,161,155,4064,424,1970,6458,3632,1,0,0,1
7467,NELLORE,Doravarisatram,UTCHURU,80,31,584,695,54,1,401,456,391,1799,5,10875,12679,7239,1,0,1,2
7468,NELLORE,Doravarisatram,VEDURUPATTU,148,75,211,434,73,38,55,166,154,2250,528,616,3394,1747,0,0,0,0
7469,NELLORE,Doravarisatram,VENUMBAKA,280,137,353,770,164,33,174,371,391,4339,737,4910,9986,5158,0,0,3,3
7470,NELLORE,Doravarisatram,YEKOLLU,638,80,222,940,268,0,109,377,361,4721,0,3114,7835,4742,0,0,0,0
7471,NELLORE,Duttalur,BANDAKINDA PALLE,24,5,112,141,17,0,71,88,85,709,0,3160,3869,2543,2,0,4,6
7472,NELLORE,Duttalur,BHYRAVARAM,241,37,842,1120,117,11,380,508,517,7307,156,11603,19066,12777,32,0,12,44
7473,NELLORE,Duttalur,BODUVARIPALLE,117,21,408,546,61,4,227,292,272,3512,169,13625,17306,12370,10,0,29,39
7474,NELLORE,Duttalur,BRAHMESWARAM,36,6,208,250,25,1,149,175,177,1251,82,6989,8322,6692,3,0,5,8
7475,NELLORE,Duttalur,DUTTALUR,351,67,1276,1694,148,6,655,809,811,6907,251,37254,44412,32216,7,0,37,44
7476,NELLORE,Duttalur,KOTHAPETA,147,1,291,439,80,0,192,272,232,2451,0,6472,8923,5799,0,0,0,0
7477,NELLORE,Duttalur,NANDIPADU,156,34,651,841,62,0,418,480,445,1990,0,29105,31095,20832,1,0,73,74
7478,NELLORE,Duttalur,NARRAWADA,148,49,430,627,6,8,165,179,164,54,320,5183,5557,3724,0,0,0,0
7479,NELLORE,Duttalur,PAPAMPALLE,30,1,152,183,8,0,89,97,100,360,0,3508,3868,2809,0,0,0,0
7480,NELLORE,Duttalur,RACHAVARIPALLE,82,2,255,339,40,0,179,219,199,2070,0,7021,9091,6573,2,0,2,4
7481,NELLORE,Duttalur,REDLADINNE,120,6,220,346,55,1,126,182,180,3722,91,9587,13400,9580,13,0,30,43
7482,NELLORE,Duttalur,SOMALAREGADA,68,30,298,396,31,10,171,212,209,983,150,11027,12160,9354,0,0,12,12
7483,NELLORE,Duttalur,THEDDUPADU,164,1,182,347,68,0,97,165,149,3679,0,4990,8669,5577,8,0,5,13
7484,NELLORE,Duttalur,THIMMAPURAM,38,3,122,163,5,2,36,43,39,341,133,2238,2712,1851,1,0,1,2
7485,NELLORE,Duttalur,VENGANAPALEM,59,2,185,246,15,2,96,113,108,1013,142,6542,7697,5352,5,0,12,17
7486,NELLORE,Duttalur,VENKATAMPETA,90,14,323,427,46,8,199,253,252,3471,283,12151,15905,11599,13,0,25,38
7487,NELLORE,Duttalur,YERRUKOLLU,138,22,404,564,74,1,255,330,315,5516,83,15953,21552,15887,20,0,27,47
7488,NELLORE,Gudur,AYYAVARI PALEM,232,92,219,543,134,18,123,275,262,4155,758,6377,11290,6314,1,0,1,2
7489,NELLORE,Gudur,CHENNURU -I,234,34,338,606,65,5,46,116,105,1536,83,961,2580,1590,0,0,0,0
7490,NELLORE,Gudur,CHENNURU -II,807,510,667,1984,107,15,28,150,119,4737,839,955,6531,4126,13,0,0,13
7491,NELLORE,Gudur,DIVI PAELM,712,485,732,1929,91,39,105,235,199,3875,637,3204,7716,5551,11,0,6,17
7492,NELLORE,Gudur,KANDALI,318,19,134,471,72,7,24,103,96,1954,177,953,3084,2265,2,0,3,5
7493,NELLORE,Gudur,KANDRA,145,60,206,411,38,4,17,59,53,692,14,163,869,485,0,0,0,0
7494,NELLORE,Gudur,KOMMANETURU,331,58,230,619,215,40,156,411,401,14527,1932,9323,25782,14089,50,6,28,84
7495,NELLORE,Gudur,KONDAGUNTA,198,7,188,393,133,3,118,254,274,4885,52,4596,9533,6479,3,0,0,3
7496,NELLORE,Gudur,KUNDAKURU,106,80,172,358,79,35,130,244,212,3081,417,5196,8694,4708,3,0,1,4
7497,NELLORE,Gudur,MANGALAPUR,156,25,172,353,68,2,58,128,112,4392,37,2973,7402,5696,11,0,8,19
7498,NELLORE,Gudur,MEKANUR,127,34,296,457,72,1,163,236,232,3809,51,5862,9722,8948,1,0,1,2
7499,NELLORE,Gudur,MITTATHMAKURU,159,40,88,287,87,6,0,93,89,7222,246,0,7468,4645,28,0,0,28
7500,NELLORE,Gudur,NELLATURU,24,208,156,388,0,10,0,10,11,0,95,0,95,58,0,0,0,0
7501,NELLORE,Gudur,NERNOOR,289,152,213,654,48,32,55,135,123,963,946,1533,3442,1661,0,0,0,0
7502,NELLORE,Gudur,PAGADALA PALLE,86,80,184,350,37,1,25,63,55,425,5,156,586,363,0,0,0,0
7503,NELLORE,Gudur,PALICHERLA,154,111,177,442,114,9,103,226,229,6335,699,4454,11488,7496,17,5,2,24
7504,NELLORE,Gudur,POTUPALEM,191,147,119,457,105,44,38,187,169,4931,840,1469,7240,4701,1,0,1,2
7505,NELLORE,Gudur,RAMALINGA PURAM,108,62,234,404,3,0,15,18,18,52,0,62,114,64,0,0,0,0
7506,NELLORE,Gudur,SANTHADAS PALLE,224,23,367,614,72,0,3,75,72,1783,0,57,1840,932,0,0,0,0
7507,NELLORE,Gudur,THIMMASAMUDRAM,114,63,158,335,86,24,101,211,210,5867,1792,6622,14281,8673,17,9,28,54
7508,NELLORE,Gudur,VEDICHERLA,242,48,177,467,141,0,90,231,220,6552,0,3424,9976,6670,8,0,2,10
7509,NELLORE,Gudur,VENDODU,331,132,373,836,178,29,132,339,291,8162,380,5283,13825,8262,16,0,2,18
7510,NELLORE,Gudur,VINDURU,272,86,292,650,0,1,6,7,7,0,6,25,31,26,0,0,0,0
7511,NELLORE,Indukurpet,DEVISPET,67,56,208,331,1,0,11,12,12,6,0,78,84,66,0,0,0,0
7512,NELLORE,Indukurpet,GANGAPATNAM,234,109,750,1093,14,0,103,117,53,633,0,4487,5120,764,1,0,0,1
7513,NELLORE,Indukurpet,INDUKURPET BIT - I,266,62,543,871,23,4,38,65,38,1475,135,987,2597,1008,4,0,0,4
7514,NELLORE,Indukurpet,JAGADEVIPET,339,95,325,759,15,0,18,33,0,159,0,171,330,0,0,0,0,0
7515,NELLORE,Indukurpet,JANGAMVANI DORUVU,146,0,1,147,73,0,0,73,35,1882,0,0,1882,637,1,0,0,1
7516,NELLORE,Indukurpet,KOMARIKA,219,92,228,539,0,0,0,0,0,0,0,0,0,0,0,0,0,0
7517,NELLORE,Indukurpet,KORUTURU,119,99,377,595,8,12,21,41,1,48,72,126,246,6,0,0,0,0
7518,NELLORE,Indukurpet,KOTHURU,182,148,860,1190,4,0,25,29,17,58,0,421,479,220,0,0,0,0
7519,NELLORE,Indukurpet,KOTHURU CHINTHOPU,70,0,5,75,0,0,0,0,0,0,0,0,0,0,0,0,0,0
7520,NELLORE,Indukurpet,KUDITHIPALEM,208,115,221,544,80,2,13,95,44,3864,54,272,4190,1927,9,0,0,9
7521,NELLORE,Indukurpet,LEBUR BET-I,306,106,518,930,41,2,49,92,55,3366,131,2721,6218,2942,13,0,11,24
7522,NELLORE,Indukurpet,MUDIVARTHI PALEM,248,78,239,565,19,21,11,51,9,1081,485,593,2159,105,2,0,0,2
7523,NELLORE,Indukurpet,MYPADU,235,124,682,1041,20,61,18,99,16,1162,3978,851,5991,739,2,7,2,11
7524,NELLORE,Indukurpet,NARSAPURAM,214,32,186,432,3,5,27,35,9,58,87,471,616,65,0,0,0,0
7525,NELLORE,Indukurpet,NIDUMUSALI,158,46,130,334,0,0,0,0,0,0,0,0,0,0,0,0,0,0
7526,NELLORE,Indukurpet,PALLIPADU,155,19,238,412,0,0,0,0,0,0,0,0,0,0,0,0,0,0
7527,NELLORE,Indukurpet,PUNNUR,43,134,189,366,0,0,0,0,0,0,0,0,0,0,0,0,0,0
7528,NELLORE,Indukurpet,RAMUDUPALEM,125,88,226,439,1,0,0,1,1,20,0,0,20,10,0,0,0,0
7529,NELLORE,Indukurpet,RAVOORU,110,19,261,390,3,1,60,64,11,60,20,2871,2951,95,0,0,3,3
7530,NELLORE,Indukurpet,SOMARAJUPALLE,149,74,136,359,47,16,2,65,4,4259,1374,126,5759,119,29,1,1,31
7531,NELLORE,Jaladanki,ANNAVARAM,363,141,492,996,153,0,169,322,290,6328,0,4756,11084,6255,11,0,6,17
7532,NELLORE,Jaladanki,BRAHMANAKRAKA,853,322,966,2141,270,2,288,560,419,7309,109,10830,18248,10901,11,0,9,20
7533,NELLORE,Jaladanki,CHAMADALA,296,61,950,1307,116,3,216,335,311,1921,19,4574,6514,3736,0,0,3,3
7534,NELLORE,Jaladanki,CHINA KRAKA,185,35,356,576,117,1,194,312,274,5157,16,5471,10644,5837,1,0,0,1
7535,NELLORE,Jaladanki,CHODAVARAM,79,23,280,382,50,7,178,235,201,1277,103,3022,4402,2272,0,0,0,0
7536,NELLORE,Jaladanki,GATTUPALLI,479,122,428,1029,61,14,103,178,161,3761,185,3448,7394,4929,13,0,5,18
7537,NELLORE,Jaladanki,GOPANNAPALEM,34,41,242,317,19,0,131,150,129,581,0,3104,3685,2319,0,0,1,1
7538,NELLORE,Jaladanki,JALADANKI,288,445,1083,1816,1,21,348,370,348,5,1025,19279,20309,15167,0,5,50,55
7539,NELLORE,Jaladanki,JAMMALAPALEM,385,33,360,778,164,12,194,370,355,3705,392,4824,8921,5595,0,1,3,4
7540,NELLORE,Jaladanki,KAMMAVARIPALEM,250,29,296,575,70,0,94,164,132,1773,0,2614,4387,2178,1,0,4,5
7541,NELLORE,Jaladanki,KESAVARAM,224,137,436,797,19,2,44,65,69,712,40,905,1657,831,2,0,0,2
7542,NELLORE,Jaladanki,KOTHAPALEM,59,64,233,356,35,1,99,135,72,2440,20,3357,5817,3074,9,0,7,16
7543,NELLORE,Jaladanki,KRISHNAPADU,86,56,173,315,36,15,88,139,122,1205,353,3696,5254,3001,0,0,0,0
7544,NELLORE,Jaladanki,LINGA RAJU AGRAHARAM,247,11,247,505,84,6,110,200,173,2211,419,2746,5376,3244,0,1,0,1
7545,NELLORE,Jaladanki,Ramavarapppadu,0,0,0,0,0,0,0,0,0,0,0,0,0,0,0,0,0,0
7546,NELLORE,Jaladanki,SOMAVARAPPADU,113,13,203,329,69,3,89,161,131,2711,37,3262,6010,3250,2,0,1,3
7547,NELLORE,Jaladanki,VEMULPADU,188,71,281,540,44,1,170,215,194,959,33,7033,8025,4429,0,0,7,7
7548,NELLORE,Kaligiri,ANANTHAPURAM,111,0,307,418,67,0,88,155,141,2659,0,3297,5956,3344,2,0,2,4
7549,NELLORE,Kaligiri,CHINNA ANNALUR,223,9,385,617,95,2,123,220,201,1611,60,4689,6360,4486,0,0,6,6
7550,NELLORE,Kaligiri,GANGIREDDIPALEM,83,34,529,646,3,2,261,266,274,155,89,10276,10520,7031,1,0,11,12
7551,NELLORE,Kaligiri,GUDLADONA EAST,196,13,108,317,75,2,51,128,124,2442,22,1524,3988,2010,0,0,0,0
7552,NELLORE,Kaligiri,GUDLADONA WEST,77,17,229,323,53,5,47,105,102,2907,72,1345,4324,2731,6,0,0,6
7553,NELLORE,Kaligiri,KALIGIRI,292,46,812,1150,52,0,327,379,363,2631,0,15019,17650,14784,6,0,21,27
7554,NELLORE,Kaligiri,KAVALI MUSTHAPURAM,79,6,325,410,28,5,101,134,119,1601,276,6502,8379,5378,1,1,24,26
7555,NELLORE,Kaligiri,KRAKUTURU,86,24,659,769,58,14,410,482,446,3242,432,14363,18037,9959,9,0,20,29
7556,NELLORE,Kaligiri,KRISHNAREDDIPALEM,413,85,1033,1531,134,5,207,346,308,5839,211,12431,18481,10689,7,0,35,42
7557,NELLORE,Kaligiri,KUMMARAKONDURU,107,33,321,461,59,0,225,284,278,2946,0,15648,18594,11858,8,0,55,63
7558,NELLORE,Kaligiri,LAKSHMIPURAM,152,67,294,513,93,43,161,297,272,4171,2437,3431,10039,5424,5,9,2,16
7559,NELLORE,Kaligiri,NAGASAMUDRAM,143,22,673,838,64,1,311,376,381,2880,6,9261,12147,7337,2,0,6,8
7560,NELLORE,Kaligiri,PATIKOTA,84,3,99,186,51,0,52,103,91,2317,0,2654,4971,2709,4,0,6,10
7561,NELLORE,Kaligiri,PEDAKONDURU,98,100,468,666,23,18,178,219,210,892,808,6499,8199,5320,4,3,10,17
7562,NELLORE,Kaligiri,POLAMPADU,73,44,230,347,50,16,158,224,201,1468,512,6758,8738,5392,2,0,5,7
7563,NELLORE,Kaligiri,RAVULAKOLLU,32,6,78,116,21,1,64,86,78,1380,18,4449,5847,3578,3,0,16,19
7564,NELLORE,Kaligiri,SIDDANA KONDURU,117,35,168,320,75,6,44,125,110,4382,59,1205,5646,3387,10,0,1,11
7565,NELLORE,Kaligiri,TELLAPADU,105,13,394,512,15,1,67,83,78,633,1,1329,1963,1425,1,0,0,1
7566,NELLORE,Kaligiri,TURUPU DUBAGUNTA,35,53,142,230,18,10,74,102,105,489,385,5734,6608,5271,0,1,25,26
7567,NELLORE,Kaligiri,VEERANAKOLLU,147,12,493,652,16,0,119,135,131,469,0,2898,3367,2564,0,0,1,1
7568,NELLORE,Kaligiri,VELAGAPADU,144,20,429,593,68,0,230,298,280,1923,0,6193,8116,4792,0,0,4,4
7569,NELLORE,Kaligiri,YEPINAPI,64,7,134,205,46,0,92,138,123,3019,0,6539,9558,7187,1,0,15,16
7570,NELLORE,Kaligiri,YERUKALAREDDIPALEM,16,11,168,195,7,9,108,124,95,704,757,5197,6658,3590,4,2,13,19
7571,NELLORE,Kaluvoya,BADDEVOLU,263,18,148,429,22,0,0,22,20,323,0,0,323,254,0,0,0,0
7572,NELLORE,Kaluvoya,BALAGIRAOPET,48,63,135,246,28,15,45,88,87,1032,584,1519,3135,2488,0,0,3,3
7573,NELLORE,Kaluvoya,BRAHMANAPALLE,225,4,130,359,49,0,0,49,49,174,0,0,174,124,0,0,0,0
7574,NELLORE,Kaluvoya,CHEEPINAPI,111,69,280,460,9,0,56,65,61,82,0,1000,1082,825,0,0,0,0
7575,NELLORE,Kaluvoya,CHINA GOPAVARAM,91,55,340,486,0,0,109,109,69,0,0,5362,5362,2399,0,0,2,2
7576,NELLORE,Kaluvoya,CHINTALAPALEM,130,53,322,505,67,8,107,182,160,1267,291,5134,6692,3635,0,0,8,8
7577,NELLORE,Kaluvoya,CHINTALATMAKURU,89,67,320,476,46,0,100,146,116,564,0,2194,2758,1649,0,0,0,0
7578,NELLORE,Kaluvoya,CHOWTAPALLE,38,71,253,362,17,1,66,84,66,287,7,1595,1889,1014,0,0,0,0
7579,NELLORE,Kaluvoya,DACHURU,110,103,272,485,0,0,0,0,0,0,0,0,0,0,0,0,0,0
7580,NELLORE,Kaluvoya,KALUVOYA,622,93,1044,1759,96,0,83,179,171,2443,0,1257,3700,2820,0,0,0,0
7581,NELLORE,Kaluvoya,KANUPURUPALLE,149,45,358,552,39,5,155,199,172,633,55,5006,5694,3429,0,0,5,5
7582,NELLORE,Kaluvoya,KESAMANENIPALLE,122,26,316,464,65,2,139,206,182,1790,12,1523,3325,1945,0,0,0,0
7583,NELLORE,Kaluvoya,KULLURU,269,211,810,1290,5,8,223,236,191,131,243,4686,5060,2793,0,0,0,0
7584,NELLORE,Kaluvoya,MADANNAGARIPALLE,196,73,256,525,120,27,108,255,248,5757,1367,4382,11506,6433,9,1,2,12
7585,NELLORE,Kaluvoya,NUKANAPALLE,137,7,202,346,56,0,111,167,161,2370,0,2887,5257,3207,4,0,3,7
7586,NELLORE,Kaluvoya,PALLAKONDA,98,27,205,330,25,0,4,29,31,127,0,21,148,109,0,0,0,0
7587,NELLORE,Kaluvoya,PERAMAKONDA,84,25,240,349,34,0,98,132,115,854,0,4034,4888,3303,0,0,0,0
7588,NELLORE,Kaluvoya,TELUGURAYAPURAM,163,46,276,485,94,0,148,242,213,2044,0,4233,6277,4215,0,0,0,0
7589,NELLORE,Kaluvoya,THOPUGUNTA,125,65,404,594,29,1,87,117,102,402,88,2284,2774,2118,0,0,0,0
7590,NELLORE,Kaluvoya,UYYALAPALLE,225,7,339,571,46,0,140,186,183,1058,0,3921,4979,2891,0,0,0,0
7591,NELLORE,Kavali,AMUDALADINNE,24,41,479,544,11,0,302,313,298,113,0,5430,5543,3110,0,0,0,0
7592,NELLORE,Kavali,ANEMADUGU,293,83,434,810,29,19,21,69,59,313,230,264,807,450,0,0,0,0
7593,NELLORE,Kavali,ANNAGARI PALEM,369,94,1892,2355,222,10,486,718,663,7083,136,7903,15122,9493,4,1,1,6
7594,NELLORE,Kavali,BUDAMGUNTA,299,19,179,497,0,0,0,0,0,0,0,0,0,0,0,0,0,0
7595,NELLORE,Kavali,CHALAMCHERLA,273,57,479,809,134,12,214,360,353,5360,264,8180,13804,8230,6,0,6,12
7596,NELLORE,Kavali,CHENCHUGANIPALEM,139,24,620,783,39,1,149,189,145,682,5,1561,2248,1318,0,0,0,0
7597,NELLORE,Kavali,CHENNAYAPALEM,153,73,437,663,32,6,232,270,223,679,153,5956,6788,3801,0,0,5,5
7598,NELLORE,Kavali,CHOWDARIPALEM,47,0,109,156,0,0,6,6,5,0,0,120,120,74,0,0,0,0
7599,NELLORE,Kavali,GOWRAVARAM,365,73,133,571,138,7,39,184,142,8501,247,2163,10911,5784,30,0,3,33
7600,NELLORE,Kavali,KOTHAPALLE,195,60,305,560,37,6,131,174,139,463,233,4873,5569,3393,0,0,1,1
7601,NELLORE,Kavali,LAXMIPURAM,50,29,91,170,36,6,64,106,98,2937,120,4356,7413,3579,14,0,14,28
7602,NELLORE,Kavali,MADDURUPADU,177,95,279,551,0,10,1,11,11,0,604,86,690,420,0,0,0,0
7603,NELLORE,Kavali,MANNANGIDINNE,229,40,251,520,88,0,79,167,141,4897,0,3077,7974,5008,12,0,1,13
7604,NELLORE,Kavali,MUSUNURU,493,269,366,1128,0,0,0,0,0,0,0,0,0,0,0,0,0,0
7605,NELLORE,Kavali,PEDAPATTAPU PALEM,74,0,858,932,0,0,182,182,167,0,0,1383,1383,1102,0,0,0,0
7606,NELLORE,Kavali,R.C. PALEM,331,24,123,478,132,0,23,155,98,5668,0,1077,6745,2062,3,0,2,5
7607,NELLORE,Kavali,RUDRAKOTA,440,186,788,1414,122,0,101,223,207,3114,0,1770,4884,3760,0,0,0,0
7608,NELLORE,Kavali,SARVAYAPALEM,154,10,630,794,0,0,349,349,332,0,0,13406,13406,10379,0,0,27,27
7609,NELLORE,Kavali,SIRIPURAM,245,49,183,477,121,21,66,208,197,5279,1053,3547,9879,7201,8,0,9,17
7610,NELLORE,Kavali,THALLAPALEM,631,86,849,1566,350,1,536,887,765,14187,31,24413,38631,18845,13,0,31,44
7611,NELLORE,Kavali,THUMMALAPENTA,100,62,1790,1952,58,1,1133,1192,1233,916,15,19641,20572,14826,0,0,0,0
7612,NELLORE,Kodavalur,ALURPADU,198,34,109,341,0,0,0,0,0,0,0,0,0,0,0,0,0,0
7613,NELLORE,Kodavalur,BASAVAIPALEM,58,37,88,183,0,0,3,3,1,0,0,48,48,8,0,0,0,0
7614,NELLORE,Kodavalur,BODDUVARIPALEM,28,8,25,61,0,0,0,0,0,0,0,0,0,0,0,0,0,0
7615,NELLORE,Kodavalur,DAMEGUNTA,35,91,127,253,14,0,5,19,10,242,0,38,280,116,0,0,0,0
7616,NELLORE,Kodavalur,GANDAVARAM,230,189,255,674,76,1,24,101,60,1457,20,823,2300,891,1,0,0,1
7617,NELLORE,Kodavalur,GANDAVARAM (SOUTH),131,37,198,366,0,0,0,0,0,0,0,0,0,0,0,0,0,0
7618,NELLORE,Kodavalur,GUNDALAMMAPALEM,123,124,49,296,0,0,0,0,0,0,0,0,0,0,0,0,0,0
7619,NELLORE,Kodavalur,KAMMAPALEM,262,68,192,522,78,0,7,85,65,1180,0,33,1213,623,0,0,0,0
7620,NELLORE,Kodavalur,KODAVALUR,291,314,257,862,7,6,27,40,24,43,138,547,728,387,0,0,0,0
7621,NELLORE,Kodavalur,KOTHAVANGALLU,380,202,380,962,80,19,32,131,96,1588,946,801,3335,1445,0,0,0,0
7622,NELLORE,Kodavalur,MANEGUNTAPADU,66,38,10,114,33,0,1,34,30,750,0,12,762,408,0,0,0,0
7623,NELLORE,Kodavalur,MIKKILIM PETA,297,10,93,400,50,0,2,52,37,310,0,6,316,174,0,0,0,0
7624,NELLORE,Kodavalur,NAIDUPALEM,146,98,68,312,11,3,12,26,21,128,26,183,337,204,0,0,0,0
7625,NELLORE,Kodavalur,NORTH RAJUPALEM,279,128,297,704,12,12,4,28,23,411,487,202,1100,623,2,1,0,3
7626,NELLORE,Kodavalur,PEYYALA PALEM,99,0,182,281,4,0,13,17,13,180,0,403,583,273,0,0,1,1
7627,NELLORE,Kodavalur,RAMANNAPALEM,196,154,160,510,8,3,5,16,14,122,60,84,266,148,0,0,0,0
7628,NELLORE,Kodavalur,REGADICHELIKA,60,106,374,540,0,0,1,1,1,0,0,5,5,5,0,0,0,0
7629,NELLORE,Kodavalur,SOUTH HARIJANAWADA,195,98,106,399,69,2,20,91,67,1834,52,189,2075,1068,0,0,0,0
7630,NELLORE,Kodavalur,TALAMANCHI,199,175,364,738,0,0,0,0,0,0,0,0,0,0,0,0,0,0
7631,NELLORE,Kodavalur,VENKANNAPURAM,101,0,72,173,0,0,4,4,4,0,0,80,80,45,0,0,0,0
7632,NELLORE,Kodavalur,YELLAYAPALEM,519,344,568,1431,181,14,115,310,270,5245,204,3054,8503,5362,3,0,0,3
7633,NELLORE,Kondapuram,BHIMAVARAPPADU,126,4,202,332,38,1,75,114,109,1751,36,4529,6316,3299,4,0,13,17
7634,NELLORE,Kondapuram,CHINTALADEVI,105,57,557,719,63,19,252,334,297,3506,391,12413,16310,10019,9,1,28,38
7635,NELLORE,Kondapuram,GANUGAPENTA,220,14,362,596,95,0,144,239,195,3884,0,3295,7179,3575,1,0,0,1
7636,NELLORE,Kondapuram,GARIMENAPENTA,343,51,897,1291,120,11,190,321,309,4463,106,4382,8951,6633,6,0,2,8
7637,NELLORE,Kondapuram,GOTTIGUNDALA,197,35,770,1002,2,0,79,81,73,12,0,323,335,264,0,0,0,0
7638,NELLORE,Kondapuram,GOTTIGUNDALA PALEM,57,0,124,181,29,0,30,59,55,708,0,342,1050,679,0,0,0,0
7639,NELLORE,Kondapuram,GUDAVALLUR,388,92,657,1137,117,10,187,314,266,6512,353,5605,12470,7040,10,0,4,14
7640,NELLORE,Kondapuram,ISKADAMERLA,150,34,440,624,70,1,210,281,283,2967,24,10001,12992,7792,4,0,11,15
7641,NELLORE,Kondapuram,KOMMI,460,43,874,1377,97,1,263,361,323,5374,48,8383,13805,9531,5,0,1,6
7642,NELLORE,Kondapuram,MARRIGUNTA,193,4,136,333,66,2,81,149,133,3358,151,4729,8238,5752,4,0,5,9
7643,NELLORE,Kondapuram,NEKUNAMPETA,272,11,435,718,75,0,77,152,142,3752,0,2311,6063,3738,6,0,0,6
7644,NELLORE,Kondapuram,PARLAPALLE,84,2,232,318,37,0,113,150,122,1531,0,4057,5588,3570,3,0,3,6
7645,NELLORE,Kondapuram,RENAMALA,126,0,405,531,51,0,171,222,200,2153,0,7357,9510,5242,3,0,7,10
7646,NELLORE,Kondapuram,SAIPET,413,106,1328,1847,108,1,380,489,412,2439,25,7706,10170,5745,0,0,3,3
7647,NELLORE,Kondapuram,SATYAVOLU,191,18,693,902,43,6,241,290,243,579,119,4489,5187,2909,0,0,0,0
7648,NELLORE,Kondapuram,SETTIPALEM,64,10,233,307,26,0,20,46,45,1561,0,1552,3113,1838,2,0,5,7
7649,NELLORE,Kondapuram,THURPUYERRABALLE,258,37,1024,1319,60,6,171,237,240,1300,40,5265,6605,5460,1,0,0,1
7650,NELLORE,Kondapuram,UPPULUR,38,10,300,348,9,0,75,84,86,104,0,1681,1785,1131,0,0,0,0
7651,NELLORE,Kondapuram,VELIGANDLA,110,8,279,397,26,3,100,129,116,767,147,3690,4604,2766,2,0,5,7
7652,NELLORE,Kota,ALLAMPADU,204,29,176,409,106,0,19,125,113,1585,0,227,1812,781,0,0,0,0
7653,NELLORE,Kota,CHENDODU,123,239,325,687,31,0,19,50,44,201,0,153,354,191,0,0,0,0
7654,NELLORE,Kota,CHITTEDU,364,149,672,1185,85,0,213,298,215,3034,0,8818,11852,5801,6,0,9,15
7655,NELLORE,Kota,GUDALI,325,309,543,1177,64,34,132,230,203,1801,573,4812,7186,4399,3,0,8,11
7656,NELLORE,Kota,JARUGUMALLI,163,34,116,313,56,0,28,84,55,1038,0,245,1283,517,0,0,0,0
7657,NELLORE,Kota,KARLAPUDI,164,142,70,376,133,0,0,133,128,3537,0,0,3537,1873,1,0,0,1
7658,NELLORE,Kota,KESAVARAM,173,75,623,871,69,17,214,300,227,3435,419,7331,11185,6254,6,0,17,23
7659,NELLORE,Kota,KOKKUPADU,223,94,155,472,46,4,3,53,48,312,56,44,412,247,0,0,0,0
7660,NELLORE,Kota,KOTA,412,210,196,818,210,1,12,223,216,2850,4,35,2889,2565,0,0,0,0
7661,NELLORE,Kota,KOTHAPATNAM,382,176,604,1162,215,30,172,417,355,8012,632,4344,12988,7874,10,0,0,10
7662,NELLORE,Kota,MADDALI,212,59,280,551,0,0,0,0,0,0,0,0,0,0,0,0,0,0
7663,NELLORE,Kota,N P KOTHAPALEM,593,122,155,870,239,1,17,257,264,4995,29,367,5391,3268,0,0,0,0
7664,NELLORE,Kota,PUTCHALAPALLI,100,19,135,254,56,0,0,56,47,1379,0,0,1379,751,0,0,0,0
7665,NELLORE,Kota,RUDRAVARAM,67,2,66,135,49,1,0,50,48,1551,12,0,1563,770,0,0,0,0
7666,NELLORE,Kota,SIDDAVARAM,328,187,149,664,157,78,10,245,231,3224,2965,212,6401,4086,0,0,0,0
7667,NELLORE,Kota,THIMMANAIDU PALEM,211,29,114,354,0,0,0,0,0,0,0,0,0,0,0,0,0,0
7668,NELLORE,Kota,THINNELA PUDI,363,108,149,620,0,3,0,3,3,0,87,0,87,47,0,0,0,0
7669,NELLORE,Kota,UNUGUNTA PALEM,303,128,264,695,107,8,36,151,143,3008,547,1563,5118,3429,0,0,2,2
7670,NELLORE,Kota,UTHAMANELLORE,127,118,195,440,58,8,61,127,113,2362,156,1699,4217,2972,1,0,0,1
7671,NELLORE,Kota,VANJIVAKA,298,60,101,459,193,32,3,228,217,4700,2106,97,6903,3875,0,7,0,7
7672,NELLORE,Kota,VENKANNAPALEM,189,198,456,843,78,56,116,250,219,2640,1463,2173,6276,4166,2,2,0,4
7673,NELLORE,Kovur,CHERLOPALEM,244,102,71,417,7,0,1,8,8,110,0,20,130,80,0,0,0,0
7674,NELLORE,Kovur,GANGAVARAM,305,157,153,615,5,3,4,12,14,85,45,53,183,129,0,0,0,0
7675,NELLORE,Kovur,INAMADUGU,512,153,334,999,10,0,11,21,23,180,0,200,380,250,0,0,0,0
7676,NELLORE,Kovur,KOVUR,855,451,537,1843,11,37,17,65,49,762,2375,1129,4266,2280,1,6,2,9
7677,NELLORE,Kovur,LEGUNTAPADU,193,91,132,416,6,9,15,30,25,75,173,268,516,267,0,0,0,0
7678,NELLORE,Kovur,MODEGUNTA,174,1,71,246,4,0,1,5,6,65,0,20,85,50,0,0,0,0
7679,NELLORE,Kovur,PADUGUPADU,144,295,132,571,3,1,5,9,7,46,5,63,114,70,0,0,0,0
7680,NELLORE,Kovur,PATUR,264,140,370,774,16,0,5,21,21,688,0,149,837,415,0,0,0,0
7681,NELLORE,Kovur,POTHIREDDIPALEM,335,294,308,937,5,6,6,17,12,45,44,24,113,78,0,0,0,0
7682,NELLORE,Kovur,VEGURU,717,238,479,1434,142,8,21,171,146,2778,164,363,3305,1895,2,0,0,2
7683,NELLORE,Manubolu,AKKAMPET,109,38,192,339,20,0,44,64,56,150,0,675,825,474,0,0,0,0
7684,NELLORE,Manubolu,BADDEVOLU,96,22,165,283,8,0,19,27,24,391,0,780,1171,579,0,0,2,2
7685,NELLORE,Manubolu,BANDE PALLE,44,3,171,218,23,1,95,119,79,774,23,3338,4135,1781,0,0,3,3
7686,NELLORE,Manubolu,CHARLO PALLE,185,65,143,393,67,3,23,93,78,1204,90,528,1822,854,0,0,0,0
7687,NELLORE,Manubolu,CHERUKUMUDI,323,6,135,464,199,0,43,242,211,8485,0,1013,9498,4039,5,0,0,5
7688,NELLORE,Manubolu,GURIVINDA PUDI,118,10,124,252,0,0,0,0,0,0,0,0,0,0,0,0,0,0
7689,NELLORE,Manubolu,JATLA KONDUR,169,96,121,386,48,16,17,81,63,989,316,303,1608,732,0,0,0,0
7690,NELLORE,Manubolu,KAGITHALAPURU,232,38,112,382,0,0,0,0,0,0,0,0,0,0,0,0,0,0
7691,NELLORE,Manubolu,KATTUVAPALLE,214,39,73,326,25,0,8,33,22,467,0,456,923,375,0,0,0,0
7692,NELLORE,Manubolu,KOLANUKUDURU,114,35,132,281,0,0,0,0,0,0,0,0,0,0,0,0,0,0
7693,NELLORE,Manubolu,KOMMALAPUDI,217,38,132,387,110,0,51,161,139,2270,0,2064,4334,2083,0,0,0,0
7694,NELLORE,Manubolu,LAXMINARASA PURAM,43,95,52,190,22,15,3,40,28,82,79,13,174,75,0,0,0,0
7695,NELLORE,Manubolu,MADAMANUR,251,251,491,993,74,29,87,190,144,3572,1609,1394,6575,2676,7,1,0,8
7696,NELLORE,Manubolu,MANUBOLU,373,288,344,1005,0,0,0,0,0,0,0,0,0,0,0,0,0,0
7697,NELLORE,Manubolu,PIDURU,159,137,77,373,4,3,0,7,5,64,34,0,98,48,0,0,0,0
7698,NELLORE,Manubolu,PIDURUPALEM,58,39,108,205,0,22,1,23,22,0,995,38,1033,507,0,4,0,4
7699,NELLORE,Manubolu,VADLAPUDI,78,51,279,408,41,0,114,155,118,1976,0,4070,6046,2243,1,0,3,4
7700,NELLORE,Manubolu,VEERAMPALLI,346,62,596,1004,100,0,111,211,163,4498,0,3406,7904,3918,9,0,2,11
7701,NELLORE,Manubolu,VENKANAPALEM,285,32,49,366,100,16,0,116,93,3683,359,0,4042,2133,4,0,0,4
7702,NELLORE,Marripadu,ALLAMPADU,56,13,223,292,13,3,102,118,122,397,226,6968,7591,5556,0,1,20,21
7703,NELLORE,Marripadu,BHEEMAVARAM,79,2,381,462,32,1,244,277,290,827,76,11157,12060,8896,0,0,14,14
7704,NELLORE,Marripadu,BRAHMANAPALLE,202,22,473,697,14,10,234,258,289,357,597,8060,9014,5787,0,0,0,0
7705,NELLORE,Marripadu,BUDAWADA,139,33,454,626,10,8,162,180,200,164,110,3437,3711,2617,0,0,0,0
7706,NELLORE,Marripadu,CHABOLU,249,19,300,568,126,12,180,318,384,9140,350,8387,17877,10495,35,1,20,56
7707,NELLORE,Marripadu,CHILAKAPADU,63,5,216,284,16,4,134,154,156,201,225,8006,8432,5188,0,0,17,17
7708,NELLORE,Marripadu,CHINAMACHANURU,204,64,977,1245,68,18,387,473,480,1202,364,11434,13000,9071,0,0,3,3
7709,NELLORE,Marripadu,CHUNCHULUR,252,4,371,627,138,0,162,300,310,6569,0,5098,11667,7280,13,0,0,13
7710,NELLORE,Marripadu,D.C. PALLE,128,21,515,664,50,3,309,362,365,1426,50,4707,6183,4292,5,0,1,6
7711,NELLORE,Marripadu,EPILAGUNTA,37,5,288,330,13,0,190,203,215,387,0,6633,7020,5836,0,0,8,8
7712,NELLORE,Marripadu,IRALAPADU,147,12,481,640,28,2,203,233,233,1343,199,11680,13222,9122,2,1,21,24
7713,NELLORE,Marripadu,KAMPASAMUDRAM,226,1,463,690,90,1,321,412,440,8583,60,20737,29380,16002,40,0,26,66
7714,NELLORE,Marripadu,KETHIGUNTA,111,15,215,341,43,0,106,149,153,2423,0,2780,5203,3256,9,0,0,9
7715,NELLORE,Marripadu,KHADARPUR,102,7,313,422,51,5,190,246,243,2089,165,5874,8128,5383,3,0,0,3
7716,NELLORE,Marripadu,MARRIPADU,205,1,420,626,56,0,235,291,289,1521,0,10861,12382,8203,0,0,7,7
7717,NELLORE,Marripadu,NAGINENIGUNTA,276,6,307,589,149,0,169,318,342,7726,0,9667,17393,9937,7,0,10,17
7718,NELLORE,Marripadu,NANDAVARAM,25,54,670,749,7,29,280,316,301,245,838,9649,10732,7712,0,1,1,2
7719,NELLORE,Marripadu,PADAMATINAIDUPALLE,296,58,572,926,81,9,130,220,251,2632,219,4774,7625,4259,0,0,1,1
7720,NELLORE,Marripadu,PEGALLAPADU,67,16,236,319,46,5,103,154,170,4027,389,8371,12787,8423,22,1,28,51
7721,NELLORE,Marripadu,PONGURU,189,4,489,682,71,2,319,392,406,1962,68,12380,14410,9244,0,0,12,12
7722,NELLORE,Marripadu,PONGURU KANDRIKA,3,16,206,225,0,7,123,130,135,0,282,7130,7412,5136,0,0,9,9
7723,NELLORE,Marripadu,RAMANAIDUPALLE,204,10,444,658,96,6,306,408,403,3970,129,16442,20541,12538,1,0,23,24
7724,NELLORE,Marripadu,SINGANAPALLE,120,22,408,550,83,9,286,378,366,5247,405,18525,24177,15466,11,1,51,63
7725,NELLORE,Marripadu,TIKKAVARAM,138,63,217,418,63,32,27,122,111,3013,1437,1191,5641,4159,5,2,1,8
7726,NELLORE,Muthukur,BRAHMADEVAM,293,179,547,1019,105,0,33,138,89,2526,0,710,3236,1355,0,0,1,1
7727,NELLORE,Muthukur,DAMMAYAPALEM,215,0,173,388,3,0,1,4,4,60,0,20,80,40,0,0,0,0
7728,NELLORE,Muthukur,DORUVULAPALEM,536,133,754,1423,157,0,22,179,37,3384,0,319,3703,579,1,0,0,1
7729,NELLORE,Muthukur,DUVVURUVARIPALEM,4,30,196,230,2,0,5,7,4,20,0,52,72,37,0,0,0,0
7730,NELLORE,Muthukur,EPURU,49,14,209,272,36,4,67,107,82,1685,29,693,2407,1357,4,0,0,4
7731,NELLORE,Muthukur,KRISHNAPATNAM,361,146,1357,1864,0,0,0,0,0,0,0,0,0,0,0,0,0,0
7732,NELLORE,Muthukur,MAMIDIPUDI,201,21,111,333,49,2,16,67,5,1338,30,128,1496,122,0,0,0,0
7733,NELLORE,Muthukur,MOLLUR,123,8,111,242,65,2,78,145,126,1174,6,1420,2600,1416,0,0,0,0
7734,NELLORE,Muthukur,MUSUNURIVARIPALEM,54,46,357,457,0,1,53,54,30,0,8,700,708,204,0,0,0,0
7735,NELLORE,Muthukur,MUTHUKUR,727,363,847,1937,0,0,0,0,0,0,0,0,0,0,0,0,0,0
7736,NELLORE,Muthukur,NARIKELLAPALLE,213,155,342,710,89,4,23,116,103,1381,32,301,1714,914,0,0,0,0
7737,NELLORE,Muthukur,NELATURU,170,48,564,782,0,0,0,0,0,0,0,0,0,0,0,0,0,0
7738,NELLORE,Muthukur,PANTAPALEM,210,128,253,591,79,0,50,129,110,2917,0,901,3818,2018,4,0,0,4
7739,NELLORE,Muthukur,PATURIVARIKHANDRIGA,0,3,53,56,0,0,0,0,0,0,0,0,0,0,0,0,0,0
7740,NELLORE,Muthukur,PIDATAPOLUR,262,117,838,1217,68,0,36,104,92,1558,0,1527,3085,1741,0,0,1,1
7741,NELLORE,Muthukur,POLAMRAJUGUNTA,61,23,41,125,43,9,18,70,56,670,66,290,1026,596,0,0,0,0
7742,NELLORE,Muthukur,POTTAMPADU,125,76,164,365,74,25,53,152,125,1197,676,3525,5398,2769,0,0,10,10
7743,NELLORE,Muthukur,PYNAMPURAM,346,94,114,554,0,0,0,0,0,0,0,0,0,0,0,0,0,0
7744,NELLORE,Muthukur,TALLAPUDI,135,23,243,401,51,3,94,148,107,1867,54,2000,3921,1570,0,0,0,0
7745,NELLORE,Muthukur,VALLURU,133,103,326,562,2,0,19,21,18,27,0,429,456,222,0,0,0,0
7746,NELLORE,Naidupeta,ANNAMEDU,758,191,356,1305,209,54,147,410,283,9858,1010,1929,12797,6503,17,0,0,17
7747,NELLORE,Naidupeta,ARAVAPERMIDI,237,89,71,397,122,41,39,202,204,2748,1722,1164,5634,2952,0,1,0,1
7748,NELLORE,Naidupeta,BHEEMAVARAM,247,151,141,539,63,42,13,118,103,439,715,104,1258,789,0,0,0,0
7749,NELLORE,Naidupeta,CHIGURUPADU,167,142,131,440,97,45,49,191,169,2611,440,606,3657,1859,0,0,0,0
7750,NELLORE,Naidupeta,CHILLAMATHUR,248,104,191,543,111,10,92,213,179,3761,133,2307,6201,3714,0,0,0,0
7751,NELLORE,Naidupeta,DWARAKAPURAM,145,28,140,313,106,1,48,155,135,3335,22,999,4356,2298,1,0,1,2
7752,NELLORE,Naidupeta,GOTTIPROLU,519,102,373,994,232,25,51,308,255,4908,579,1187,6674,3487,0,0,0,0
7753,NELLORE,Naidupeta,JUVVALAPALEM,598,430,95,1123,104,76,39,219,214,3376,4968,3225,11569,8280,4,13,15,32
7754,NELLORE,Naidupeta,KALLIPEDU,275,75,297,647,180,25,173,378,356,4944,376,4159,9479,5052,0,0,0,0
7755,NELLORE,Naidupeta,KAPULURU,325,316,308,949,13,89,27,129,102,404,1332,375,2111,930,0,0,0,0
7756,NELLORE,Naidupeta,KUCHIWADA,262,18,92,372,155,2,37,194,143,3234,10,681,3925,2013,0,0,0,0
7757,NELLORE,Naidupeta,MARLAPALLE,132,1,167,300,71,0,109,180,156,3181,0,4116,7297,4191,3,0,1,4
7758,NELLORE,Naidupeta,MENAKURU,559,140,896,1595,28,30,143,201,159,1644,986,7626,10256,5090,6,0,14,20
7759,NELLORE,Naidupeta,NAIDUPETA,1044,336,713,2093,0,0,0,0,0,0,0,0,0,0,0,0,0,0
7760,NELLORE,Naidupeta,PANDLURU,306,187,412,905,71,66,177,314,282,596,1713,3377,5686,3164,0,0,0,0
7761,NELLORE,Naidupeta,PUDERU,271,120,422,813,123,59,229,411,376,4698,3077,9078,16853,9603,4,3,0,7
7762,NELLORE,Naidupeta,PUDURU,365,359,1057,1781,57,10,394,461,410,2877,671,12471,16019,10044,4,5,56,65
7763,NELLORE,Naidupeta,THIMMAJI KHANDRIKA,106,1,97,204,59,0,66,125,71,3417,0,2885,6302,2622,8,0,0,8
7764,NELLORE,Naidupeta,VINNAMALA,1169,190,138,1497,282,3,25,310,286,8734,74,1368,10176,7252,6,0,1,7
7765,NELLORE,Nellore,ALLIPURAM,110,6,107,223,0,0,0,0,0,0,0,0,0,0,0,0,0,0
7766,NELLORE,Nellore,AMANCHERLA,446,199,559,1204,187,3,42,232,214,5574,28,515,6117,3302,1,0,0,1
7767,NELLORE,Nellore,AMBAPURAM,89,65,122,276,0,0,0,0,0,0,0,0,0,0,0,0,0,0
7768,NELLORE,Nellore,BUJA BUJA NELLORE,123,159,241,523,0,0,0,0,0,0,0,0,0,0,0,0,0,0
7769,NELLORE,Nellore,CHINTAREDDIPALEM,530,89,174,793,0,0,2,2,1,0,0,4,4,2,0,0,0,0
7770,NELLORE,Nellore,DEVARIPALEM,101,116,117,334,58,20,42,120,111,4365,1558,2524,8447,5189,11,4,3,18
7771,NELLORE,Nellore,DONTHALI,130,171,119,420,25,0,31,56,34,723,0,1560,2283,1138,0,0,1,1
7772,NELLORE,Nellore,GOLLA KANDUKUR,123,6,268,397,73,0,87,160,159,1014,0,864,1878,1089,0,0,0,0
7773,NELLORE,Nellore,GUDIPALLIPADU,185,55,136,376,0,0,0,0,0,0,0,0,0,0,0,0,0,0
7774,NELLORE,Nellore,GUNDLAPALEM,89,33,179,301,0,0,0,0,0,0,0,0,0,0,0,0,0,0
7775,NELLORE,Nellore,KAKUPALLE-I,173,70,139,382,0,5,1,6,5,0,22,3,25,14,0,0,0,0
7776,NELLORE,Nellore,KALIVELAPALEM,127,35,192,354,18,0,60,78,10,561,0,2012,2573,270,0,0,0,0
7777,NELLORE,Nellore,KALLLURPALLE,305,49,171,525,0,0,0,0,0,0,0,0,0,0,0,0,0,0
7778,NELLORE,Nellore,KANDAMURU,183,84,213,480,105,11,2,118,79,2708,42,10,2760,1084,0,0,0,0
7779,NELLORE,Nellore,KANUPARTHIPADU,259,89,79,427,0,0,0,0,0,0,0,0,0,0,0,0,0,0
7780,NELLORE,Nellore,KODURUPADU,243,83,86,412,0,0,1,1,0,0,0,10,10,0,0,0,0,0
7781,NELLORE,Nellore,KOMARAPUDI,124,23,158,305,96,0,3,99,97,2292,0,44,2336,1344,0,0,0,0
7782,NELLORE,Nellore,KONDLAPUDI,146,204,182,532,59,13,45,117,45,3982,802,3201,7985,2745,9,3,3,15
7783,NELLORE,Nellore,KOTHA VELLANTI,207,170,130,507,113,1,5,119,119,1510,22,62,1594,913,0,0,0,0
7784,NELLORE,Nellore,KOTHURU,35,11,121,167,0,0,0,0,0,0,0,0,0,0,0,0,0,0
7785,NELLORE,Nellore,MADARAJAGUDUR,154,80,471,705,36,22,58,116,80,967,536,350,1853,1036,0,0,0,0
7786,NELLORE,Nellore,MULUMUDI,278,44,652,974,101,2,166,269,196,2116,62,4940,7118,3215,0,0,1,1
7787,NELLORE,Nellore,NARAYANAREDDIPET,3,3,391,397,0,0,0,0,0,0,0,0,0,0,0,0,0,0
7788,NELLORE,Nellore,NAVALAK GARDENS,116,170,134,420,0,0,0,0,0,0,0,0,0,0,0,0,0,0
7789,NELLORE,Nellore,PATHA VELLANTI,196,10,205,411,121,0,118,239,221,3920,0,1371,5291,3404,2,0,0,2
7790,NELLORE,Nellore,PEDDA CHERUKUR,187,132,216,535,2,4,3,9,10,40,80,48,168,118,0,0,0,0
7791,NELLORE,Nellore,PENUBARTHI,183,67,224,474,51,21,88,160,39,1302,534,2024,3860,660,0,0,0,0
7792,NELLORE,Nellore,POTTEPALEM,267,41,204,512,0,0,0,0,0,0,0,0,0,0,0,0,0,0
7793,NELLORE,Nellore,SAJJAPURAM,47,31,166,244,31,1,90,122,132,789,30,2096,2915,1766,0,0,0,0
7794,NELLORE,Nellore,SOUTH MOPUR,278,165,762,1205,124,48,22,194,159,4549,1538,256,6343,3462,0,0,0,0
7795,NELLORE,Nellore,UPPUTURU,64,11,175,250,40,3,75,118,94,2186,125,3193,5504,3139,6,1,7,14
7796,NELLORE,Nellore,VISAVAVILETTIPADU,208,68,255,531,0,0,0,0,0,0,0,0,0,0,0,0,0,0
7797,NELLORE,Ojili,ARIMANIPADU,73,106,525,704,33,2,118,153,141,665,6,1488,2159,1376,0,0,0,0
7798,NELLORE,Ojili,ATHIVARAM,194,47,321,562,133,27,242,402,365,5548,804,9085,15437,9035,1,0,6,7
7799,NELLORE,Ojili,BHATLAKANUPURU,105,123,162,390,6,14,116,136,106,47,213,2685,2945,1587,0,0,0,0
7800,NELLORE,Ojili,BHUVANAGIRIPALEM,58,47,137,242,43,27,113,183,184,2134,819,6086,9039,5908,1,0,8,9
7801,NELLORE,Ojili,CHILLAMANUCHENU,118,59,178,355,44,0,30,74,78,1010,0,344,1354,929,0,0,0,0
7802,NELLORE,Ojili,GRADDAGUNTA,207,134,223,564,123,57,115,295,246,2783,2748,1507,7038,4236,0,4,0,4
7803,NELLORE,Ojili,GURRAMKONDA,100,44,136,280,47,3,55,105,95,1872,82,2125,4079,3012,2,0,1,3
7804,NELLORE,Ojili,INUGUNTA,345,51,196,592,254,17,113,384,362,11303,471,2804,14578,7723,22,0,0,22
7805,NELLORE,Ojili,KARABALLAVOLU,117,32,160,309,26,0,0,26,21,90,0,0,90,57,0,0,0,0
7806,NELLORE,Ojili,KONDAVALLI PADU,112,64,123,299,91,13,59,163,151,4712,534,2628,7874,4535,4,1,2,7
7807,NELLORE,Ojili,KOTHA CHERUVU,67,46,41,154,45,26,1,72,73,1628,2717,10,4355,2247,0,17,0,17
7808,NELLORE,Ojili,KUNDAM,66,103,118,287,42,16,45,103,107,1939,467,1875,4281,2327,2,0,0,2
7809,NELLORE,Ojili,KURUGONDA,386,164,416,966,195,39,65,299,266,2949,461,530,3940,2517,0,0,0,0
7810,NELLORE,Ojili,MACHAVARAM,100,12,74,186,71,0,44,115,103,3213,0,1728,4941,3717,2,0,1,3
7811,NELLORE,Ojili,MANAMALA,76,112,152,340,48,29,48,125,85,1494,752,1255,3501,1930,0,0,0,0
7812,NELLORE,Ojili,MANAVALI,134,0,143,277,74,0,84,158,126,2776,0,3879,6655,4023,1,0,4,5
7813,NELLORE,Ojili,MUMMAYAPALEM,93,60,90,243,73,0,51,124,113,4327,0,1888,6215,4548,11,0,2,13
7814,NELLORE,Ojili,NEMALLAPUDI,85,22,168,275,69,20,114,203,200,2841,839,4232,7912,4605,1,0,3,4
7815,NELLORE,Ojili,OJILI,174,192,327,693,116,79,199,394,353,2574,2132,6304,11010,6394,0,0,0,0
7816,NELLORE,Ojili,PEDA PARIYA,135,43,129,307,19,0,47,66,59,157,0,368,525,323,0,0,0,0
7817,NELLORE,Ojili,PUNNEPALLE,127,70,155,352,0,14,0,14,12,0,115,0,115,60,0,0,0,0
7818,NELLORE,Ojili,RACHAPAELM,94,85,184,363,59,35,94,188,184,3345,1097,4326,8768,6346,13,0,2,15
7819,NELLORE,Ojili,RAVIPADU,72,33,155,260,40,16,100,156,150,467,202,3206,3875,2268,0,0,1,1
7820,NELLORE,Ojili,SAGUTURU,195,46,260,501,118,7,144,269,264,6165,233,5661,12059,9155,9,0,10,19
7821,NELLORE,Ojili,THIRUMALAPUDI,94,26,83,203,76,0,63,139,147,2143,0,1238,3381,2283,0,0,0,0
7822,NELLORE,Ojili,VENKATAREDDI PALEM,249,100,157,506,168,9,62,239,202,4730,97,1037,5864,3301,0,0,0,0
7823,NELLORE,Pellakur,ANAKAVOLU,114,46,88,248,63,35,6,104,106,1415,455,69,1939,1195,0,0,0,0
7824,NELLORE,Pellakur,ARDHAMALA,265,67,143,475,152,30,78,260,231,7325,158,4055,11538,6138,18,0,2,20
7825,NELLORE,Pellakur,BANGARAMMAPETA,186,42,177,405,123,28,105,256,277,6473,1280,5688,13441,7021,16,1,3,20
7826,NELLORE,Pellakur,C.NAIDU PETA,157,36,179,372,104,26,81,211,223,3485,827,2340,6652,3583,0,0,1,1
7827,NELLORE,Pellakur,CHAVALI,203,83,261,547,149,17,27,193,209,7121,674,1584,9379,5820,5,1,4,10
7828,NELLORE,Pellakur,CHEMBEDU,365,56,306,727,299,43,0,342,368,9924,831,0,10755,5958,1,0,0,1
7829,NELLORE,Pellakur,CHILLAKUR,177,27,262,466,83,3,68,154,158,1145,24,1309,2478,1532,0,0,0,0
7830,NELLORE,Pellakur,CHINTAPUDI,130,9,201,340,10,0,30,40,40,711,0,2045,2756,1470,1,0,2,3
7831,NELLORE,Pellakur,JEELLAPATUR,151,55,171,377,100,18,131,249,209,5146,389,5221,10756,5930,2,0,5,7
7832,NELLORE,Pellakur,KALAVAKURU,156,89,157,402,105,40,99,244,236,1309,774,2887,4970,2597,0,0,0,0
7833,NELLORE,Pellakur,KANURU,199,70,259,528,33,1,116,150,72,200,52,2123,2375,722,0,0,0,0
7834,NELLORE,Pellakur,KOTHUR,16,30,153,199,0,0,0,0,0,0,0,0,0,0,0,0,0,0
7835,NELLORE,Pellakur,M REDDIGUNTA,191,0,0,191,115,0,0,115,108,6273,0,0,6273,3921,12,0,0,12
7836,NELLORE,Pellakur,NANDIMALA,118,34,47,199,96,20,28,144,137,4042,593,757,5392,2965,2,0,0,2
7837,NELLORE,Pellakur,NELUBALLI,271,12,258,541,171,8,24,203,202,8290,359,1028,9677,5424,1,0,0,1
7838,NELLORE,Pellakur,PALACHUR,185,138,359,682,110,10,90,210,184,4416,125,2681,7222,3824,1,0,0,1
7839,NELLORE,Pellakur,PELLAKUR,227,15,156,398,0,0,0,0,0,0,0,0,0,0,0,0,0,0
7840,NELLORE,Pellakur,PENNEPALLI,121,0,29,150,0,0,0,0,0,0,0,0,0,0,0,0,0,0
7841,NELLORE,Pellakur,PULLURU,51,25,145,221,0,0,0,0,0,0,0,0,0,0,0,0,0,0
7842,NELLORE,Pellakur,PUNABAKA,462,169,193,824,150,0,1,151,156,3662,0,6,3668,1965,0,0,0,0
7843,NELLORE,Pellakur,RAVULAPADU,65,28,102,195,32,0,13,45,45,673,0,195,868,512,0,0,0,0
7844,NELLORE,Pellakur,ROSANURU,148,79,136,363,0,0,51,51,41,0,0,639,639,396,0,0,0,0
7845,NELLORE,Pellakur,SIRASANAMBEDU,258,117,355,730,145,65,142,352,319,4483,1870,5497,11850,6798,3,0,3,6
7846,NELLORE,Pellakur,TALAVAYIPADU,166,63,483,712,77,44,276,397,364,2354,1263,7513,11130,6655,1,0,5,6
7847,NELLORE,Podlakur,ALTHURTHI,55,50,237,342,12,0,60,72,73,90,0,860,950,659,0,0,0,0
7848,NELLORE,Podlakur,AMMAVARIPALEM,92,47,295,434,0,16,25,41,41,0,1322,256,1578,1028,0,5,0,5
7849,NELLORE,Podlakur,AYYAGARIPALEM,44,10,228,282,15,0,45,60,39,286,0,361,647,341,0,0,0,0
7850,NELLORE,Podlakur,BATHULAPALLE,263,42,278,583,0,0,3,3,2,0,0,24,24,12,0,0,0,0
7851,NELLORE,Podlakur,BIRADAVOLU,190,173,488,851,75,0,8,83,76,2095,0,84,2179,1426,1,0,0,1
7852,NELLORE,Podlakur,CHATAGOTLA,123,32,262,417,59,4,102,165,161,2748,206,3966,6920,4406,3,0,6,9
7853,NELLORE,Podlakur,CHENNAREDDIPALLE,89,59,308,456,36,1,157,194,200,345,14,6834,7193,4002,0,0,11,11
7854,NELLORE,Podlakur,DEGAPUDI,120,96,404,620,10,2,58,70,68,606,40,1064,1710,1209,2,0,2,4
7855,NELLORE,Podlakur,DUGGUNTA,236,158,488,882,91,17,56,164,132,2349,407,1488,4244,2512,0,0,1,1
7856,NELLORE,Podlakur,INUKURTHY,206,77,389,672,42,1,68,111,84,1649,124,3088,4861,2507,4,1,8,13
7857,NELLORE,Podlakur,KANUPARTHI,124,26,360,510,26,0,153,179,154,737,0,5598,6335,4957,0,0,3,3
7858,NELLORE,Podlakur,MAHAMMADAPURAM,169,160,453,782,1,0,4,5,4,5,0,72,77,31,0,0,0,0
7859,NELLORE,Podlakur,MARRIPALLE GOPASAMUDRAM,1,65,190,256,0,0,33,33,30,0,0,173,173,130,0,0,0,0
7860,NELLORE,Podlakur,MARUPURU,214,134,362,710,53,1,10,64,48,1321,42,185,1548,897,1,0,0,1
7861,NELLORE,Podlakur,MOGALLUR,171,70,392,633,11,1,96,108,101,236,24,3951,4211,3214,0,0,6,6
7862,NELLORE,Podlakur,NANDIVAYA,42,5,43,90,9,1,2,12,10,45,7,8,60,52,0,0,0,0
7863,NELLORE,Podlakur,NAVURU,1,0,222,223,0,0,69,69,59,0,0,1103,1103,714,0,0,0,0
7864,NELLORE,Podlakur,NAVURUPALLE,132,36,183,351,2,0,22,24,9,10,0,96,106,37,0,0,0,0
7865,NELLORE,Podlakur,NEDURUPALLE,223,67,666,956,47,0,122,169,129,1083,0,6188,7271,3614,1,0,18,19
7866,NELLORE,Podlakur,PARLAPALLE,34,6,134,174,3,1,25,29,25,20,24,176,220,158,0,0,0,0
7867,NELLORE,Podlakur,PODALAKUR,448,224,925,1597,87,0,0,87,76,5059,0,0,5059,2497,15,0,0,15
7868,NELLORE,Podlakur,PRABAGIRIPATNAM,261,43,140,444,38,0,31,69,53,819,0,368,1187,654,0,0,0,0
7869,NELLORE,Podlakur,PULIKALLU,91,120,205,416,1,4,0,5,2,6,30,0,36,12,0,0,0,0
7870,NELLORE,Podlakur,R.Y.PALEM,260,82,303,645,62,7,61,130,122,1589,95,2618,4302,2900,2,0,9,11
7871,NELLORE,Podlakur,SURAYAPALEM,82,33,349,464,4,0,20,24,19,49,0,351,400,167,0,0,0,0
7872,NELLORE,Podlakur,TATIPARTHI,315,256,979,1550,13,12,84,109,92,81,188,1173,1442,935,0,0,0,0
7873,NELLORE,Podlakur,THODERU,357,158,457,972,121,0,1,122,111,3506,0,6,3512,1846,0,0,0,0
7874,NELLORE,Podlakur,VAVINTAPARTHI,112,82,274,468,38,23,119,180,131,882,638,5198,6718,4267,0,0,20,20
7875,NELLORE,Podlakur,VELIKANTIPALEM,4,54,98,156,0,0,0,0,0,0,0,0,0,0,0,0,0,0
7876,NELLORE,Podlakur,VIRUVURU,315,104,462,881,69,2,44,115,31,2203,54,1738,3995,498,0,0,2,2
7877,NELLORE,Rapur,ADURUPALLE,61,1,68,130,31,0,15,46,41,310,0,214,524,271,0,0,0,0
7878,NELLORE,Rapur,AKILIVALASA,378,163,202,743,162,38,26,226,213,8150,621,712,9483,4914,28,0,0,28
7879,NELLORE,Rapur,BOJJANAPALLE,186,68,325,579,40,1,150,191,162,676,1,5210,5887,3234,0,0,2,2
7880,NELLORE,Rapur,CHERLOPALLE,63,66,188,317,40,45,114,199,203,843,1985,4520,7348,4536,0,0,6,6
7881,NELLORE,Rapur,GILAKAPADU,105,91,254,450,4,18,79,101,86,41,316,3522,3879,2468,0,0,4,4
7882,NELLORE,Rapur,GONUPALLE,352,163,402,917,42,73,13,128,98,658,285,376,1319,739,0,0,0,0
7883,NELLORE,Rapur,GUNDAVOLU,193,60,250,503,86,21,105,212,177,2288,151,2799,5238,3497,1,0,1,2
7884,NELLORE,Rapur,JOREPALLE,360,23,234,617,20,6,56,82,80,364,45,399,808,503,0,0,0,0
7885,NELLORE,Rapur,KAMBHALAPALLI,109,68,101,278,36,6,13,55,49,382,161,204,747,379,0,0,0,0
7886,NELLORE,Rapur,M.V.PURAM,81,68,145,294,26,22,29,77,67,1140,1543,1688,4371,2337,0,3,3,6
7887,NELLORE,Rapur,NELLEPALLE,101,222,306,629,18,10,21,49,29,159,96,204,459,190,0,0,0,0
7888,NELLORE,Rapur,PANGILI,110,126,467,703,9,27,140,176,155,9,84,1301,1394,996,0,0,0,0
7889,NELLORE,Rapur,PENUBARTHI,140,146,407,693,62,17,142,221,209,1265,327,5470,7062,4194,0,0,2,2
7890,NELLORE,Rapur,RAPUR,1274,447,1626,3347,269,18,308,595,522,7087,317,9005,16409,9528,3,0,2,5
7891,NELLORE,Rapur,SANKRANTHIPALLI,211,229,220,660,70,31,8,109,103,1516,905,197,2618,1521,0,0,0,0
7892,NELLORE,Rapur,SANYANPALEM,116,33,268,417,62,2,96,160,130,988,42,3753,4783,2384,0,0,3,3
7893,NELLORE,Rapur,SIDDAVARAM,408,143,582,1133,204,47,330,581,513,8814,2192,15937,26943,16365,16,3,17,36
7894,NELLORE,Rapur,TEGACHERLA,364,176,345,885,158,84,93,335,318,3522,2224,2633,8379,4739,1,0,1,2
7895,NELLORE,Rapur,TUMAYA,137,37,119,293,50,9,72,131,125,1797,280,4199,6276,4134,0,0,12,12
7896,NELLORE,Rapur,VEPINAPI,173,44,160,377,84,10,61,155,136,1606,311,2206,4123,2483,0,0,3,3
7897,NELLORE,Rapur,YEPURU,274,56,262,592,100,31,86,217,210,4528,1005,3160,8693,4543,5,0,3,8
7898,NELLORE,Sangam,ANNAREDDIPALEM,351,184,354,889,166,21,156,343,361,8214,522,12287,21023,11729,16,0,58,74
7899,NELLORE,Sangam,CHENNAVARAPPADU,41,21,188,250,21,0,96,117,18,472,0,2866,3338,107,0,0,0,0
7900,NELLORE,Sangam,DUVVURU,343,91,371,805,44,3,46,93,76,323,18,2892,3233,1534,0,0,0,0
7901,NELLORE,Sangam,GANDHIJANASANGAM,5,299,60,364,0,41,15,56,44,0,1808,484,2292,1142,0,6,1,7
7902,NELLORE,Sangam,JANDADIBBA,83,140,1052,1275,40,4,237,281,249,1674,89,6483,8246,4394,0,0,28,28
7903,NELLORE,Sangam,JANGALA KHANDRIKA,66,40,101,207,42,2,45,89,46,1197,84,909,2190,702,0,0,0,0
7904,NELLORE,Sangam,KOLAGATLA,158,2,166,326,61,0,36,97,94,2077,0,526,2603,1381,0,0,0,0
7905,NELLORE,Sangam,KORIMERLA,155,34,325,514,63,10,141,214,198,650,88,2391,3129,1963,0,0,0,0
7906,NELLORE,Sangam,MAKTHAPURAM,145,66,294,505,81,26,34,141,119,509,721,1020,2250,1079,0,0,0,0
7907,NELLORE,Sangam,MARRIPADU,152,183,569,904,5,4,259,268,234,121,319,15097,15537,7582,0,2,50,52
7908,NELLORE,Sangam,NEELAYAPALEM,6,0,144,150,2,0,79,81,62,24,0,1386,1410,687,0,0,0,0
7909,NELLORE,Sangam,PADAMATIPALEM,114,32,244,390,35,9,66,110,77,371,62,1138,1571,560,0,0,0,0
7910,NELLORE,Sangam,PERAMANA,169,19,344,532,0,0,0,0,0,0,0,0,0,0,0,0,0,0
7911,NELLORE,Sangam,SANGAM,267,84,1088,1439,11,0,75,86,71,112,0,1756,1868,984,0,0,0,0
7912,NELLORE,Sangam,SIDDIPURAM,177,10,505,692,1,0,7,8,8,18,0,106,124,60,0,0,0,0
7913,NELLORE,Sangam,TALUPURUPADU,53,34,257,344,26,0,123,149,134,674,0,2452,3126,1614,0,0,1,1
7914,NELLORE,Sangam,THARUNAVAYA,460,161,164,785,4,0,0,4,3,48,0,0,48,18,0,0,0,0
7915,NELLORE,Sangam,VANGALLU,218,162,461,841,120,24,191,335,196,2098,172,1569,3839,1816,0,0,0,0
7916,NELLORE,Sangam,VEERLAGUDIPADU,15,18,94,127,7,1,42,50,33,172,45,814,1031,450,0,0,0,0
7917,NELLORE,Sangam,VENGAREDDIPALEM,145,46,146,337,12,0,0,12,3,186,0,0,186,34,0,0,0,0
7918,NELLORE,Seetharamapuram,AYYAVARIPALLE,131,0,400,531,45,0,215,260,216,378,0,1707,2085,1307,0,0,0,0
7919,NELLORE,Seetharamapuram,BALAYAPALLE,102,15,363,480,55,7,241,303,343,1584,107,8805,10496,6499,0,0,2,2
7920,NELLORE,Seetharamapuram,BASINENIPALLE,398,57,733,1188,150,20,214,384,459,3527,573,4171,8271,4792,0,0,1,1
7921,NELLORE,Seetharamapuram,CHINA NAGAMPALLE,166,2,413,581,112,0,232,344,292,1581,0,2972,4553,2452,0,0,0,0
7922,NELLORE,Seetharamapuram,DEVAMMACHERUVU,14,73,153,240,3,19,81,103,115,36,530,1397,1963,1150,0,0,0,0
7923,NELLORE,Seetharamapuram,DEVARAJUSURAYAPALLE,1,9,377,387,0,5,193,198,168,0,39,1352,1391,817,0,0,0,0
7924,NELLORE,Seetharamapuram,DEVISETTIPALLE,1,0,159,160,0,0,79,79,87,0,0,1896,1896,1457,0,0,0,0
7925,NELLORE,Seetharamapuram,GUNDUPALLE,51,29,226,306,31,25,154,210,240,837,636,4437,5910,3705,0,0,2,2
7926,NELLORE,Seetharamapuram,JAYAPURAM,3,59,355,417,0,0,0,0,0,0,0,0,0,0,0,0,0,0
7927,NELLORE,Seetharamapuram,MARAMREDDIPALLE,277,6,400,683,98,4,203,305,311,1230,104,10025,11359,6385,0,0,4,4
7928,NELLORE,Seetharamapuram,NEMALLADINNE,258,59,286,603,109,36,150,295,332,2192,941,2873,6006,3678,0,0,0,0
7929,NELLORE,Seetharamapuram,PABBULETIPALLI,125,49,439,613,48,17,108,173,169,1477,192,1633,3302,1946,0,0,0,0
7930,NELLORE,Seetharamapuram,SEETHARAMAPURAM,357,44,1875,2276,115,3,675,793,973,2627,77,11295,13999,8047,0,0,0,0
7931,NELLORE,Seetharamapuram,SINGAREDDIPALLE,47,5,552,604,26,0,196,222,227,455,0,3133,3588,2339,0,0,1,1
7932,NELLORE,Sullurpeta,ABAKA,403,0,166,569,292,0,115,407,399,5008,0,1966,6974,4420,0,0,0,0
7933,NELLORE,Sullurpeta,DAMA NELLORE,166,70,257,493,74,31,152,257,245,2300,872,4469,7641,4816,3,0,2,5
7934,NELLORE,Sullurpeta,DAMARAYA,115,15,188,318,89,10,150,249,216,4297,606,10827,15730,9222,3,3,38,44
7935,NELLORE,Sullurpeta,GOPALA REDDY PALEM,327,45,6,378,213,32,1,246,237,5301,195,78,5574,3550,0,0,0,0
7936,NELLORE,Sullurpeta,ILLUPURU,745,69,197,1011,128,0,18,146,141,1303,0,156,1459,1162,0,0,0,0
7937,NELLORE,Sullurpeta,K.C.N. GUNTA,169,32,121,322,116,21,66,203,213,3877,1189,2612,7678,4917,0,1,0,1
7938,NELLORE,Sullurpeta,KADAPATRA,275,81,433,789,122,0,196,318,325,5185,0,9020,14205,8953,13,0,11,24
7939,NELLORE,Sullurpeta,KORIDI,167,52,301,520,107,11,163,281,302,5427,406,5455,11288,8118,4,0,9,13
7940,NELLORE,Sullurpeta,KOTAPOLURU,737,133,229,1099,406,37,55,498,457,3497,777,813,5087,3612,0,0,0,0
7941,NELLORE,Sullurpeta,KUDIRI,170,8,209,387,89,3,159,251,259,3859,181,9022,13062,7952,2,0,8,10
7942,NELLORE,Sullurpeta,MANGALAMPADU,170,154,381,705,123,52,271,446,397,1926,567,2563,5056,2978,0,0,0,0
7943,NELLORE,Sullurpeta,MANGANELLORE,204,230,168,602,0,0,0,0,0,0,0,0,0,0,0,0,0,0
7944,NELLORE,Sullurpeta,MANNEMUTHERI,473,131,300,904,162,42,80,284,272,3951,1995,1865,7811,5558,0,0,0,0
7945,NELLORE,Sullurpeta,MATHAKAMUDI,1,61,243,305,0,0,174,174,150,0,0,2904,2904,1650,0,0,0,0
7946,NELLORE,Sullurpeta,NADENDLAVARI KANDRIGA,186,44,180,410,126,25,93,244,226,3029,327,1556,4912,3209,0,0,0,0
7947,NELLORE,Sullurpeta,SAMANTHAMALLAM,71,6,173,250,66,2,153,221,246,1585,19,3222,4826,2663,0,0,0,0
7948,NELLORE,Sullurpeta,SUGGUPALLI,65,6,137,208,51,5,2,58,59,703,33,23,759,476,0,0,0,0
7949,NELLORE,Sullurpeta,SULLURU(SULLURUPETA)(U),519,201,70,790,0,0,0,0,0,0,0,0,0,0,0,0,0,0
7950,NELLORE,Sullurpeta,UGGUMUDI,168,41,89,298,133,0,49,182,151,3953,0,1074,5027,2711,0,0,0,0
7951,NELLORE,Sullurpeta,VELAGALAPONNURU,92,0,75,167,0,0,0,0,0,0,0,0,0,0,0,0,0,0
7952,NELLORE,Sydapuram,ANANTHAMADUGU,357,47,273,677,101,1,46,148,123,4328,4,1213,5545,2784,10,0,1,11
7953,NELLORE,Sydapuram,CHAGANAM,288,119,243,650,16,0,4,20,16,185,0,144,329,133,0,0,0,0
7954,NELLORE,Sydapuram,CHAGANAM RAJU PALEM,16,169,170,355,3,51,93,147,118,72,1677,4211,5960,2807,0,2,12,14
7955,NELLORE,Sydapuram,CHEEKAVOLU,221,135,328,684,71,7,144,222,190,1585,126,2448,4159,2181,0,0,0,0
7956,NELLORE,Sydapuram,DEVARAVEMUR,200,7,201,408,80,0,96,176,156,844,0,2161,3005,1994,0,0,0,0
7957,NELLORE,Sydapuram,G BRUNDAVANAM,8,0,24,32,0,0,0,0,0,0,0,0,0,0,0,0,0,0
7958,NELLORE,Sydapuram,GRIDDALUR,340,122,627,1089,38,0,57,95,75,1102,0,1248,2350,1684,0,0,0,0
7959,NELLORE,Sydapuram,GULIMICHERLA,124,15,147,286,21,8,61,90,54,318,232,1678,2228,745,0,0,0,0
7960,NELLORE,Sydapuram,JOGIPALLE,40,60,99,199,16,21,22,59,36,1706,1649,1806,5161,1690,12,7,10,29
7961,NELLORE,Sydapuram,K.G.R.PALEM,5,84,129,218,0,44,78,122,108,0,1598,3404,5002,2869,0,0,0,0
7962,NELLORE,Sydapuram,KALICHEDU,83,76,204,363,0,0,0,0,0,0,0,0,0,0,0,0,0,0
7963,NELLORE,Sydapuram,KOMMIPADU,101,18,118,237,2,5,39,46,42,14,57,608,679,341,0,0,0,0
7964,NELLORE,Sydapuram,KRISHNAREDDI PALLE,127,4,59,190,53,0,34,87,83,2109,0,1501,3610,1875,1,0,1,2
7965,NELLORE,Sydapuram,LINGANAPALEM,3,63,137,203,0,14,82,96,92,0,231,2348,2579,2003,0,0,1,1
7966,NELLORE,Sydapuram,LINGASAMUDRAM,124,70,127,321,43,13,16,72,58,656,214,127,997,483,0,0,0,0
7967,NELLORE,Sydapuram,MALICHEDU,72,12,86,170,13,2,36,51,39,727,55,1574,2356,1235,3,0,0,3
7968,NELLORE,Sydapuram,MARLAPUDI,189,86,170,445,72,44,92,208,189,1834,1504,4482,7820,4969,2,1,7,10
7969,NELLORE,Sydapuram,PALUR,305,62,294,661,46,29,168,243,253,1007,1008,7003,9018,5237,0,1,4,5
7970,NELLORE,Sydapuram,PERUMALLA PADU,61,99,127,287,5,29,32,66,57,113,462,442,1017,531,0,0,0,0
7971,NELLORE,Sydapuram,POKKANDALA,61,30,60,151,40,19,47,106,93,1970,596,3030,5596,3358,6,1,12,19
7972,NELLORE,Sydapuram,POTHEGUNTA,166,39,233,438,51,10,55,116,110,1836,184,673,2693,1421,1,0,0,1
7973,NELLORE,Sydapuram,R Y G PALEM,28,73,109,210,12,38,60,110,97,382,1108,2800,4290,2640,0,0,6,6
7974,NELLORE,Sydapuram,RAGANARAMAPURAM,18,32,101,151,1,9,42,52,31,21,396,1019,1436,554,0,0,0,0
7975,NELLORE,Sydapuram,RAMASAGARAM,430,87,413,930,93,1,25,119,102,2833,20,307,3160,1900,0,0,0,0
7976,NELLORE,Sydapuram,SYDAPURAM,595,275,558,1428,27,0,69,96,74,893,0,2256,3149,1366,2,0,4,6
7977,NELLORE,Sydapuram,THIPPIREDDI PALLE,144,16,173,333,60,8,110,178,169,2000,235,3908,6143,3477,1,0,2,3
7978,NELLORE,Sydapuram,THUMMALA THALUPURU,361,201,259,821,34,4,16,54,37,479,90,148,717,399,0,0,0,0
7979,NELLORE,Sydapuram,TOCHEM,57,42,126,225,31,11,64,106,97,857,452,2891,4200,1816,0,2,3,5
7980,NELLORE,Sydapuram,TURIMERLA,226,142,368,736,71,9,100,180,164,2287,321,3512,6120,3669,2,0,1,3
7981,NELLORE,Sydapuram,UTUKUR,203,71,200,474,50,9,26,85,52,2156,864,991,4011,1459,1,7,0,8
7982,NELLORE,Sydapuram,VEMULACHEDU,205,108,294,607,84,19,84,187,178,4554,237,1501,6292,3521,3,0,0,3
7983,NELLORE,Tada,ANDAGUNDALA,80,47,104,231,39,1,6,46,41,862,2,77,941,730,0,0,0,0
7984,NELLORE,Tada,BHEEMULAVARIPALEM,63,6,499,568,28,0,176,204,212,1160,0,4787,5947,4809,0,0,1,1
7985,NELLORE,Tada,CHENIGUNTA,279,107,53,439,140,7,37,184,164,7365,24,1797,9186,6721,8,0,5,13
7986,NELLORE,Tada,GRADDAGUNTA,387,106,100,593,202,8,21,231,221,7274,347,1189,8810,5402,15,0,4,19
7987,NELLORE,Tada,IRAKAM,127,33,505,665,81,11,246,338,339,1442,482,7122,9046,5926,0,0,0,0
7988,NELLORE,Tada,KADALURU,556,78,41,675,231,38,10,279,251,2743,404,96,3243,2109,0,0,0,0
7989,NELLORE,Tada,KARIJATHA,274,12,218,504,182,0,126,308,282,7724,0,6204,13928,8851,15,0,8,23
7990,NELLORE,Tada,KARUR,94,13,1149,1256,23,2,213,238,225,234,12,1344,1590,1350,0,0,0,0
7991,NELLORE,Tada,KONDURU,394,58,171,623,209,24,75,308,298,7845,278,1808,9931,7111,6,0,1,7
7992,NELLORE,Tada,MAMBATTU,408,99,221,728,249,24,67,340,358,6889,259,1247,8395,5318,3,0,0,3
7993,NELLORE,Tada,PERIAVATTU,68,43,452,563,0,0,72,72,74,0,0,1322,1322,1306,0,0,0,0
7994,NELLORE,Tada,PUDI,56,6,294,356,36,6,143,185,196,1994,257,8060,10311,6706,3,0,22,25
7995,NELLORE,Tada,RAMAPURAM,148,2,1026,1176,82,0,369,451,429,2597,0,5626,8223,6480,0,0,1,1
7996,NELLORE,Tada,TADA,318,64,590,972,58,25,206,289,289,719,988,7601,9308,7270,0,1,19,20
7997,NELLORE,Tada,TADAKHANDRIKA,337,3,374,714,116,0,79,195,204,3923,0,2629,6552,4320,10,0,3,13
7998,NELLORE,Tada,VATAMBEDU,323,27,419,769,231,2,95,328,307,4665,40,1638,6343,3811,1,0,0,1
7999,NELLORE,Tada,VENADU,123,158,245,526,73,0,0,73,76,655,0,0,655,459,0,0,0,0
8000,NELLORE,Tada,VENDLURUPADU,198,2,60,260,130,0,8,138,131,5918,0,124,6042,3181,5,0,0,5
8001,NELLORE,Thotapalligudur,CHINATHOPU,246,28,92,366,10,1,13,24,7,181,20,260,461,82,0,0,0,0
8002,NELLORE,Thotapalligudur,CHINNACHERUKUR,244,37,176,457,24,0,0,24,0,244,0,0,244,0,0,0,0,0
8003,NELLORE,Thotapalligudur,EDURU - I,94,13,193,300,56,0,2,58,47,1655,0,16,1671,911,0,0,0,0
8004,NELLORE,Thotapalligudur,EDURU - II(MANDAPAM),1,24,479,504,0,0,121,121,6,0,0,5366,5366,317,0,0,2,2
8005,NELLORE,Thotapalligudur,ISKAPALEM,300,43,15,358,64,1,0,65,43,1039,12,0,1051,487,0,0,0,0
8006,NELLORE,Thotapalligudur,KODURU,298,313,936,1547,35,1,84,120,95,861,26,1514,2401,1293,0,0,0,0
8007,NELLORE,Thotapalligudur,KOTHAPALEM,120,26,134,280,39,14,45,98,6,1611,756,3539,5906,143,0,0,5,5
8008,NELLORE,Thotapalligudur,KOVERAPALEM,19,5,164,188,0,0,0,0,0,0,0,0,0,0,0,0,0,0
8009,NELLORE,Thotapalligudur,MACHERLAVARIPALEM,238,126,158,522,30,15,43,88,58,300,266,708,1274,456,0,0,0,0
8010,NELLORE,Thotapalligudur,MALLIKARGUNAPURAM,153,297,127,577,8,25,10,43,36,71,327,164,562,300,0,0,0,0
8011,NELLORE,Thotapalligudur,MUNGALADORUVU,1,7,199,207,0,2,59,61,25,0,141,3368,3509,700,0,0,9,9
8012,NELLORE,Thotapalligudur,NARUKURU,218,41,308,567,17,0,30,47,3,182,0,626,808,76,0,0,0,0
8013,NELLORE,Thotapalligudur,PEDURU,288,95,354,737,29,0,32,61,19,334,0,497,831,161,0,0,0,0
8014,NELLORE,Thotapalligudur,POTLAPUDI,218,55,281,554,0,0,37,37,2,0,0,321,321,20,0,0,0,0
8015,NELLORE,Thotapalligudur,SOUTH AMULUR,141,58,239,438,15,4,22,41,19,299,96,170,565,179,0,0,0,0
8016,NELLORE,Thotapalligudur,T.P. GUDUR -II,157,58,213,428,41,25,33,99,67,965,829,959,2753,1359,0,0,0,0
8017,NELLORE,Thotapalligudur,T.P.GUDUR -I,277,47,192,516,57,0,57,114,27,2086,0,3452,5538,678,6,0,14,20
8018,NELLORE,Thotapalligudur,THOTAPALLE,305,64,78,447,21,0,0,21,10,146,0,0,146,60,0,0,0,0
8019,NELLORE,Thotapalligudur,VANKANAPALEM,284,133,334,751,99,26,2,127,100,2487,264,38,2789,2031,0,0,0,0
8020,NELLORE,Thotapalligudur,VARAKAVIPUDU,213,193,302,708,0,0,4,4,0,0,0,27,27,0,0,0,0,0
8021,NELLORE,Thotapalligudur,VARIGONDA,282,266,613,1161,1,82,37,120,73,5,1873,943,2821,1156,0,0,0,0
8022,NELLORE,Thotapalligudur,VILUKANIPALLE,130,197,87,414,1,45,2,48,37,13,2729,147,2889,1490,0,3,0,3
8023,NELLORE,Udayagiri,APPASAMUDRAM,104,8,546,658,55,3,303,361,355,1515,27,7137,8679,5489,0,0,1,1
8024,NELLORE,Udayagiri,ARLAPADIYA,100,25,292,417,65,16,180,261,248,3110,756,11256,15122,10386,3,0,16,19
8025,NELLORE,Udayagiri,BANDAGANIPALLE,81,70,755,906,34,26,282,342,330,992,519,7956,9467,5477,0,0,1,1
8026,NELLORE,Udayagiri,DASARI PALLE,78,67,708,853,33,7,105,145,131,1109,211,4500,5820,4139,0,0,2,2
8027,NELLORE,Udayagiri,G.AYYAVARI PALLE,63,13,440,516,31,3,74,108,128,1274,66,1897,3237,1930,1,0,0,1
8028,NELLORE,Udayagiri,G.CHERLOPALLE,23,3,318,344,7,0,170,177,175,403,0,8188,8591,7117,0,0,2,2
8029,NELLORE,Udayagiri,G.CHERUVU PALLE,146,0,472,618,37,0,237,274,272,145,0,2647,2792,1886,0,0,0,0
8030,NELLORE,Udayagiri,GANDIPALEM,165,1,473,639,47,0,148,195,203,1764,0,4823,6587,5394,0,0,0,0
8031,NELLORE,Udayagiri,GANNEPALLE,78,8,377,463,57,2,247,306,276,4168,65,13761,17994,11072,16,0,18,34
8032,NELLORE,Udayagiri,KONDAYAPALEM,388,15,838,1241,168,11,382,561,536,7424,384,14246,22054,13921,11,0,18,29
8033,NELLORE,Udayagiri,KRISHNAMPALLE,89,4,534,627,65,0,245,310,323,3047,0,7522,10569,6073,3,0,1,4
8034,NELLORE,Udayagiri,NELATURU,91,0,140,231,9,0,51,60,71,115,0,1148,1263,769,0,0,0,0
8035,NELLORE,Udayagiri,PULLAYAPALLE,154,6,194,354,70,3,117,190,202,4239,183,5359,9781,6011,6,0,2,8
8036,NELLORE,Udayagiri,SAKUNALAPALLE,128,18,397,543,71,8,233,312,324,4838,397,10808,16043,10135,7,1,12,20
8037,NELLORE,Udayagiri,THIRUMALPURAM,178,138,710,1026,89,68,475,632,677,2869,896,17851,21616,12302,0,0,13,13
8038,NELLORE,Udayagiri,UDAYAGIRI,345,116,1734,2195,72,27,461,560,524,2985,488,21425,24898,21276,1,0,6,7
8039,NELLORE,Udayagiri,VENGALARAO NAGAR,86,5,375,466,44,4,158,206,191,1165,38,6956,8159,6381,0,0,0,0
8040,NELLORE,Vakadu,BALIREDDYPALEM,527,61,35,623,52,0,0,52,58,498,0,0,498,288,0,0,0,0
8041,NELLORE,Vakadu,DUGARAJAPATNAM,174,122,676,972,91,19,112,222,183,4131,431,5442,10004,5436,10,0,14,24
8042,NELLORE,Vakadu,JAMINKOTHAPALEM,257,137,149,543,93,0,5,98,100,3116,0,68,3184,1675,0,0,0,0
8043,NELLORE,Vakadu,JUVVINATTU,53,89,93,235,0,0,0,0,0,0,0,0,0,0,0,0,0,0
8044,NELLORE,Vakadu,KALLURU,247,30,278,555,92,6,47,145,142,1013,44,542,1599,782,0,0,0,0
8045,NELLORE,Vakadu,KASIPURAM,117,2,35,154,1,0,1,2,2,8,0,8,16,8,0,0,0,0
8046,NELLORE,Vakadu,KONDAPURAM,190,72,392,654,66,17,95,178,167,2777,390,1831,4998,3641,5,0,1,6
8047,NELLORE,Vakadu,KONDURU,383,100,49,532,199,6,14,219,216,5435,85,318,5838,3590,0,0,0,0
8048,NELLORE,Vakadu,MOLAGANUR,71,55,23,149,22,4,0,26,25,342,198,0,540,285,0,0,0,0
8049,NELLORE,Vakadu,MULAPADAVA,358,52,109,519,226,14,53,293,227,9978,239,1965,12182,5863,4,0,0,4
8050,NELLORE,Vakadu,MUTTEMBAKA,184,44,80,308,137,1,23,161,153,2488,20,494,3002,1534,0,0,0,0
8051,NELLORE,Vakadu,NELLIPUDI,268,32,157,457,173,2,0,175,172,1856,14,0,1870,1134,0,0,0,0
8052,NELLORE,Vakadu,NIDIGURTHI,424,96,403,923,90,3,186,279,190,1612,33,2751,4396,2023,0,0,0,0
8053,NELLORE,Vakadu,PUDIRAYADORUVU,9,119,463,591,2,30,169,201,169,173,691,7693,8557,4578,0,0,2,2
8054,NELLORE,Vakadu,RAVIGUNTAPALEM,181,83,200,464,135,38,148,321,306,3457,1451,6320,11228,5393,0,0,4,4
8055,NELLORE,Vakadu,THIRUMUR,132,119,119,370,88,39,89,216,180,3035,390,1960,5385,2726,0,0,0,0
8056,NELLORE,Vakadu,VAKADU,528,337,287,1152,82,0,14,96,91,777,0,221,998,716,0,0,0,0
8057,NELLORE,Vakadu,VALAMEDU,160,33,41,234,79,0,0,79,75,1271,0,0,1271,792,0,0,0,0
8058,NELLORE,Vakadu,YARAGATIPALLE,255,59,44,358,3,0,0,3,3,111,0,0,111,57,0,0,0,0
8059,NELLORE,Varikuntapadu,DAKKANUR,57,3,134,194,27,0,87,114,107,1529,0,8220,9749,7004,3,0,56,59
8060,NELLORE,Varikuntapadu,G. KONDAREDDIPALLE,120,14,424,558,35,4,207,246,246,1463,155,7750,9368,6168,2,0,7,9
8061,NELLORE,Varikuntapadu,GANESHWARAPURAM,153,35,494,682,77,5,246,328,340,4583,404,16601,21588,14673,8,1,39,48
8062,NELLORE,Varikuntapadu,GUVVADI,101,3,210,314,57,1,103,161,153,1784,15,3982,5781,4210,0,0,0,0
8063,NELLORE,Varikuntapadu,ISAKAPALLE,31,0,115,146,20,0,85,105,97,1434,0,4869,6303,4185,3,0,10,13
8064,NELLORE,Varikuntapadu,JADADEVI,66,9,273,348,23,6,196,225,237,1419,564,12920,14903,11186,3,3,30,36
8065,NELLORE,Varikuntapadu,KANCHERUVU,64,16,200,280,33,3,103,139,130,1254,63,3204,4521,3571,0,0,2,2
8066,NELLORE,Varikuntapadu,KONDAREDDIPALLE,50,0,208,258,22,0,110,132,130,1039,0,1867,2906,1996,0,0,0,0
8067,NELLORE,Varikuntapadu,KRISHNAMRAJUPALLE,74,4,228,306,28,0,136,164,168,510,0,4119,4629,2880,0,0,0,0
8068,NELLORE,Varikuntapadu,MOHAMMADAPURAM,61,112,216,389,5,3,37,45,44,45,24,650,719,476,0,0,0,0
8069,NELLORE,Varikuntapadu,NALLABOTHULAVARIPALLE,13,7,234,254,7,5,127,139,145,165,159,5498,5822,3523,0,0,12,12
8070,NELLORE,Varikuntapadu,NORTH KONDAYAPALEM,63,9,459,531,24,1,233,258,248,687,46,3021,3754,2690,0,0,0,0
8071,NELLORE,Varikuntapadu,PAMURUPALLE,3,0,198,201,1,0,135,136,135,10,0,8760,8770,6055,0,0,18,18
8072,NELLORE,Varikuntapadu,PEDDIREDDIPALLE,88,22,586,696,0,0,16,16,15,0,0,156,156,90,0,0,0,0
8073,NELLORE,Varikuntapadu,RAMAPURAM,104,41,617,762,28,13,182,223,220,757,786,10151,11694,8975,0,3,13,16
8074,NELLORE,Varikuntapadu,THIMMAREDDIPALLE,147,8,283,438,83,2,170,255,227,4300,76,8312,12688,9038,8,0,4,12
8075,NELLORE,Varikuntapadu,THOTALACHERUVUPALLE,120,0,400,520,0,0,9,9,9,0,0,147,147,123,0,0,0,0
8076,NELLORE,Varikuntapadu,THURPU BOYAMADUGULA,76,27,237,340,29,0,57,86,93,432,0,1236,1668,978,0,0,0,0
8077,NELLORE,Varikuntapadu,THURPU CHENNAMPALLE,73,6,98,177,36,2,77,115,133,1529,33,1610,3172,1893,0,0,0,0
8078,NELLORE,Varikuntapadu,THURPU ROMPIDODLA,119,79,204,402,65,10,95,170,155,2018,305,2805,5128,3554,0,0,6,6
8079,NELLORE,Varikuntapadu,VARIKUNTAPADU,485,38,679,1202,204,4,324,532,509,10274,250,12531,23055,14668,16,0,10,26
8080,NELLORE,Varikuntapadu,VEMPADU,196,19,437,652,83,12,219,314,301,1918,514,6229,8661,5840,4,0,15,19
8081,NELLORE,Varikuntapadu,VIRUVURU,126,1,484,611,51,1,215,267,299,2835,80,10927,13842,8230,7,0,12,19
8082,NELLORE,Varikuntapadu,YERRAMREDDIPALLE,36,8,115,159,23,3,79,105,92,1219,113,3913,5245,3650,0,0,3,3
8083,NELLORE,Venkatachalam,ANIKEPALLE,339,357,303,999,119,10,10,139,123,2678,241,369,3288,1933,0,0,1,1
8084,NELLORE,Venkatachalam,ATRAMVARI KANDRIGA,0,2,32,34,0,0,0,0,0,0,0,0,0,0,0,0,0,0
8085,NELLORE,Venkatachalam,CHAVATAPALEM (K.BIT II),349,106,143,598,149,12,27,188,159,4212,467,1154,5833,3457,3,2,1,6
8086,NELLORE,Venkatachalam,CHEMUDUGUNTA,146,279,39,464,0,0,0,0,0,0,0,0,0,0,0,0,0,0
8087,NELLORE,Venkatachalam,EDAGALI,254,193,382,829,111,37,128,276,238,2754,1708,2634,7096,3641,0,2,1,3
8088,NELLORE,Venkatachalam,GUDLURUVARIPALEM,287,45,533,865,141,0,177,318,271,5000,0,4958,9958,5439,2,0,1,3
8089,NELLORE,Venkatachalam,IDIMEPALLE,127,81,454,662,70,38,78,186,140,3393,784,2116,6293,2967,7,1,3,11
8090,NELLORE,Venkatachalam,KAKUTURU,124,54,157,335,9,0,8,17,15,79,0,47,126,101,0,0,0,0
8091,NELLORE,Venkatachalam,KANDALAPADU,178,5,70,253,88,0,47,135,102,1341,0,1209,2550,1395,0,0,0,0
8092,NELLORE,Venkatachalam,KANTEPALLE,176,116,181,473,120,63,30,213,175,1725,4283,831,6839,3215,0,8,0,8
8093,NELLORE,Venkatachalam,KANUPUR,206,133,187,526,34,54,44,132,94,1274,1909,1836,5019,2240,1,1,0,2
8094,NELLORE,Venkatachalam,KASUMURU,419,171,554,1144,220,41,108,369,276,5246,2070,2481,9797,5091,1,4,1,6
8095,NELLORE,Venkatachalam,KURICHERLAPADU,114,60,376,550,81,1,148,230,155,4433,77,4031,8541,4416,3,0,0,3
8096,NELLORE,Venkatachalam,NIDIGUNTAPALEM,599,74,100,773,271,0,10,281,254,8561,0,238,8799,5311,7,0,0,7
8097,NELLORE,Venkatachalam,PALICHERLAPADU,217,25,151,393,144,1,85,230,212,7041,39,4631,11711,6431,21,0,13,34
8098,NELLORE,Venkatachalam,PUDIPARTHI,330,151,410,891,139,10,157,306,265,6047,401,4564,11012,6964,7,0,1,8
8099,NELLORE,Venkatachalam,PUNJULURUPADU,122,23,94,239,93,0,47,140,115,2297,0,835,3132,1741,0,0,0,0
8100,NELLORE,Venkatachalam,RAMDOSS KANDRIGA,103,27,226,356,0,0,19,19,16,0,0,81,81,45,0,0,0,0
8101,NELLORE,Venkatachalam,SURVEPALLE   BIT-II,262,203,202,667,74,68,25,167,141,2156,3393,239,5788,3547,0,5,0,5
8102,NELLORE,Venkatachalam,SURVEPALLE   BIT-III,269,36,197,502,136,11,92,239,201,1599,139,1797,3535,2325,0,0,0,0
8103,NELLORE,Venkatachalam,THATIPARTHIPALEM,103,28,169,300,60,0,0,60,44,3235,0,0,3235,1603,5,0,0,5
8104,NELLORE,Venkatachalam,TIKKAVARAPPADU(S BIT-I),241,288,249,778,94,14,27,135,95,3251,723,284,4258,1882,10,2,0,12
8105,NELLORE,Venkatachalam,TIRUMALAMMA PALEM,250,45,107,402,181,1,77,259,234,6095,22,2167,8284,4267,2,0,1,3
8106,NELLORE,Venkatachalam,VENKATACHALAM,36,136,308,480,2,2,9,13,13,68,24,419,511,277,0,0,0,0
8107,NELLORE,Venkatachalam,YEGUVAMITTA,6,16,279,301,2,2,201,205,169,43,34,4427,4504,2508,0,0,0,0
8108,NELLORE,Venkatagiri,AMMAPALEM,92,3,427,522,56,0,111,167,153,2612,0,699,3311,1635,5,0,0,5
8109,NELLORE,Venkatagiri,CHELIKAMPADU,175,18,239,432,58,9,147,214,221,1833,399,4927,7159,3761,0,0,1,1
8110,NELLORE,Venkatagiri,CHINANNAPET,288,24,110,422,193,1,75,269,261,7321,5,2503,9829,4979,8,0,0,8
8111,NELLORE,Venkatagiri,CHINTHAGUNTA,85,40,236,361,2,7,52,61,58,16,52,2337,2405,1212,0,0,0,0
8112,NELLORE,Venkatagiri,JANGALAPALLI,121,49,290,460,55,3,93,151,135,4253,147,5161,9561,5528,13,0,9,22
8113,NELLORE,Venkatagiri,KALAPADU,120,100,116,336,0,0,0,0,0,0,0,0,0,0,0,0,0,0
8114,NELLORE,Venkatagiri,KALAVALAPUDI,265,64,313,642,192,20,144,356,307,5735,727,3221,9683,4926,1,0,0,1
8115,NELLORE,Venkatagiri,KURJAGUNTA,81,216,210,507,39,69,108,216,201,1416,1936,4706,8058,3101,1,1,3,5
8116,NELLORE,Venkatagiri,LALAPET,138,0,146,284,83,0,35,118,103,2988,0,1578,4566,2607,2,0,2,4
8117,NELLORE,Venkatagiri,MOGALLAGUNTA,163,80,217,460,76,45,51,172,138,2564,2719,2496,7779,3197,8,14,7,29
8118,NELLORE,Venkatagiri,PALEMKOTA,67,106,280,453,24,25,158,207,160,508,690,1822,3020,1710,0,0,0,0
8119,NELLORE,Venkatagiri,PANJAM,91,28,174,293,62,12,111,185,161,2546,120,5558,8224,4842,2,0,14,16
8120,NELLORE,Venkatagiri,PAPAMAMBAPURAM,95,77,338,510,23,27,78,128,117,964,404,2830,4198,1814,3,0,1,4
8121,NELLORE,Venkatagiri,PARAVOLU,292,138,355,785,156,3,83,242,232,6568,250,2386,9204,4738,17,1,1,19
8122,NELLORE,Venkatagiri,PETLURU,169,90,176,435,114,59,44,217,183,6304,3393,1790,11487,6367,7,6,1,14
8123,NELLORE,Venkatagiri,SIDDAVARAM,112,35,282,429,74,14,153,241,212,1428,272,8357,10057,5607,0,0,7,7
8124,NELLORE,Venkatagiri,SOMASANIGUNTA,245,206,492,943,52,70,162,284,254,1290,1711,5502,8503,4643,1,0,0,1
8125,NELLORE,Venkatagiri,UPPARAPALLE,115,24,163,302,84,16,85,185,121,2364,388,1417,4169,1786,0,0,0,0
8126,NELLORE,Venkatagiri,VALLIVEDU,179,108,361,648,106,34,267,407,339,3643,540,9412,13595,6909,1,0,1,2
8127,NELLORE,Venkatagiri,YATHALURU,238,60,177,475,154,31,136,321,265,8254,1313,7706,17273,8039,8,2,12,22
8128,NELLORE,Vidavalur,ALAGANIPADU,198,81,175,454,82,40,77,199,109,3420,2484,2690,8594,2911,2,5,0,7
8129,NELLORE,Vidavalur,ANNAREDDIPALEM,161,54,430,645,81,3,196,280,275,834,24,2620,3478,2525,0,0,0,0
8130,NELLORE,Vidavalur,CHOWKACHERLA,477,186,260,923,154,0,51,205,84,3557,0,884,4441,1033,0,0,0,0
8131,NELLORE,Vidavalur,DAMPURU,238,158,308,704,58,33,71,162,110,2443,985,1767,5195,2306,2,0,0,2
8132,NELLORE,Vidavalur,DANDIGUNTA,119,48,110,277,76,38,85,199,145,4458,738,2738,7934,2701,3,0,0,3
8133,NELLORE,Vidavalur,DINNE,131,52,209,392,96,12,138,246,120,5054,322,3831,9207,2363,5,0,0,5
8134,NELLORE,Vidavalur,MUDIVARTHI,377,169,354,900,2,35,17,54,31,54,1887,459,2400,1054,0,5,0,5
8135,NELLORE,Vidavalur,PARLAPALLE,215,94,321,630,38,0,90,128,60,960,0,2218,3178,830,0,0,0,0
8136,NELLORE,Vidavalur,RAMACHANDRAPURAM,21,70,1095,1186,12,3,227,242,200,513,23,5502,6038,4050,0,0,1,1
8137,NELLORE,Vidavalur,RAMATHEERTHAM,371,118,726,1215,117,7,117,241,100,1644,92,1333,3069,971,0,0,0,0
8138,NELLORE,Vidavalur,UTUKURU,359,381,947,1687,93,0,52,145,102,1302,0,245,1547,839,0,0,0,0
8139,NELLORE,Vidavalur,VARINI,128,100,240,468,0,30,62,92,30,0,642,1785,2427,632,0,0,0,0
8140,NELLORE,Vidavalur,VAVILLA,243,143,274,660,86,2,36,124,95,3286,47,1104,4437,2356,0,0,0,0
8141,NELLORE,Vidavalur,VIDAVALUR,545,408,511,1464,42,33,44,119,74,301,483,755,1539,779,0,0,0,0
8142,NELLORE,Vinjamur,A. KISTHIPURAM,97,19,416,532,36,0,211,247,222,686,0,6605,7291,4707,0,0,10,10
8143,NELLORE,Vinjamur,BUCCAPURAM,15,20,82,117,0,0,0,0,0,0,0,0,0,0,0,0,0,0
8144,NELLORE,Vinjamur,BUKKAPURAM,71,5,602,678,46,0,323,369,345,2537,0,18605,21142,13848,6,0,34,40
8145,NELLORE,Vinjamur,CHAKALAKONDA,103,23,632,758,0,2,172,174,156,0,14,6748,6762,5578,0,0,5,5
8146,NELLORE,Vinjamur,GUNDEMADAKALA,135,28,565,728,89,6,382,477,466,2995,234,15875,19104,11827,3,0,31,34
8147,NELLORE,Vinjamur,JANARDHANAPURAM,122,7,134,263,47,0,80,127,120,2518,0,3043,5561,4350,4,0,0,4
8148,NELLORE,Vinjamur,KATEPALLI,100,112,713,925,52,11,412,475,451,3322,303,23212,26837,15941,10,0,55,65
8149,NELLORE,Vinjamur,NALLAGONDA,94,108,385,587,43,29,254,326,300,2858,1160,17712,21730,14654,11,0,53,64
8150,NELLORE,Vinjamur,NANDIGUNTA,92,12,226,330,39,8,134,181,172,1824,404,7740,9968,6199,2,1,13,16
8151,NELLORE,Vinjamur,RAVIPADU,53,0,191,244,22,0,97,119,118,458,0,2705,3163,1917,0,0,0,0
8152,NELLORE,Vinjamur,SANKAVARAM,93,9,388,490,37,1,213,251,238,1893,20,11339,13252,9235,4,0,27,31
8153,NELLORE,Vinjamur,UTUKURU,199,118,272,589,62,8,131,201,178,1964,248,4751,6963,4356,2,0,2,4
8154,NELLORE,Vinjamur,VINJAMUR,755,355,3000,4110,107,57,717,881,869,3949,1959,39564,45472,40169,4,0,44,48
8155,PRAKASAM,Addanki,ADDANKI,326,11,240,577,0,0,0,0,0,0,0,0,0,0,0,0,0,0
8156,PRAKASAM,Addanki,BOMMANAMPADU,206,14,463,683,99,0,239,338,294,2031,0,11911,13942,9095,0,0,9,9
8157,PRAKASAM,Addanki,CHAKRAYA PALEM,170,35,175,380,135,9,84,228,210,9104,230,4255,13589,9306,17,0,6,23
8158,PRAKASAM,Addanki,CHINAKOTHA PALLI,181,27,413,621,88,8,268,364,368,4204,166,9960,14330,7687,2,0,8,10
8159,PRAKASAM,Addanki,DHARMAVARAM,191,43,593,827,111,18,356,485,425,3455,201,13555,17211,11712,3,0,10,13
8160,PRAKASAM,Addanki,DHENUVA KONDA,208,7,335,550,0,0,0,0,0,0,0,0,0,0,0,0,0,0
8161,PRAKASAM,Addanki,GOPALAPURAM,112,133,90,335,78,11,49,138,120,3763,101,2114,5978,3308,2,0,2,4
8162,PRAKASAM,Addanki,GOVADA,293,37,346,676,218,26,187,431,401,5759,480,8785,15024,7598,0,0,1,1
8163,PRAKASAM,Addanki,JARLAPALEM,275,7,273,555,205,6,147,358,338,11074,165,8709,19948,11920,7,0,15,22
8164,PRAKASAM,Addanki,KALAVAKURU,203,36,506,745,136,3,216,355,319,5892,37,7939,13868,8177,4,0,10,14
8165,PRAKASAM,Addanki,KONGAPADU,100,2,127,229,78,2,86,166,155,6258,197,7262,13717,8542,24,1,35,60
8166,PRAKASAM,Addanki,KOTIKALAPUDI,187,2,361,550,112,0,111,223,231,6536,0,3083,9619,6237,17,0,0,17
8167,PRAKASAM,Addanki,KUNKUPADU,136,0,222,358,91,0,186,277,282,2713,0,7844,10557,6302,1,0,3,4
8168,PRAKASAM,Addanki,MANIKESWARAM,281,16,203,500,188,7,116,311,287,11241,268,5140,16649,10683,33,0,9,42
8169,PRAKASAM,Addanki,MODEPALLI,190,2,166,358,146,0,73,219,222,5465,0,1325,6790,3877,4,0,0,4
8170,PRAKASAM,Addanki,MYLAVARAM,121,18,159,298,99,14,121,234,214,7122,685,5995,13802,7720,20,0,2,22
8171,PRAKASAM,Addanki,NAGULAPADU,163,0,180,343,112,0,58,170,166,7676,0,2913,10589,8801,14,0,1,15
8172,PRAKASAM,Addanki,PERAYAPALEM,25,1,114,140,5,1,80,86,77,265,74,4043,4382,2539,0,0,10,10
8173,PRAKASAM,Addanki,RAMAYAPALEM,82,14,153,249,39,11,106,156,145,944,200,5691,6835,5463,1,0,7,8
8174,PRAKASAM,Addanki,SANKHAVARAPPADU,348,0,455,803,201,0,231,432,408,4824,0,4576,9400,6428,1,0,0,1
8175,PRAKASAM,Addanki,SINGARAKONDA PALEM,130,68,405,603,35,4,75,114,82,953,19,1426,2398,1002,0,0,0,0
8176,PRAKASAM,Addanki,THIMMAYAPALEM,251,8,347,606,91,2,147,240,206,2212,84,7282,9578,4765,3,0,10,13
8177,PRAKASAM,Addanki,UPPALAPADU,70,2,255,327,54,2,172,228,253,1975,74,8384,10433,5776,3,0,16,19
8178,PRAKASAM,Addanki,VELAMURIPADU,220,5,45,270,149,0,8,157,161,5612,0,101,5713,4191,5,0,0,5
8179,PRAKASAM,Addanki,VEMPARALA,234,20,356,610,153,12,222,387,371,7259,173,9785,17217,10787,8,0,12,20
8180,PRAKASAM,Addanki,VENKATAPURAM,166,38,91,295,142,6,48,196,164,10878,341,3812,15031,9104,35,0,14,49
8181,PRAKASAM,Addanki,VIPPARLAVARI PALEM,213,0,1,214,180,0,0,180,177,13894,0,0,13894,7648,51,0,0,51
8182,PRAKASAM,Ardhaveedu,ARDHAVEEDU,279,14,1327,1620,125,5,726,856,780,6280,231,32868,39379,22667,16,0,44,60
8183,PRAKASAM,Ardhaveedu,AYYAVARI PALLI,128,0,413,541,76,0,261,337,306,4694,0,18174,22868,13157,8,0,51,59
8184,PRAKASAM,Ardhaveedu,BOGOLU,70,0,286,356,46,0,169,215,206,3201,0,11531,14732,8723,4,0,29,33
8185,PRAKASAM,Ardhaveedu,BOLLU PALLI,255,25,520,800,159,19,332,510,492,7704,1031,14084,22819,12143,15,2,13,30
8186,PRAKASAM,Ardhaveedu,DONAKONDA,184,8,417,609,102,0,257,359,333,3954,0,13746,17700,10678,5,0,21,26
8187,PRAKASAM,Ardhaveedu,GANNEPALLI,48,15,344,407,34,4,256,294,256,1532,141,12708,14381,7735,1,0,22,23
8188,PRAKASAM,Ardhaveedu,KAKARLA,189,0,618,807,107,0,390,497,506,5973,0,22348,28321,17088,15,0,51,66
8189,PRAKASAM,Ardhaveedu,MAGUTUR,65,240,555,860,50,133,379,562,655,3134,9567,21400,34101,18401,13,39,50,102
8190,PRAKASAM,Ardhaveedu,MOHIDDIN PURAM,58,0,631,689,35,0,377,412,383,1306,0,17029,18335,12201,1,0,9,10
8191,PRAKASAM,Ardhaveedu,NAGULAVARAM,127,2,636,765,69,1,363,433,428,2059,6,13781,15846,9833,2,0,11,13
8192,PRAKASAM,Ardhaveedu,PAPINENI PALLI,160,39,1018,1217,83,2,470,555,492,3374,47,23402,26823,15890,5,0,55,60
8193,PRAKASAM,Ardhaveedu,PEDDA KANDUKUR,130,128,443,701,100,94,314,508,516,7992,5622,21359,34973,18637,23,7,50,80
8194,PRAKASAM,Ardhaveedu,RANGAPURAM,123,73,262,458,73,58,171,302,276,4253,3562,9197,17012,9335,13,11,16,40
8195,PRAKASAM,Ardhaveedu,VELAGALAPAYA,150,136,417,703,96,4,249,349,349,6165,22,13300,19487,10869,19,0,20,39
8196,PRAKASAM,Ardhaveedu,YACHAVARAM,151,47,392,590,104,29,223,356,371,4871,603,5216,10690,5383,9,0,1,10
8197,PRAKASAM,Ballikuruva,BALLIKURAVA,270,33,391,694,155,1,131,287,279,3097,20,4008,7125,4188,0,0,4,4
8198,PRAKASAM,Ballikuruva,CHENNUPALLI,244,4,252,500,131,0,162,293,276,3183,0,7931,11114,6708,1,0,14,15
8199,PRAKASAM,Ballikuruva,GORRE PADU,54,2,128,184,12,0,34,46,37,204,0,857,1061,669,0,0,0,0
8200,PRAKASAM,Ballikuruva,GUNTU PALLI,38,17,400,455,20,1,207,228,221,346,3,3054,3403,2215,0,0,0,0
8201,PRAKASAM,Ballikuruva,K.RAJUPALEM,1,1,221,223,0,0,124,124,116,0,0,6847,6847,4469,0,0,10,10
8202,PRAKASAM,Ballikuruva,KOMMINENIVARIPALEM,226,5,403,634,91,1,142,234,188,4167,12,6787,10966,5725,13,0,17,30
8203,PRAKASAM,Ballikuruva,KONIDENA,287,16,840,1143,190,3,248,441,441,9679,27,9414,19120,13584,27,0,15,42
8204,PRAKASAM,Ballikuruva,KOPPERA PADU,235,104,512,851,120,13,145,278,282,7898,226,4998,13122,8120,29,0,4,33
8205,PRAKASAM,Ballikuruva,KOPPERA PALEM,276,24,379,679,91,11,196,298,287,2662,289,7030,9981,5405,4,0,8,12
8206,PRAKASAM,Ballikuruva,KOTHURU,86,135,189,410,51,88,124,263,246,2354,4455,7271,14080,7664,2,14,18,34
8207,PRAKASAM,Ballikuruva,KUKATLA PALLI,232,119,299,650,153,38,106,297,269,5682,1137,2965,9784,6589,6,0,0,6
8208,PRAKASAM,Ballikuruva,MUKTESWARAM,270,24,707,1001,172,6,339,517,459,5736,216,13891,19843,12410,3,0,16,19
8209,PRAKASAM,Ballikuruva,NAKKABOKKALAPADU,150,0,396,546,142,0,290,432,397,9453,0,8666,18119,9775,19,0,2,21
8210,PRAKASAM,Ballikuruva,PATHA MALLAYAPALEM,154,94,432,680,111,36,289,436,416,3437,1562,10489,15488,9265,7,3,8,18
8211,PRAKASAM,Ballikuruva,PEDA AMBADIPUDI,376,4,501,881,193,2,235,430,376,8102,16,10630,18748,11905,18,0,16,34
8212,PRAKASAM,Ballikuruva,SANKARALINGAM GUDIPADU,96,52,319,467,5,1,75,81,67,69,52,1438,1559,869,0,0,0,0
8213,PRAKASAM,Ballikuruva,UPPUMAGULUR,466,98,485,1049,175,17,176,368,328,2676,100,2540,5316,2775,0,0,0,0
8214,PRAKASAM,Ballikuruva,VAIDANA,171,7,550,728,40,2,164,206,177,1035,37,5554,6626,4597,4,0,3,7
8215,PRAKASAM,Ballikuruva,VALLAPALLI,265,13,201,479,150,8,67,225,213,5150,481,2697,8328,4680,4,0,1,5
8216,PRAKASAM,Ballikuruva,VELAMAVARI PALEM,240,10,197,447,190,7,129,326,315,10443,549,7444,18436,10336,17,0,8,25
8217,PRAKASAM,Ballikuruva,VEMAVARAM,39,76,274,389,13,29,141,183,165,350,2074,4146,6570,3523,0,9,2,11
8218,PRAKASAM,Bestavaripeta,AKKAPALLI,33,0,295,328,29,0,236,265,274,2511,0,16820,19331,11564,13,0,50,63
8219,PRAKASAM,Bestavaripeta,BASINE PALLI,221,5,687,913,122,3,472,597,610,8435,105,33610,42150,22997,34,0,108,142
8220,PRAKASAM,Bestavaripeta,BESTHAVARIPET,288,23,696,1007,151,0,170,321,285,6542,0,5199,11741,7054,7,0,6,13
8221,PRAKASAM,Bestavaripeta,CHETTICHERLA,123,2,274,399,67,2,216,285,272,2405,28,15230,17663,11024,5,0,26,31
8222,PRAKASAM,Bestavaripeta,CHINA OBINENIPALLE,42,1,180,223,36,0,173,209,202,2182,0,12743,14925,8604,6,0,38,44
8223,PRAKASAM,Bestavaripeta,GALIJERUGULLA,258,4,1017,1279,162,1,643,806,849,7562,68,33412,41042,24123,8,0,41,49
8224,PRAKASAM,Bestavaripeta,J.C.AGRAHARAM,220,0,699,919,137,0,384,521,555,6549,0,17755,24304,13303,3,0,44,47
8225,PRAKASAM,Bestavaripeta,JAGGAMBOTLAKRISHNAPURAM,2,5,325,332,0,1,273,274,277,0,38,17031,17069,9387,0,0,43,43
8226,PRAKASAM,Bestavaripeta,KHAJIPURAM,120,0,355,475,89,0,298,387,409,4666,0,16153,20819,12586,11,0,22,33
8227,PRAKASAM,Bestavaripeta,KONA PALLI,141,0,380,521,114,0,277,391,385,7614,0,17052,24666,13254,27,0,40,67
8228,PRAKASAM,Bestavaripeta,MADHANA PULLALA CHERUVU,110,0,437,547,80,0,319,399,431,6041,0,18472,24513,14707,22,0,24,46
8229,PRAKASAM,Bestavaripeta,MOKSHA GUNDAM,71,0,525,596,40,0,396,436,445,3242,0,25189,28431,16893,19,0,52,71
8230,PRAKASAM,Bestavaripeta,NEKUNAMBAD,186,0,217,403,99,0,143,242,216,4112,0,8280,12392,7446,7,0,16,23
8231,PRAKASAM,Bestavaripeta,PACHALA VENKATA PURAM,40,1,254,295,35,1,234,270,244,2421,76,15788,18285,11019,10,0,42,52
8232,PRAKASAM,Bestavaripeta,PANDILLAPALLI,95,0,384,479,55,0,261,316,297,3457,0,17846,21303,12121,10,0,62,72
8233,PRAKASAM,Bestavaripeta,PEDA OBINENIPALLE,122,0,356,478,99,0,266,365,383,8191,0,15029,23220,12020,38,0,44,82
8234,PRAKASAM,Bestavaripeta,PITIKAYAGULLA,129,8,610,747,71,4,374,449,452,4957,160,24947,30064,18074,17,0,51,68
8235,PRAKASAM,Bestavaripeta,PUSALAPADU,178,0,745,923,98,0,454,552,551,4635,0,23009,27644,16309,5,0,27,32
8236,PRAKASAM,Bestavaripeta,SALAKALAVEEDU,185,3,713,901,133,3,573,709,787,11587,247,41506,53340,29702,58,0,125,183
8237,PRAKASAM,Chadrasekarapuram,A.KOTHA PALLI,13,0,183,196,10,0,109,119,135,516,0,6076,6592,4301,0,0,9,9
8238,PRAKASAM,Chadrasekarapuram,AMBAVARAM,18,3,158,179,3,2,68,73,74,93,41,1923,2057,1290,0,0,0,0
8239,PRAKASAM,Chadrasekarapuram,ANIKALA PALLI,25,0,155,180,11,0,115,126,146,194,0,2128,2322,1486,0,0,0,0
8240,PRAKASAM,Chadrasekarapuram,ARIVEMULA,165,4,476,645,29,0,220,249,261,587,0,3475,4062,2362,0,0,0,0
8241,PRAKASAM,Chadrasekarapuram,AYYALURIVARI PALLI,25,2,203,230,15,0,112,127,127,166,0,1841,2007,1350,0,0,0,0
8242,PRAKASAM,Chadrasekarapuram,BOYAMADUGULA,106,140,430,676,39,34,133,206,246,2044,1554,6654,10252,6036,2,1,8,11
8243,PRAKASAM,Chadrasekarapuram,CHANDRA SEKHARA PURAM,155,69,1706,1930,72,18,626,716,754,1350,545,14926,16821,11891,1,0,7,8
8244,PRAKASAM,Chadrasekarapuram,CHENNAPANAYUNI PALLE,61,1,275,337,33,0,217,250,298,1132,0,7260,8392,4763,1,0,0,1
8245,PRAKASAM,Chadrasekarapuram,CHERLOPALLI,94,7,426,527,19,0,91,110,122,1328,0,5628,6956,4898,2,0,16,18
8246,PRAKASAM,Chadrasekarapuram,CHINTHAPUDI,78,3,372,453,39,2,260,301,310,1040,133,10505,11678,6561,0,0,8,8
8247,PRAKASAM,Chadrasekarapuram,DARSIGUNTA PETA,181,7,693,881,79,1,294,374,413,1118,28,9410,10556,7158,0,0,8,8
8248,PRAKASAM,Chadrasekarapuram,K.AGRAHARAM,44,2,359,405,6,0,18,24,21,86,0,263,349,160,0,0,0,0
8249,PRAKASAM,Chadrasekarapuram,KAMBHAM PADU,22,3,183,208,1,0,11,12,8,20,0,118,138,61,0,0,0,0
8250,PRAKASAM,Chadrasekarapuram,KOVILAM PADU,120,7,515,642,76,3,306,385,444,1494,50,6053,7597,4640,0,0,0,0
8251,PRAKASAM,Chadrasekarapuram,NALLAMADUGULA,109,33,296,438,60,0,26,86,98,2729,0,821,3550,2064,6,0,2,8
8252,PRAKASAM,Chadrasekarapuram,PEDA GOGULAPALLI,104,1,446,551,49,0,102,151,155,1620,0,3308,4928,2963,1,0,2,3
8253,PRAKASAM,Chadrasekarapuram,PEDARAJU PALEM,94,3,448,545,56,0,317,373,418,579,0,3671,4250,2686,0,0,0,0
8254,PRAKASAM,Chadrasekarapuram,PULLAGURA PALLI,72,18,294,384,20,10,81,111,113,487,261,3290,4038,2432,0,0,2,2
8255,PRAKASAM,Chadrasekarapuram,REDDYGARI KOTHAPALLI,127,1,296,424,83,1,171,255,272,4183,9,8871,13063,8061,5,0,15,20
8256,PRAKASAM,Chadrasekarapuram,REGULA CHILAKA,61,27,323,411,30,17,215,262,315,867,871,7962,9700,5922,0,1,2,3
8257,PRAKASAM,Chadrasekarapuram,UPPALAPADU,125,45,339,509,72,6,229,307,413,2963,120,5783,8866,5120,3,0,1,4
8258,PRAKASAM,Chadrasekarapuram,VATLA BAYALU,82,0,407,489,51,0,316,367,468,1441,0,9981,11422,6029,0,0,0,0
8259,PRAKASAM,Chadrasekarapuram,VENGANAGUNTA,112,0,268,380,69,0,143,212,224,3626,0,10352,13978,8686,4,0,44,48
8260,PRAKASAM,Chimakurthi,BANDLA MUDI,271,7,285,563,100,3,124,227,226,3763,73,5702,9538,8109,8,0,4,12
8261,PRAKASAM,Chimakurthi,BHUSURAPALLI,112,1,153,266,63,0,51,114,116,3868,0,2304,6172,4740,16,0,9,25
8262,PRAKASAM,Chimakurthi,BUDAWADA,324,32,331,687,73,3,18,94,94,894,12,244,1150,862,0,0,0,0
8263,PRAKASAM,Chimakurthi,CHANDRA PADU,299,20,432,751,165,2,183,350,311,5849,47,3813,9709,6610,4,0,0,4
8264,PRAKASAM,Chimakurthi,CHIMAKURTHI,251,70,191,512,0,0,0,0,0,0,0,0,0,0,0,0,0,0
8265,PRAKASAM,Chimakurthi,CHINARAVIPADU,89,0,239,328,34,0,91,125,119,1421,0,3695,5116,4362,2,0,0,2
8266,PRAKASAM,Chimakurthi,DEVARA PALEM,205,41,605,851,117,5,434,556,563,4247,104,9148,13499,9297,1,0,0,1
8267,PRAKASAM,Chimakurthi,GADIPARTHIVARI PALEM,111,15,271,397,52,14,133,199,203,1529,432,4225,6186,4642,1,0,2,3
8268,PRAKASAM,Chimakurthi,GONUGUNTA,212,1,322,535,110,1,175,286,298,4347,26,6017,10390,7352,0,0,1,1
8269,PRAKASAM,Chimakurthi,ILAPAVULUR,153,1,422,576,88,0,242,330,325,4492,0,10838,15330,11248,8,0,12,20
8270,PRAKASAM,Chimakurthi,KUNAMANENI VARI PALEM,309,7,57,373,136,1,0,137,133,930,2,0,932,712,0,0,0,0
8271,PRAKASAM,Chimakurthi,MANCHIKALAPADU,289,17,174,480,138,1,74,213,198,5207,12,2724,7943,5944,2,0,0,2
8272,PRAKASAM,Chimakurthi,MUVVAVARIPALEM,99,40,376,515,47,2,194,243,201,1242,114,7553,8909,6789,0,0,2,2
8273,PRAKASAM,Chimakurthi,NEKUNAM BADU,110,2,144,256,70,0,97,167,154,5271,0,6551,11822,8216,16,0,24,40
8274,PRAKASAM,Chimakurthi,NIPPATLAPADU,157,39,424,620,89,20,244,353,374,3871,697,10318,14886,11276,6,1,16,23
8275,PRAKASAM,Chimakurthi,PADAMATI NAYUDU PALEM,542,12,234,788,188,0,16,204,193,5904,0,191,6095,4546,1,0,0,1
8276,PRAKASAM,Chimakurthi,PALLA MALLI,363,35,555,953,169,5,221,395,389,5999,289,7295,13583,9939,3,0,5,8
8277,PRAKASAM,Chimakurthi,PIDATHALAPUDI,73,11,104,188,41,8,65,114,113,2906,451,4083,7440,5181,12,1,11,24
8278,PRAKASAM,Chimakurthi,PULIKONDA,366,12,393,771,159,7,104,270,267,4954,188,2211,7353,5129,1,0,0,1
8279,PRAKASAM,Chimakurthi,RAJU PALEM LAXMI PURAM,228,10,72,310,69,1,20,90,84,2083,14,354,2451,1793,1,0,0,1
8280,PRAKASAM,Chimakurthi,RAMACHANDRA PURAM,106,14,392,512,32,4,263,299,281,1686,207,16930,18823,14750,6,0,39,45
8281,PRAKASAM,Chimakurthi,TORRAGUDI PADU,173,2,206,381,98,0,131,229,215,4073,0,6196,10269,8242,1,0,3,4
8282,PRAKASAM,Chimakurthi,YELURIVARI PALEM,128,2,145,275,81,1,105,187,184,4286,21,6839,11146,6798,6,0,17,23
8283,PRAKASAM,Chimakurthi,YERRAGUDIPADU,119,17,121,257,75,0,57,132,137,2987,0,2534,5521,4480,1,0,2,3
8284,PRAKASAM,Chinaganjam,CHINAGANJAM,320,66,682,1068,38,2,100,140,108,649,20,1400,2069,789,0,0,1,1
8285,PRAKASAM,Chinaganjam,CHINTHAGUM PALLI,260,0,150,410,195,0,92,287,267,10459,0,3759,14218,7690,8,0,2,10
8286,PRAKASAM,Chinaganjam,GONASAPUDI,260,9,289,558,210,5,198,413,388,16792,443,11134,28369,14291,65,3,17,85
8287,PRAKASAM,Chinaganjam,KADAVAKUDURU,128,115,796,1039,87,20,421,528,491,4755,345,16287,21387,12356,6,0,11,17
8288,PRAKASAM,Chinaganjam,KOTHAPALEM,83,13,665,761,25,0,159,184,142,444,0,2992,3436,1700,0,0,2,2
8289,PRAKASAM,Chinaganjam,MOTU PALLI,3,32,723,758,0,0,87,87,74,0,0,949,949,442,0,0,0,0
8290,PRAKASAM,Chinaganjam,MUNNAMVARI PALEM,96,23,584,703,49,1,174,224,190,3031,95,5016,8142,5377,7,0,11,18
8291,PRAKASAM,Chinaganjam,NEELAYAPALEM,2,10,87,99,0,2,46,48,39,0,4,3428,3432,1762,0,0,24,24
8292,PRAKASAM,Chinaganjam,PALLEPALEM,0,1,541,542,0,0,134,134,103,0,0,7982,7982,5015,0,0,24,24
8293,PRAKASAM,Chinaganjam,PEDAGANJAM,230,58,1772,2060,153,3,510,666,587,7499,24,11638,19161,10026,6,0,18,24
8294,PRAKASAM,Chinaganjam,RAJU BANGARU PALEM,22,149,693,864,17,14,210,241,197,951,83,6288,7322,3707,0,0,9,9
8295,PRAKASAM,Chinaganjam,SANTHARAVUR,480,30,366,876,384,12,232,628,627,17440,468,7456,25364,13905,19,0,0,19
8296,PRAKASAM,Chirala,BURLAVARI PALEM,229,53,460,742,121,11,279,411,335,3335,163,7984,11482,4638,2,0,8,10
8297,PRAKASAM,Chirala,CHIRALA (RURAL),22,4,905,931,3,0,327,330,307,80,0,8404,8484,6843,0,0,1,1
8298,PRAKASAM,Chirala,DEVANGAPURI,111,130,370,611,7,6,18,31,10,102,98,218,418,115,0,0,0,0
8299,PRAKASAM,Chirala,DEVINUTALA,54,4,378,436,36,0,135,171,40,829,0,2059,2888,533,0,0,1,1
8300,PRAKASAM,Chirala,EPURU PALEM,150,198,1530,1878,64,31,443,538,276,844,998,5712,7554,4048,0,0,0,0
8301,PRAKASAM,Chirala,GANDHI NAGAR,2,3,37,42,0,0,0,0,0,0,0,0,0,0,0,0,0,0
8302,PRAKASAM,Chirala,GAVINIVARI PALEM,96,20,1493,1609,24,0,575,599,74,268,0,16099,16367,1012,0,0,15,15
8303,PRAKASAM,Chirala,KANURUVARIPALEM,331,0,1112,1443,136,0,250,386,98,2048,0,4247,6295,895,0,0,1,1
8304,PRAKASAM,Chirala,KOTHA PALEM,93,79,542,714,0,0,0,0,0,0,0,0,0,0,0,0,0,0
8305,PRAKASAM,Chirala,PITTUVARIPALEM,48,1,363,412,32,1,281,314,254,844,17,11775,12636,6198,0,0,23,23
8306,PRAKASAM,Chirala,RAMAKRISHNAPURAM,93,22,190,305,0,0,0,0,0,0,0,0,0,0,0,0,0,0
8307,PRAKASAM,Chirala,SALMON CENTRE,10,2,142,154,0,0,0,0,0,0,0,0,0,0,0,0,0,0
8308,PRAKASAM,Chirala,THOTAVARIPALEM,423,84,746,1253,185,8,290,483,381,2750,106,3720,6576,2829,0,0,0,0
8309,PRAKASAM,Chirala,VIJAYANAGAR COLONY,424,0,2,426,145,0,0,145,134,1556,0,0,1556,845,0,0,0,0
8310,PRAKASAM,Chirala,VODAREVU,85,4,2035,2124,7,0,383,390,263,74,0,5366,5440,3184,0,0,3,3
8311,PRAKASAM,Cumbum,AURANGABAD,10,1,221,232,5,0,113,118,116,453,0,9837,10290,5934,3,0,54,57
8312,PRAKASAM,Cumbum,CHINA CUMBUM,170,1,417,588,82,1,130,213,213,2065,40,3056,5161,3263,1,0,2,3
8313,PRAKASAM,Cumbum,CUMBUM,83,31,712,826,14,3,234,251,236,232,36,7591,7859,5579,0,0,5,5
8314,PRAKASAM,Cumbum,DARGA,1,0,255,256,1,0,201,202,185,37,0,7113,7150,4686,0,0,1,1
8315,PRAKASAM,Cumbum,HAZARAT GUDEM,1,0,212,213,1,0,142,143,137,29,0,6681,6710,4048,0,0,1,1
8316,PRAKASAM,Cumbum,JANGAMGUNTLA,121,0,323,444,81,0,88,169,167,3879,0,2964,6843,4411,6,0,3,9
8317,PRAKASAM,Cumbum,KANDULA PURAM,101,10,594,705,55,1,328,384,370,2516,39,7293,9848,5635,7,0,2,9
8318,PRAKASAM,Cumbum,LAKSHMI KOTA,92,1,553,646,66,1,433,500,510,4880,20,24083,28983,18039,26,0,48,74
8319,PRAKASAM,Cumbum,LINGAPURAM,70,0,293,363,47,0,219,266,266,2405,0,10925,13330,7663,5,0,15,20
8320,PRAKASAM,Cumbum,NARISIREDDY PALLI,51,9,209,269,43,1,157,201,213,3262,69,11607,14938,8786,14,0,43,57
8321,PRAKASAM,Cumbum,PEDANALLA KALVA,115,1,366,482,46,0,173,219,207,1911,0,6192,8103,4659,2,0,4,6
8322,PRAKASAM,Cumbum,RAVIPADU,110,19,801,930,60,10,506,576,631,3641,781,15754,20176,10493,11,5,16,32
8323,PRAKASAM,Cumbum,THURIMELLA,86,5,1084,1175,28,0,619,647,602,1760,0,24419,26179,15987,7,0,7,14
8324,PRAKASAM,Cumbum,YERRABALEM,116,9,553,678,97,6,442,545,567,7209,194,14292,21695,12269,29,0,12,41
8325,PRAKASAM,Darsi,BANDIVELIGANDLA,113,1,491,605,62,0,272,334,380,1339,0,6426,7765,5261,0,0,2,2
8326,PRAKASAM,Darsi,BASIREDDIPALLI,1,1,381,383,0,1,297,298,285,0,22,17413,17435,10703,0,0,34,34
8327,PRAKASAM,Darsi,BOTLAPALEM,314,32,828,1174,104,3,452,559,538,1998,60,16016,18074,14184,1,0,4,5
8328,PRAKASAM,Darsi,CHANDALUR,117,0,538,655,41,0,263,304,298,1324,0,13124,14448,8547,1,0,23,24
8329,PRAKASAM,Darsi,DARSI,857,124,3558,4539,282,22,1378,1682,1553,6992,360,28525,35877,25181,4,0,1,5
8330,PRAKASAM,Darsi,DEVAVARAM,180,1,469,650,117,0,334,451,434,6342,0,15110,21452,12210,4,0,4,8
8331,PRAKASAM,Darsi,EAST CHOUTAPALEM,537,2,398,937,289,0,1,290,287,12767,0,71,12838,8078,14,0,0,14
8332,PRAKASAM,Darsi,EAST VEERAYA PALEM,310,55,496,861,121,6,240,367,308,3941,82,4920,8943,5247,0,0,1,1
8333,PRAKASAM,Darsi,EAST VENKATA PURAM,203,1,526,730,121,1,349,471,461,6006,22,10902,16930,9649,1,0,3,4
8334,PRAKASAM,Darsi,JAMUKULADINNE,2,0,265,267,0,0,175,175,173,0,0,9580,9580,5954,0,0,15,15
8335,PRAKASAM,Darsi,KORLAMADUGU,52,1,142,195,43,1,113,157,167,2834,58,6784,9676,7036,9,0,12,21
8336,PRAKASAM,Darsi,KOTHAPALLI,217,33,476,726,93,16,293,402,391,4123,710,15272,20105,12726,9,2,27,38
8337,PRAKASAM,Darsi,LANKOJANA PALLI,152,1,430,583,112,1,308,421,414,5952,116,9193,15261,9286,12,1,3,16
8338,PRAKASAM,Darsi,MAREDDY PALLI,20,0,164,184,15,0,136,151,142,1330,0,9838,11168,6792,7,0,30,37
8339,PRAKASAM,Darsi,PAPIREDDY PALEM,2,93,229,324,1,37,158,196,189,9,1816,9809,11634,6284,0,4,18,22
8340,PRAKASAM,Darsi,PEDA VUYYALAWADA,183,8,365,556,90,2,180,272,270,2673,89,5839,8601,6146,0,0,0,0
8341,PRAKASAM,Darsi,POTHA KAMURU,155,0,281,436,102,0,161,263,250,4939,0,9281,14220,9191,3,0,23,26
8342,PRAKASAM,Darsi,POTHAVARAM,164,107,477,748,87,49,319,455,449,5631,2192,18028,25851,15340,15,2,31,48
8343,PRAKASAM,Darsi,RAJAM PALLI,734,40,797,1571,219,11,417,647,612,6471,586,13407,20464,12226,4,2,4,10
8344,PRAKASAM,Darsi,RAMACHANDRA PURAM,103,6,258,367,53,1,163,217,195,2536,19,7241,9796,6357,1,0,2,3
8345,PRAKASAM,Darsi,SAMANTHAPUDI,125,36,633,794,57,9,310,376,428,1267,214,11780,13261,7838,1,0,14,15
8346,PRAKASAM,Darsi,THANAM CHINTALA,97,2,319,418,56,0,220,276,277,1624,0,13439,15063,8193,0,0,23,23
8347,PRAKASAM,Darsi,THRIPURASUNDARI PURAM,52,5,198,255,34,1,156,191,188,2351,8,6680,9039,6192,8,0,4,12
8348,PRAKASAM,Darsi,THUMMEDALAPADU,49,0,217,266,25,0,175,200,179,452,0,11116,11568,7000,0,0,25,25
8349,PRAKASAM,Darsi,VENKATACHALAM PALLI,263,3,579,845,120,2,388,510,472,3279,91,14860,18230,11410,0,0,2,2
8350,PRAKASAM,Darsi,YERRAOBANA PALLI,117,44,219,380,62,6,161,229,225,2451,60,6323,8834,5014,1,0,2,3
8351,PRAKASAM,Donakonda,ARAVALLIPADU,296,10,809,1115,165,1,409,575,551,4510,21,18052,22583,13295,2,0,32,34
8352,PRAKASAM,Donakonda,BHUMANAPALLI,163,0,247,410,94,0,165,259,289,6281,0,12495,18776,9536,19,0,30,49
8353,PRAKASAM,Donakonda,CHANDAVARAM,447,23,1272,1742,193,21,894,1108,1033,8768,1252,41748,51768,26507,15,1,40,56
8354,PRAKASAM,Donakonda,DONAKONDA R.S.,681,14,1091,1786,375,1,470,846,701,17868,5,21760,39633,21917,28,0,20,48
8355,PRAKASAM,Donakonda,GANGADEVIPALLI,290,1,783,1074,5,0,155,160,132,65,0,1716,1781,875,0,0,0,0
8356,PRAKASAM,Donakonda,INDLA CHERUVU,605,4,742,1351,258,3,481,742,668,13062,67,25499,38628,21062,19,0,33,52
8357,PRAKASAM,Donakonda,KOCHERLA KOTA,758,2,1125,1885,329,0,532,861,723,5673,0,8284,13957,7177,0,0,0,0
8358,PRAKASAM,Donakonda,MALLAM PETA,300,10,418,728,98,7,233,338,331,2117,260,7049,9426,5037,1,0,1,2
8359,PRAKASAM,Donakonda,MANGINAPUDI,279,5,1045,1329,163,4,556,723,650,6819,198,29834,36851,19266,9,0,72,81
8360,PRAKASAM,Donakonda,PADAMARA LAKSHMIPURAM,69,3,390,462,45,3,246,294,357,3539,217,17155,20911,11049,20,1,65,86
8361,PRAKASAM,Donakonda,PADAMATI VENKATA PURAM,149,2,254,405,98,1,92,191,250,7187,36,4909,12132,6352,22,0,4,26
8362,PRAKASAM,Donakonda,PEDDANNAPALEM,188,1,719,908,68,0,415,483,569,1420,0,16194,17614,8848,0,0,16,16
8363,PRAKASAM,Donakonda,POLE PALLI,562,0,1283,1845,268,0,762,1030,983,18762,0,34660,53422,25776,39,0,42,81
8364,PRAKASAM,Donakonda,RAMAPURAM,111,0,403,514,75,0,235,310,331,2680,0,11970,14650,7645,0,0,7,7
8365,PRAKASAM,Donakonda,RUDRA SAMUDRAM,190,12,620,822,131,0,400,531,535,8730,0,17912,26642,13137,21,0,18,39
8366,PRAKASAM,Donakonda,SANGAPURAM,90,0,343,433,54,0,225,279,280,3852,0,9481,13333,6572,14,0,10,24
8367,PRAKASAM,Donakonda,Tella Padu,0,0,0,0,0,0,0,0,0,0,0,0,0,0,0,0,0,0
8368,PRAKASAM,Donakonda,VADDIPADU,243,0,454,697,121,0,207,328,318,9598,0,11968,21566,10621,47,0,31,78
8369,PRAKASAM,Dornala,CHINA DORNALA,121,0,343,464,74,0,239,313,330,3037,0,13619,16656,10722,3,0,35,38
8370,PRAKASAM,Dornala,CHINAGUDIPADU,219,257,805,1281,104,0,370,474,392,4138,0,18222,22360,12705,3,0,22,25
8371,PRAKASAM,Dornala,GANTAVARI PALLI,162,877,416,1455,119,174,263,556,550,6868,16014,15503,38385,20719,15,49,26,90
8372,PRAKASAM,Dornala,JAMMIDORNALA,277,0,408,685,91,0,228,319,328,4033,0,13089,17122,8690,11,0,26,37
8373,PRAKASAM,Dornala,KATA KANI PALLI,176,1,761,938,114,1,508,623,613,3853,41,14535,18429,8945,0,0,2,2
8374,PRAKASAM,Dornala,NALLAGUNTLA,255,1381,582,2218,121,214,286,621,630,4384,16540,11379,32303,16490,3,58,12,73
8375,PRAKASAM,Dornala,P. BOMMALAPURAM,5,364,35,404,1,92,0,93,101,120,9407,0,9527,5026,1,46,0,47
8376,PRAKASAM,Dornala,PEDA BOMMALA PURAM,516,476,1372,2364,302,167,872,1341,1202,17589,12580,34946,65115,33376,52,52,15,119
8377,PRAKASAM,Dornala,PEDA DORNALA,993,580,1629,3202,271,197,811,1279,1088,6352,10493,21358,38203,21770,4,16,9,29
8378,PRAKASAM,Dornala,PEDDA DORNALA,733,1572,2165,4470,239,511,833,1583,1418,9404,28011,41603,79018,47050,15,52,65,132
8379,PRAKASAM,Dornala,RAMACHANDRA KOTA,216,7,299,522,144,4,205,353,390,6154,245,9151,15550,8373,6,0,7,13
8380,PRAKASAM,Dornala,YADAVALLI,230,4,548,782,103,2,280,385,358,3521,33,6355,9909,4803,3,0,0,3
8381,PRAKASAM,Dornala,YEGUVA CHERLO PALLI,514,1488,675,2677,230,287,378,895,810,10510,13817,19307,43634,22478,32,21,44,97
8382,PRAKASAM,Giddaluru,ADIMURTHY PALLI,26,0,214,240,20,0,172,192,197,1232,0,8299,9531,5765,6,0,9,15
8383,PRAKASAM,Giddaluru,AMBAVARAM,200,0,409,609,119,0,230,349,369,7269,0,14485,21754,15637,20,0,41,61
8384,PRAKASAM,Giddaluru,GADIKOTA,100,76,570,746,63,31,377,471,473,2842,2218,18778,23838,15665,6,10,18,34
8385,PRAKASAM,Giddaluru,GIDDALUR,284,7,843,1134,28,1,48,77,66,348,4,424,776,483,0,0,0,0
8386,PRAKASAM,Giddaluru,JAYARAMAPURAM,101,36,256,393,73,19,209,301,311,5286,1766,16961,24013,13723,20,10,74,104
8387,PRAKASAM,Giddaluru,KANCHI PALLI,87,30,634,751,59,16,259,334,326,1640,1039,9905,12584,8147,1,5,20,26
8388,PRAKASAM,Giddaluru,KOMMUNURU,149,0,710,859,86,0,396,482,527,6522,0,27295,33817,19447,29,0,76,105
8389,PRAKASAM,Giddaluru,KONGALA VEEDU,49,74,334,457,19,24,216,259,261,1005,940,10848,12793,8881,4,1,16,21
8390,PRAKASAM,Giddaluru,KOTHAKOTA,72,0,454,526,47,0,328,375,362,2742,0,18808,21550,13739,4,0,46,50
8391,PRAKASAM,Giddaluru,KRISHNAM SETTY PALLI,440,260,1029,1729,249,94,424,767,779,9991,1836,14940,26767,18743,6,0,2,8
8392,PRAKASAM,Giddaluru,MUNDLA PADU,151,136,1464,1751,31,62,693,786,762,1097,1413,23652,26162,19264,2,0,22,24
8393,PRAKASAM,Giddaluru,NARAVA,82,1,549,632,60,0,337,397,387,2965,0,16527,19492,13601,6,0,18,24
8394,PRAKASAM,Giddaluru,OBULAPURAM,113,67,353,533,103,66,316,485,493,5235,6588,14975,26798,15635,9,44,15,68
8395,PRAKASAM,Giddaluru,PODILI KONDA PALLE,139,0,667,806,64,0,301,365,348,4657,0,3328,7985,4574,16,0,0,16
8396,PRAKASAM,Giddaluru,SANJEEVARAO PETA,217,6,562,785,181,3,436,620,618,9250,61,13782,23093,13878,16,0,4,20
8397,PRAKASAM,Giddaluru,THAMBALLA PALLI,7,0,372,379,3,0,226,229,256,77,0,10656,10733,6763,0,0,27,27
8398,PRAKASAM,Giddaluru,THIMMA PURAM,32,0,312,344,18,0,201,219,224,1094,0,12159,13253,8727,4,0,24,28
8399,PRAKASAM,Giddaluru,VELLUPALLI,0,44,497,541,0,41,398,439,501,0,2236,21959,24195,13238,0,1,31,32
8400,PRAKASAM,Giddaluru,VUYYALA WADA,238,24,673,935,174,14,458,646,679,8475,523,15345,24343,14561,13,0,22,35
8401,PRAKASAM,Gudluru,ADAVIRAJU PALEM,219,15,191,425,148,9,143,300,311,8753,228,5929,14910,9729,21,0,2,23
8402,PRAKASAM,Gudluru,AMMAVARI PALEM,328,9,237,574,143,6,124,273,277,7547,261,7043,14851,9116,21,0,12,33
8403,PRAKASAM,Gudluru,BASIREDDY PALEM,248,5,872,1125,119,3,462,584,551,3644,5,9550,13199,9642,3,0,2,5
8404,PRAKASAM,Gudluru,CHEVURU,349,167,362,878,57,8,131,196,221,733,77,2530,3340,2111,0,0,0,0
8405,PRAKASAM,Gudluru,CHIMIDTHIPADU,162,23,241,426,100,10,142,252,233,7225,433,9723,17381,14119,27,1,43,71
8406,PRAKASAM,Gudluru,CHINALA TRAPI,186,199,596,981,106,74,373,553,531,6079,2754,18173,27006,17630,15,4,31,50
8407,PRAKASAM,Gudluru,DAPPALAMPADU,98,15,145,258,50,11,104,165,174,1854,447,3977,6278,4512,0,0,2,2
8408,PRAKASAM,Gudluru,DARAKANI PADU,194,0,517,711,93,0,256,349,314,3356,0,7498,10854,8059,4,0,0,4
8409,PRAKASAM,Gudluru,ELERUPADU,202,55,147,404,121,6,97,224,183,6497,89,5636,12222,8941,13,0,10,23
8410,PRAKASAM,Gudluru,GUDLUR,359,87,1119,1565,198,18,610,826,802,8105,133,34131,42369,31441,12,0,86,98
8411,PRAKASAM,Gudluru,GUNDLA PALEM,219,7,173,399,96,7,106,209,195,6311,403,8177,14891,12578,15,0,32,47
8412,PRAKASAM,Gudluru,KOTHA PETA,174,10,211,395,109,0,105,214,209,1912,0,1525,3437,2294,0,0,0,0
8413,PRAKASAM,Gudluru,MOCHARLA,368,221,543,1132,59,44,160,263,203,309,419,1560,2288,1376,0,0,0,0
8414,PRAKASAM,Gudluru,MOGALLUR,158,36,64,258,132,35,44,211,224,9772,1285,3115,14172,9645,49,2,10,61
8415,PRAKASAM,Gudluru,NAYUDU PALEM,121,48,211,380,95,19,171,285,251,6854,784,10898,18536,11732,31,2,48,81
8416,PRAKASAM,Gudluru,PAJERLA,15,39,242,296,8,19,159,186,154,220,410,5719,6349,4414,0,0,0,0
8417,PRAKASAM,Gudluru,PARAKONDA PADU,334,5,233,572,204,1,93,298,277,15687,14,4349,20050,12516,76,0,16,92
8418,PRAKASAM,Gudluru,POTLURU,56,112,205,373,20,6,141,167,145,1051,116,9660,10827,7008,1,0,35,36
8419,PRAKASAM,Gudluru,PURETI PALLI,186,88,351,625,139,35,262,436,470,3790,763,9777,14330,9544,2,1,8,11
8420,PRAKASAM,Gudluru,RAVUR,115,1,361,477,69,0,153,222,227,2681,0,5254,7935,4666,2,0,2,4
8421,PRAKASAM,Gudluru,SALEPETA,18,71,339,428,7,26,223,256,257,333,591,13412,14336,11316,2,0,41,43
8422,PRAKASAM,Gudluru,SWARNAJIPURAM,159,45,61,265,102,23,32,157,141,8513,817,2153,11483,8020,49,3,12,64
8423,PRAKASAM,Gudluru,VENKAM PETA,5,19,155,179,0,12,89,101,84,0,520,6779,7299,3639,0,0,30,30
8424,PRAKASAM,Hanumanthunipadu,DASALLA PALLI,51,0,143,194,26,0,106,132,151,1907,0,9070,10977,6566,4,0,32,36
8425,PRAKASAM,Hanumanthunipadu,DASARIPALLI,158,0,192,350,84,0,113,197,190,4541,0,6940,11481,6417,8,0,24,32
8426,PRAKASAM,Hanumanthunipadu,DODDI CHINTALA,154,1,177,332,80,0,115,195,210,3559,0,5704,9263,6303,6,0,0,6
8427,PRAKASAM,Hanumanthunipadu,GAYAMVARIPALLI,76,0,154,230,4,0,30,34,29,56,0,403,459,251,0,0,0,0
8428,PRAKASAM,Hanumanthunipadu,GOLLA PALLI,156,1,459,616,90,1,266,357,348,2771,18,8471,11260,7314,1,0,1,2
8429,PRAKASAM,Hanumanthunipadu,HANUMANTHA PURAM,112,3,206,321,64,1,159,224,231,4610,11,9461,14082,9363,19,0,31,50
8430,PRAKASAM,Hanumanthunipadu,HANUMANTHUNI PADU,126,2,369,497,58,1,171,230,225,878,53,9395,10326,6062,0,0,8,8
8431,PRAKASAM,Hanumanthunipadu,HAZEEPURAM,120,2,202,324,71,0,139,210,233,3421,0,6264,9685,5999,5,0,11,16
8432,PRAKASAM,Hanumanthunipadu,KISTAMPALLI,120,0,157,277,71,0,118,189,186,3257,0,6001,9258,6255,4,0,13,17
8433,PRAKASAM,Hanumanthunipadu,KONDAREDDI PALLI,258,0,432,690,113,0,164,277,286,2691,0,4720,7411,4001,1,0,2,3
8434,PRAKASAM,Hanumanthunipadu,KUTAGUNDLA,95,1,310,406,65,0,215,280,298,4383,0,9328,13711,8376,14,0,20,34
8435,PRAKASAM,Hanumanthunipadu,LINGAMGUNTLA,122,0,223,345,66,0,153,219,225,3424,0,11484,14908,8655,11,0,48,59
8436,PRAKASAM,Hanumanthunipadu,MITTAPALEM,17,1,105,123,12,1,76,89,90,880,80,4745,5705,4309,2,0,7,9
8437,PRAKASAM,Hanumanthunipadu,MOHAMMADA PURAM,91,0,204,295,57,0,160,217,218,1527,0,2899,4426,2409,2,0,0,2
8438,PRAKASAM,Hanumanthunipadu,MUPPALLA PADU,211,0,378,589,84,0,249,333,331,2730,0,10056,12786,7647,1,0,12,13
8439,PRAKASAM,Hanumanthunipadu,NALLAGANDLA,66,0,125,191,43,0,54,97,89,2856,0,3533,6389,4038,4,0,9,13
8440,PRAKASAM,Hanumanthunipadu,NANDANAVANAM,157,0,457,614,91,0,185,276,255,3118,0,6965,10083,6543,2,0,7,9
8441,PRAKASAM,Hanumanthunipadu,SEETHARAMA PURAM,144,4,314,462,31,0,141,172,163,282,0,4442,4724,2719,0,0,10,10
8442,PRAKASAM,Hanumanthunipadu,THIMMAREDDI PALLI,210,3,369,582,78,1,221,300,304,1873,45,10445,12363,7610,1,0,13,14
8443,PRAKASAM,Hanumanthunipadu,UMMANA PALLI,90,0,218,308,60,0,127,187,213,4633,0,9428,14061,8328,21,0,38,59
8444,PRAKASAM,Hanumanthunipadu,VALICHERLA,157,1,297,455,94,0,198,292,280,4289,0,8333,12622,8611,2,0,6,8
8445,PRAKASAM,Hanumanthunipadu,VEERARAMA PURAM,62,0,150,212,37,0,107,144,142,2016,0,5510,7526,4916,1,0,11,12
8446,PRAKASAM,Hanumanthunipadu,VEMULA PADU,142,0,393,535,51,0,134,185,157,1344,0,4430,5774,3137,3,0,1,4
8447,PRAKASAM,Inkollu,BHIMAVARAM,223,14,174,411,153,8,96,257,225,12009,652,6127,18788,9976,53,3,19,75
8448,PRAKASAM,Inkollu,DUDDUKUR,316,32,479,827,190,9,197,396,380,9614,511,7813,17938,10364,12,1,1,14
8449,PRAKASAM,Inkollu,GANGA VARAM,246,17,327,590,102,2,115,219,187,1474,24,6713,8211,4086,0,0,29,29
8450,PRAKASAM,Inkollu,IDUPULAPADU,549,6,514,1069,321,2,142,465,393,10846,116,4341,15303,6915,7,0,9,16
8451,PRAKASAM,Inkollu,INKOLLU,1079,60,679,1818,538,10,134,682,691,21896,239,5356,27491,14809,20,0,13,33
8452,PRAKASAM,Inkollu,KONIKI,304,27,414,745,205,17,263,485,469,4282,867,16319,21468,11238,1,0,32,33
8453,PRAKASAM,Inkollu,NAGANDLA,280,68,301,649,145,13,114,272,225,5747,279,2171,8197,4615,7,0,0,7
8454,PRAKASAM,Inkollu,NAKKALAPALEM,181,14,106,301,157,13,47,217,205,6149,456,2077,8682,3892,1,0,7,8
8455,PRAKASAM,Inkollu,PAVULUR,364,17,560,941,236,3,244,483,497,11854,87,9195,21136,11495,12,0,6,18
8456,PRAKASAM,Inkollu,PUSAPADU,195,13,351,559,142,4,151,297,209,4792,84,5505,10381,4234,1,0,2,3
8457,PRAKASAM,Inkollu,SUBBAREDDY PALEM,0,0,131,131,0,0,0,0,0,0,0,0,0,0,0,0,0,0
8458,PRAKASAM,Inkollu,SUDIVARI PALEM,114,16,136,266,81,11,77,169,159,2961,388,2836,6185,3047,1,0,5,6
8459,PRAKASAM,Inkollu,VANKAYALAPADU,288,15,185,488,208,5,26,239,213,5059,85,302,5446,2969,2,0,0,2
8460,PRAKASAM,Janakavarampanguluru,ALAVALA PADU,117,3,560,680,86,2,342,430,419,4739,67,10746,15552,11554,11,0,0,11
8461,PRAKASAM,Janakavarampanguluru,ARIKATLAVARI PALEM,193,0,100,293,161,0,73,234,205,13650,0,4962,18612,9179,78,0,16,94
8462,PRAKASAM,Janakavarampanguluru,BHAGAVANRAJUPALEM,173,6,125,304,67,2,52,121,111,2377,8,1166,3551,2470,3,0,0,3
8463,PRAKASAM,Janakavarampanguluru,BUDAVADA,466,39,534,1039,176,0,70,246,244,1712,0,1291,3003,1743,0,0,0,0
8464,PRAKASAM,Janakavarampanguluru,BYTAMANJULUR,103,14,301,418,81,11,178,270,315,4450,313,4577,9340,5414,12,1,1,14
8465,PRAKASAM,Janakavarampanguluru,CHANDALUR,200,8,403,611,145,6,266,417,402,10553,525,15769,26847,17796,42,3,40,85
8466,PRAKASAM,Janakavarampanguluru,CHINAMALLAVARAM,102,26,169,297,63,15,82,160,170,2188,998,4091,7277,4369,1,5,14,20
8467,PRAKASAM,Janakavarampanguluru,JAGARLAMUDIVARI PALEM,143,16,180,339,80,5,72,157,136,3164,330,3597,7091,5014,0,2,3,5
8468,PRAKASAM,Janakavarampanguluru,JANAKAVARAM,100,12,194,306,94,8,162,264,248,6530,596,11420,18546,12067,21,3,23,47
8469,PRAKASAM,Janakavarampanguluru,KALLAMVARIPALEM,127,17,227,371,87,1,112,200,204,2485,23,6067,8575,5003,2,0,18,20
8470,PRAKASAM,Janakavarampanguluru,KASYA PURAM,70,1,127,198,45,0,48,93,90,2704,0,2577,5281,3410,4,0,0,4
8471,PRAKASAM,Janakavarampanguluru,KONDAMANJULUR,306,19,213,538,217,0,35,252,250,11677,0,1481,13158,7156,35,0,5,40
8472,PRAKASAM,Janakavarampanguluru,KONDAMUR,107,0,637,744,56,0,338,394,337,1364,0,11109,12473,7273,3,0,13,16
8473,PRAKASAM,Janakavarampanguluru,KOTAPADU,369,9,467,845,225,3,226,454,410,9212,72,10862,20146,12852,10,0,9,19
8474,PRAKASAM,Janakavarampanguluru,MUPPAVARAM,140,56,356,552,76,43,165,284,271,3329,1514,6825,11668,7905,5,2,8,15
8475,PRAKASAM,Janakavarampanguluru,NUZELLA PALLI,191,56,191,438,110,19,69,198,173,5418,269,3311,8998,5407,5,0,0,5
8476,PRAKASAM,Janakavarampanguluru,PANGULURU,500,35,1092,1627,391,26,785,1202,1149,18723,1267,34342,54332,29484,11,2,3,16
8477,PRAKASAM,Janakavarampanguluru,RAMAKURU,61,74,806,941,26,12,187,225,185,756,209,3262,4227,2304,0,0,3,3
8478,PRAKASAM,Janakavarampanguluru,RENANGI VARAM,158,11,286,455,95,7,181,283,302,4046,354,8725,13125,10167,6,0,0,6
8479,PRAKASAM,Janakavarampanguluru,THURPU KOPPERA PADU,225,1,338,564,118,1,129,248,226,5602,78,5346,11026,6547,6,0,5,11
8480,PRAKASAM,Janakavarampanguluru,THURPU THAKKELLA PADU,219,33,216,468,138,13,149,300,279,4838,287,5000,10125,6180,4,0,1,5
8481,PRAKASAM,Kandukur,ANANDA PURAM,250,11,544,805,163,5,338,506,469,7852,188,15487,23527,13863,6,0,5,11
8482,PRAKASAM,Kandukur,ANANTHA SAGARAM,120,1,131,252,87,0,90,177,163,2697,0,3140,5837,4183,0,0,0,0
8483,PRAKASAM,Kandukur,BALIJAPALEM,44,1,182,227,35,1,131,167,171,2455,6,6415,8876,7018,10,0,6,16
8484,PRAKASAM,Kandukur,DIVIVARIPALEM,11,64,237,312,6,26,179,211,207,167,1074,10885,12126,7770,0,2,28,30
8485,PRAKASAM,Kandukur,JILLELLAMUDI,22,0,70,92,14,0,38,52,54,824,0,1315,2139,1572,1,0,0,1
8486,PRAKASAM,Kandukur,KAMMAVARI PALEM,22,11,67,100,17,9,45,71,64,704,383,1762,2849,1674,0,1,4,5
8487,PRAKASAM,Kandukur,KANCHARAGUNTA,88,0,158,246,8,0,15,23,19,58,0,140,198,123,0,0,0,0
8488,PRAKASAM,Kandukur,KONDAMUDUSU PALEM,137,14,552,703,86,8,307,401,369,2286,351,13290,15927,13293,0,0,2,2
8489,PRAKASAM,Kandukur,KONDIKANDUKUR,141,0,115,256,89,0,98,187,171,5622,0,7478,13100,10043,14,0,15,29
8490,PRAKASAM,Kandukur,KOVUR,126,41,451,618,91,31,347,469,426,4091,1287,23788,29166,21286,4,2,53,59
8491,PRAKASAM,Kandukur,MACHAVARAM,370,133,739,1242,200,5,293,498,442,6447,24,8705,15176,10902,0,0,0,0
8492,PRAKASAM,Kandukur,MAHADEVAPURAM,129,55,383,567,87,3,218,308,275,3775,53,7779,11607,9223,1,0,0,1
8493,PRAKASAM,Kandukur,MEKAPADU (G),185,2,137,324,104,0,57,161,173,3621,0,1209,4830,2991,11,0,0,11
8494,PRAKASAM,Kandukur,MOPADU,189,5,368,562,96,1,8,105,105,4774,14,58,4846,3392,4,0,0,4
8495,PRAKASAM,Kandukur,NARISETTIVARI PALEM,0,0,117,117,0,0,76,76,68,0,0,4608,4608,3359,0,0,7,7
8496,PRAKASAM,Kandukur,OGUR,240,7,459,706,141,3,301,445,374,9729,76,18502,28307,21055,18,0,18,36
8497,PRAKASAM,Kandukur,PALUKUR,197,25,458,680,112,0,200,312,274,4319,0,8432,12751,9628,6,0,5,11
8498,PRAKASAM,Kandukur,PALUR DONDA PADU,291,79,235,605,128,19,53,200,169,5592,535,1121,7248,4894,1,0,0,1
8499,PRAKASAM,Kandukur,PANDALA PADU,71,0,118,189,65,0,89,154,132,2772,0,3995,6767,4865,2,0,0,2
8500,PRAKASAM,Kandukur,SRIRANGARAJA PURAM,112,43,53,208,68,21,5,94,72,2747,527,44,3318,2142,2,0,0,2
8501,PRAKASAM,Kandukur,VIKKIRALA PETA,118,19,215,352,84,15,121,220,223,5134,300,6547,11981,10308,11,0,6,17
8502,PRAKASAM,Kanigiri,BADUGULERU,169,0,270,439,74,0,98,172,168,3234,0,5035,8269,4524,1,0,12,13
8503,PRAKASAM,Kanigiri,BALLI PALLI,340,96,512,948,35,8,81,124,117,967,123,1850,2940,1511,1,0,5,6
8504,PRAKASAM,Kanigiri,BOMMIREDDY PALLI,115,8,632,755,37,2,196,235,242,1073,143,10044,11260,7893,0,0,16,16
8505,PRAKASAM,Kanigiri,CHAKIRALA,198,2,712,912,32,1,277,310,266,633,18,14730,15381,11475,0,0,30,30
8506,PRAKASAM,Kanigiri,CHALLAGIRI GILA,226,0,433,659,92,0,145,237,259,3010,0,4451,7461,4632,1,0,11,12
8507,PRAKASAM,Kanigiri,CHEERLADINNE,168,5,527,700,18,0,156,174,155,211,0,5794,6005,3826,0,0,1,1
8508,PRAKASAM,Kanigiri,CHINAIRLA PADU,221,14,275,510,114,3,129,246,258,8308,228,8545,17081,10733,39,2,33,74
8509,PRAKASAM,Kanigiri,DIRISAVANCHA,99,2,204,305,48,1,92,141,133,2986,18,3728,6732,4801,7,0,7,14
8510,PRAKASAM,Kanigiri,GANUGA PENTA,25,23,104,152,21,13,69,103,111,1172,491,3387,5050,3247,1,0,2,3
8511,PRAKASAM,Kanigiri,GOSULAVEEDU,63,0,166,229,28,0,44,72,65,653,0,1796,2449,1812,0,0,2,2
8512,PRAKASAM,Kanigiri,GUDI PADU,133,7,459,599,50,2,167,219,161,2161,54,6815,9030,5341,3,0,8,11
8513,PRAKASAM,Kanigiri,GURAVAJI PETA,193,20,562,775,91,16,256,363,384,2870,300,6636,9806,5809,0,0,0,0
8514,PRAKASAM,Kanigiri,JAMMALAMADAKA,48,0,187,235,3,0,31,34,37,7,0,511,518,256,0,0,0,0
8515,PRAKASAM,Kanigiri,KANIGIRI,166,87,1224,1477,0,0,0,0,0,0,0,0,0,0,0,0,0,0
8516,PRAKASAM,Kanigiri,KASSEPURAM,82,79,314,475,0,0,0,0,0,0,0,0,0,0,0,0,0,0
8517,PRAKASAM,Kanigiri,KRISHNA PURAM,69,0,225,294,38,0,131,169,147,2694,0,6585,9279,6192,14,0,16,30
8518,PRAKASAM,Kanigiri,LINGAREDDY PALLI,117,0,484,601,49,0,363,412,411,2440,0,13652,16092,10296,4,0,5,9
8519,PRAKASAM,Kanigiri,MACHAVARAM,38,0,285,323,0,0,0,0,0,0,0,0,0,0,0,0,0,0
8520,PRAKASAM,Kanigiri,N.GOLLAPALLI,125,0,351,476,48,0,120,168,171,785,0,1580,2365,1796,0,0,0,0
8521,PRAKASAM,Kanigiri,PERAMGUDI PALLE,107,1,169,277,13,1,78,92,107,189,12,2710,2911,1715,0,0,4,4
8522,PRAKASAM,Kanigiri,POLAVARAM,153,9,276,438,54,0,85,139,145,1867,0,3290,5157,3279,1,0,8,9
8523,PRAKASAM,Kanigiri,PONUGODU,179,58,305,542,57,0,99,156,133,1766,0,2015,3781,2598,1,0,0,1
8524,PRAKASAM,Kanigiri,SANKAVARAM,294,0,415,709,16,0,6,22,25,486,0,295,781,537,0,0,1,1
8525,PRAKASAM,Kanigiri,TAKKELLA PADU,148,7,436,591,23,0,176,199,207,676,0,3242,3918,2277,1,0,1,2
8526,PRAKASAM,Kanigiri,THALLUR,115,8,532,655,70,0,260,330,325,1939,0,6294,8233,5437,0,0,1,1
8527,PRAKASAM,Kanigiri,THUMMAGUNTA,129,3,353,485,12,0,44,56,50,184,0,425,609,401,0,0,0,0
8528,PRAKASAM,Kanigiri,VANGA PADU,107,43,399,549,38,20,197,255,236,999,556,5536,7091,4389,0,0,2,2
8529,PRAKASAM,Kanigiri,YADAVALLI,141,0,414,555,6,0,131,137,135,30,0,2289,2319,1439,0,0,0,0
8530,PRAKASAM,Kanigiri,YERUVARIPALLI,185,35,389,609,109,4,163,276,258,3951,36,4361,8348,5183,2,0,1,3
8531,PRAKASAM,Karamchedu,AUDI PUDI,289,11,397,697,146,0,210,356,310,2472,0,3939,6411,3465,0,0,0,0
8532,PRAKASAM,Karamchedu,DAGGUBADU,338,12,227,577,79,0,19,98,69,1239,0,181,1420,602,0,0,0,0
8533,PRAKASAM,Karamchedu,JARUBULAVARI PALEM,295,2,91,388,258,2,40,300,316,8656,44,1026,9726,4946,0,0,0,0
8534,PRAKASAM,Karamchedu,KARAMCHEDU,327,153,1506,1986,203,15,481,699,624,5378,439,16183,22000,12580,0,0,18,18
8535,PRAKASAM,Karamchedu,KESAVARAPPADU,107,2,153,262,73,0,58,131,112,3399,0,2701,6100,3461,0,0,1,1
8536,PRAKASAM,Karamchedu,KODAVALI VARI PALEM,247,4,89,340,183,3,41,227,210,9362,137,2365,11864,6851,5,0,1,6
8537,PRAKASAM,Karamchedu,KUNKALAMARRU,516,23,818,1357,348,9,451,808,735,6804,108,7922,14834,7819,0,0,0,0
8538,PRAKASAM,Karamchedu,NAIDUVARI PALEM,1,0,116,117,0,0,11,11,1,0,0,138,138,6,0,0,0,0
8539,PRAKASAM,Karamchedu,POTINAVARIPALEM,0,2,133,135,0,0,74,74,58,0,0,1397,1397,647,0,0,0,0
8540,PRAKASAM,Karamchedu,RANGAPANAIDUVARI PAL,230,0,56,286,143,0,9,152,126,9402,0,390,9792,4668,26,0,1,27
8541,PRAKASAM,Karamchedu,SWARNA,470,122,746,1338,315,49,65,429,403,11197,1713,1555,14465,7084,1,1,0,2
8542,PRAKASAM,Karamchedu,SWARNA PALEM,106,0,132,238,76,0,101,177,158,5089,0,4600,9689,4924,12,0,2,14
8543,PRAKASAM,Karamchedu,THIMIDITAPADU,231,1,177,409,198,1,126,325,363,6767,59,3272,10098,5084,2,0,0,2
8544,PRAKASAM,Karamchedu,YARRAMVARIPALEM,0,0,111,111,0,0,41,41,38,0,0,1401,1401,666,0,0,2,2
8545,PRAKASAM,Komarolu,ALLINAGARAM,136,4,633,773,83,2,349,434,386,3495,41,11895,15431,8602,4,0,7,11
8546,PRAKASAM,Komarolu,BADINENI PALLI,118,0,378,496,63,0,192,255,248,4679,0,9296,13975,8586,19,0,16,35
8547,PRAKASAM,Komarolu,BRAHMANA PALLE,177,0,867,1044,113,0,504,617,716,6072,0,27304,33376,18886,15,0,76,91
8548,PRAKASAM,Komarolu,CHINTHALA PALLI,151,0,640,791,95,0,402,497,526,3771,0,17215,20986,12703,4,0,17,21
8549,PRAKASAM,Komarolu,DADDAWADA,87,0,1040,1127,52,0,605,657,687,2757,0,26751,29508,16274,3,0,27,30
8550,PRAKASAM,Komarolu,EDAMAKALLU,160,2,547,709,86,1,273,360,351,2873,7,8820,11700,7479,2,0,1,3
8551,PRAKASAM,Komarolu,KOMAROLU,335,3,2238,2576,152,0,765,917,845,6384,0,24645,31029,20391,6,0,19,25
8552,PRAKASAM,Komarolu,MUKTHAPURAM,37,0,263,300,19,0,182,201,193,1504,0,15150,16654,10631,9,0,78,87
8553,PRAKASAM,Komarolu,NALLAGUNTLA,262,0,516,778,157,0,215,372,346,12447,0,12461,24908,14463,59,0,14,73
8554,PRAKASAM,Komarolu,PULLAREDDI PALLI,76,0,201,277,50,0,147,197,168,3078,0,9364,12442,6957,10,0,41,51
8555,PRAKASAM,Komarolu,RAJUPALEM,75,0,1031,1106,49,0,621,670,661,3106,0,28145,31251,18295,8,0,42,50
8556,PRAKASAM,Komarolu,REDDICHERLA,269,21,820,1110,117,16,352,485,450,3098,1597,10452,15147,8584,3,9,9,21
8557,PRAKASAM,Komarolu,SURAVARI PALLI,113,0,368,481,76,0,280,356,366,3040,0,14497,17537,10521,7,0,32,39
8558,PRAKASAM,Komarolu,TATICHERLA,132,0,697,829,78,0,417,495,510,2424,0,14210,16634,10348,2,0,11,13
8559,PRAKASAM,Konakanamitla,BATCHALAKURAPADU,89,0,254,343,53,0,140,193,188,3128,0,10218,13346,8054,6,0,33,39
8560,PRAKASAM,Konakanamitla,CHINAMANAGUNDAM,209,0,353,562,124,0,272,396,407,7028,0,15389,22417,12956,6,0,15,21
8561,PRAKASAM,Konakanamitla,CHINARIKATLA,163,1,668,832,72,0,362,434,419,2694,0,17106,19800,13359,2,0,7,9
8562,PRAKASAM,Konakanamitla,CHINTA GUNTA,258,2,246,506,107,1,138,246,259,3107,46,4260,7413,4106,1,0,0,1
8563,PRAKASAM,Konakanamitla,GANIVANI PADU,54,0,131,185,29,0,97,126,121,269,0,444,713,436,0,0,0,0
8564,PRAKASAM,Konakanamitla,GARIMANA PENTA,161,21,302,484,78,13,236,327,329,4594,634,15879,21107,11174,3,0,47,50
8565,PRAKASAM,Konakanamitla,GARLADINNE,83,0,175,258,72,0,130,202,241,5861,0,10792,16653,8827,27,0,57,84
8566,PRAKASAM,Konakanamitla,GOTLAGATTU,346,1,626,973,229,1,372,602,619,8683,28,12545,21256,11638,13,0,19,32
8567,PRAKASAM,Konakanamitla,IRASALAGUNDAM,118,5,161,284,93,4,116,213,200,5698,188,7769,13655,9196,16,0,23,39
8568,PRAKASAM,Konakanamitla,KATRAGUNTA,257,0,436,693,118,0,331,449,508,4832,0,19568,24400,14199,8,0,50,58
8569,PRAKASAM,Konakanamitla,KONAKANAMITLA,188,10,566,764,88,2,349,439,483,3229,107,13562,16898,9050,4,0,6,10
8570,PRAKASAM,Konakanamitla,MANGAPURAM,36,0,233,269,27,0,151,178,136,896,0,7023,7919,4010,0,0,0,0
8571,PRAKASAM,Konakanamitla,MUNAGAPADU,157,16,367,540,71,3,221,295,294,1354,53,7275,8682,5530,0,0,2,2
8572,PRAKASAM,Konakanamitla,NAGAMPALLI,182,0,215,397,118,0,153,271,269,5405,0,9594,14999,8125,3,0,16,19
8573,PRAKASAM,Konakanamitla,NAGARAJU GUNTA,106,7,467,580,43,5,265,313,285,1022,95,7687,8804,5202,0,0,2,2
8574,PRAKASAM,Konakanamitla,NAGIREDDYPALLI,58,1,143,202,39,0,129,168,193,1907,0,7690,9597,5464,4,0,8,12
8575,PRAKASAM,Konakanamitla,PEDARIKATLA,184,5,1163,1352,7,0,366,373,290,121,0,7686,7807,4775,0,0,1,1
8576,PRAKASAM,Konakanamitla,REGUMANUPALLI,116,3,390,509,71,2,278,351,377,3737,112,15475,19324,10192,3,0,22,25
8577,PRAKASAM,Konakanamitla,SALANUTHALA,54,0,229,283,41,0,161,202,254,1806,0,6051,7857,4318,4,0,2,6
8578,PRAKASAM,Konakanamitla,SIDDAVARAM,315,8,561,884,155,0,314,469,426,5738,0,15470,21208,13303,3,0,7,10
8579,PRAKASAM,Konakanamitla,THUVVA PADU,251,0,333,584,157,0,167,324,334,8747,0,9335,18082,10663,20,0,27,47
8580,PRAKASAM,Konakanamitla,VADDIMADUGU,93,0,311,404,33,0,189,222,225,1012,0,7381,8393,6059,0,0,8,8
8581,PRAKASAM,Konakanamitla,VAGEMADUGU,139,4,715,858,38,1,345,384,443,2761,6,18797,21564,13134,14,0,33,47
8582,PRAKASAM,Konakanamitla,VELIGANDLA,132,7,249,388,92,0,68,160,170,6356,0,2113,8469,5098,19,0,3,22
8583,PRAKASAM,Konakanamitla,VINJAVARTHI PADU,13,1,142,156,3,0,34,37,36,57,0,642,699,380,0,0,0,0
8584,PRAKASAM,Konakanamitla,YEDURALLA PADU,101,0,255,356,59,0,97,156,162,275,0,3250,3525,1776,0,0,1,1
8585,PRAKASAM,Kondapi,ANAKARLAPUDI,209,1,331,541,144,0,259,403,379,6183,0,9917,16100,11001,4,0,3,7
8586,PRAKASAM,Kondapi,CHINA KANDLAGUNTA,164,46,523,733,98,28,331,457,417,3149,825,16301,20275,12473,0,0,16,16
8587,PRAKASAM,Kondapi,CHINA VENKANNA PALEM,150,1,81,232,104,0,42,146,133,4166,0,1249,5415,3616,4,0,0,4
8588,PRAKASAM,Kondapi,CHODAVARM,213,10,204,427,143,4,123,270,229,6844,325,6821,13990,9774,6,2,8,16
8589,PRAKASAM,Kondapi,GOGINENIVARI PALEM,63,0,174,237,45,0,100,145,130,3525,0,5852,9377,5814,13,0,16,29
8590,PRAKASAM,Kondapi,GURRAPPADIA,199,0,153,352,127,0,94,221,213,4091,0,3412,7503,4862,0,0,0,0
8591,PRAKASAM,Kondapi,ILAVARA,181,33,592,806,134,19,369,522,498,9798,1193,24715,35706,26961,19,0,29,48
8592,PRAKASAM,Kondapi,K.UPPALAPADU,267,31,170,468,160,0,8,168,166,7043,0,149,7192,4642,14,0,0,14
8593,PRAKASAM,Kondapi,KATTUBADIPALEM,77,1,220,298,61,1,118,180,164,4218,108,7250,11576,8138,14,1,13,28
8594,PRAKASAM,Kondapi,KONDEPI,695,6,1573,2274,452,1,825,1278,1175,20452,20,37167,57639,34996,28,0,102,130
8595,PRAKASAM,Kondapi,MITTAPALEM,266,0,61,327,146,0,24,170,171,7876,0,1138,9014,6524,19,0,1,20
8596,PRAKASAM,Kondapi,MUGACHINTALA,206,0,196,402,83,0,103,186,184,3180,0,3870,7050,4958,3,0,6,9
8597,PRAKASAM,Kondapi,MUPPARAJUPALEM,23,1,186,210,17,1,142,160,151,544,96,4861,5501,3678,0,0,1,1
8598,PRAKASAM,Kondapi,MUPPAVARAM,42,1,258,301,34,0,177,211,192,2351,0,9613,11964,7644,9,0,15,24
8599,PRAKASAM,Kondapi,NENNURUPADU,131,6,286,423,49,2,164,215,201,1813,51,7884,9748,7255,1,0,12,13
8600,PRAKASAM,Kondapi,PEDAKANDLAGUNTA,184,29,446,659,107,12,225,344,343,3837,302,9049,13188,8206,0,0,5,5
8601,PRAKASAM,Kondapi,PERIDEPI,300,4,191,495,220,4,115,339,313,9985,182,5157,15324,10675,6,0,5,11
8602,PRAKASAM,Kondapi,PETLUR,428,24,678,1130,244,0,475,719,733,8649,0,17795,26444,16100,8,0,9,17
8603,PRAKASAM,Kondapi,VENNUR,172,13,249,434,127,10,174,311,314,8530,702,8990,18222,12506,39,1,18,58
8604,PRAKASAM,Korisapadu,ANAMANAMUR,154,2,183,339,91,0,69,160,147,5371,0,4274,9645,6528,14,0,10,24
8605,PRAKASAM,Korisapadu,BODDUVARI PALEM,214,0,314,528,100,0,144,244,241,6153,0,10625,16778,11790,14,0,25,39
8606,PRAKASAM,Korisapadu,BOLLAVARAPPADU,52,0,127,179,41,0,75,116,101,3328,0,5048,8376,4828,21,0,20,41
8607,PRAKASAM,Korisapadu,DYVALARAVURU,350,30,173,553,18,4,4,26,12,288,42,80,410,122,0,0,0,0
8608,PRAKASAM,Korisapadu,KORISA PADU,453,3,556,1012,145,2,375,522,463,5187,36,24420,29643,16801,3,0,36,39
8609,PRAKASAM,Korisapadu,KURRAVANIPALEM,202,0,282,484,103,0,5,108,94,1517,0,55,1572,928,0,0,0,0
8610,PRAKASAM,Korisapadu,MEDARAMETLA,435,88,479,1002,36,3,23,62,31,636,60,392,1088,506,0,0,0,0
8611,PRAKASAM,Korisapadu,PAMIDI PADU,727,19,948,1694,408,5,388,801,796,12435,164,15933,28532,17233,6,0,9,15
8612,PRAKASAM,Korisapadu,PICHIKALAGUDIPADU,146,1,271,418,57,0,96,153,151,4292,0,4324,8616,5534,22,0,10,32
8613,PRAKASAM,Korisapadu,PRASANGULA PADU,202,0,202,404,129,0,35,164,153,6571,0,1151,7722,4353,23,0,0,23
8614,PRAKASAM,Korisapadu,RACHAPUDI,446,8,354,808,239,2,127,368,363,5104,38,1712,6854,4249,0,0,0,0
8615,PRAKASAM,Korisapadu,RAVINUTHALA,644,27,772,1443,309,1,159,469,442,11355,34,5555,16944,11031,6,0,5,11
8616,PRAKASAM,Korisapadu,THAMMAVARAM,131,0,318,449,52,0,77,129,118,1054,0,1709,2763,1949,0,0,0,0
8617,PRAKASAM,Korisapadu,THIMMANAPALEM,147,0,79,226,9,0,2,11,7,162,0,40,202,90,0,0,0,0
8618,PRAKASAM,Korisapadu,YARRABALEM,184,0,176,360,132,0,85,217,187,7908,0,5103,13011,8018,26,0,16,42
8619,PRAKASAM,Kothapatnam,ALLUR,550,279,556,1385,304,80,301,685,617,13963,2502,12510,28975,18698,3,1,3,7
8620,PRAKASAM,Kothapatnam,ALOOR,243,7,296,546,172,4,188,364,336,10971,279,13609,24859,17273,10,1,16,27
8621,PRAKASAM,Kothapatnam,ETHA MUKKALA,361,243,430,1034,173,30,77,280,252,11485,269,2183,13937,10588,36,0,2,38
8622,PRAKASAM,Kothapatnam,GADEPALEM,86,1,172,259,53,0,104,157,151,3940,0,8368,12308,8202,6,0,29,35
8623,PRAKASAM,Kothapatnam,GAMALLAPALEM,38,40,575,653,0,0,84,84,67,0,0,917,917,599,0,0,0,0
8624,PRAKASAM,Kothapatnam,GUNDAMALA,9,0,566,575,1,0,71,72,58,6,0,765,771,366,0,0,0,0
8625,PRAKASAM,Kothapatnam,K.PALLEPALEM,4,0,815,819,0,0,110,110,95,0,0,921,921,718,0,0,0,0
8626,PRAKASAM,Kothapatnam,KOTHAPATNAM,196,383,624,1203,79,57,82,218,186,4043,810,1399,6252,4369,5,1,1,7
8627,PRAKASAM,Kothapatnam,MADANUR,233,167,545,945,62,8,180,250,207,507,60,5527,6094,3235,0,0,0,0
8628,PRAKASAM,Kothapatnam,MOTUMALA,113,56,521,690,72,12,208,292,244,3900,130,8712,12742,8425,14,0,12,26
8629,PRAKASAM,Kothapatnam,PADARTHI,147,0,157,304,7,0,6,13,6,45,0,51,96,47,0,0,0,0
8630,PRAKASAM,Kothapatnam,RAJU PALEM,178,14,492,684,96,0,102,198,114,4678,0,1706,6384,4237,9,0,1,10
8631,PRAKASAM,Kothapatnam,RANGAYAPALEM,74,55,216,345,6,3,21,30,15,49,57,299,405,157,0,0,0,0
8632,PRAKASAM,Kothapatnam,SANKUVANI GUNTA,191,5,0,196,105,0,0,105,100,7667,0,0,7667,5525,29,0,0,29
8633,PRAKASAM,Kurichedu,ALAVALA PADU,94,0,176,270,68,0,132,200,208,3227,0,8009,11236,7211,2,0,14,16
8634,PRAKASAM,Kurichedu,AVULAMANDA,350,205,945,1500,110,34,470,614,580,1849,628,15538,18015,10679,0,0,6,6
8635,PRAKASAM,Kurichedu,BAYYA VARAM,58,0,132,190,28,0,87,115,116,744,0,2462,3206,1474,0,0,0,0
8636,PRAKASAM,Kurichedu,BODANAM PADU,96,0,388,484,34,0,247,281,291,3105,0,16095,19200,12740,12,0,44,56
8637,PRAKASAM,Kurichedu,DEKANAKONDA,219,0,377,596,110,0,78,188,190,1580,0,2076,3656,2099,0,0,2,2
8638,PRAKASAM,Kurichedu,GANGADONA KONDA,102,0,355,457,68,0,275,343,356,2643,0,10530,13173,7433,1,0,5,6
8639,PRAKASAM,Kurichedu,KALLUR,161,3,580,744,93,0,386,479,549,2628,0,16217,18845,10060,0,0,18,18
8640,PRAKASAM,Kurichedu,KURICHEDU,261,55,1264,1580,81,3,681,765,748,1497,64,25632,27193,18171,1,0,37,38
8641,PRAKASAM,Kurichedu,NAMASSIVAYA PURAM,125,1,444,570,93,1,338,432,447,4629,23,21897,26549,18076,8,0,78,86
8642,PRAKASAM,Kurichedu,PEDDA VARAM,79,1,283,363,44,0,183,227,227,1696,0,11446,13142,7940,3,0,32,35
8643,PRAKASAM,Kurichedu,POTLAPADU,242,3,586,831,162,3,416,581,537,8933,192,25788,34913,22461,6,0,13,19
8644,PRAKASAM,Kurichedu,WEST GANGAVARAM,114,0,522,636,81,0,421,502,556,1562,0,28253,29815,15401,3,0,76,79
8645,PRAKASAM,Kurichedu,WEST KASIPURAM,103,4,197,304,57,0,130,187,185,3904,0,9973,13877,7835,12,0,43,55
8646,PRAKASAM,Kurichedu,WEST NAIDUPALEM,115,119,677,911,66,51,473,590,564,3802,3242,32642,39686,21104,13,12,126,151
8647,PRAKASAM,Kurichedu,WEST VEERAYA PALEM,196,13,678,887,80,1,486,567,603,2656,12,23819,26487,15980,2,0,22,24
8648,PRAKASAM,Lingasamudram,ANGIREKULA PADU,79,2,276,357,49,2,155,206,216,1850,156,4450,6456,3939,0,1,1,2
8649,PRAKASAM,Lingasamudram,ANNEBOINA PALLI,462,0,461,923,187,0,105,292,249,7854,0,856,8710,4956,5,0,0,5
8650,PRAKASAM,Lingasamudram,CHINA PAVANI,194,37,642,873,99,3,387,489,429,3983,55,15567,19605,12526,0,0,8,8
8651,PRAKASAM,Lingasamudram,GANGA PALEM,176,1,132,309,110,0,92,202,206,8944,0,6193,15137,10766,35,0,13,48
8652,PRAKASAM,Lingasamudram,LINGASAMUDRAM,525,89,1602,2216,241,22,957,1220,1129,8780,941,52912,62633,44116,13,1,131,145
8653,PRAKASAM,Lingasamudram,MALA KONDA RAYUNI PALEM,131,33,259,423,64,27,188,279,265,3527,787,9624,13938,9228,8,0,16,24
8654,PRAKASAM,Lingasamudram,MEDARAMETLA PALEM,24,10,193,227,14,7,90,111,95,728,268,4681,5677,3326,0,0,2,2
8655,PRAKASAM,Lingasamudram,MOGILI CHARLA,122,24,773,919,76,13,458,547,517,4593,881,26988,32462,20191,9,1,51,61
8656,PRAKASAM,Lingasamudram,MUTYALAPADU,202,70,373,645,74,3,212,289,272,3693,94,12544,16331,10964,6,0,28,34
8657,PRAKASAM,Lingasamudram,PEDAPAVANI,208,48,797,1053,165,14,397,576,509,4874,278,11993,17145,9520,4,0,1,5
8658,PRAKASAM,Lingasamudram,PENTRALA,341,45,562,948,155,15,260,430,444,4742,332,9298,14372,8318,1,0,18,19
8659,PRAKASAM,Lingasamudram,RACHERUVU RAJU PALEM,68,0,202,270,26,0,119,145,129,915,0,7216,8131,4921,2,0,7,9
8660,PRAKASAM,Lingasamudram,THIMMAREDDY PALEM,193,50,667,910,84,3,435,522,541,5364,156,29470,34990,21019,23,1,70,94
8661,PRAKASAM,Lingasamudram,VEERA RAGHAVUNI KOTA,274,20,628,922,193,9,217,419,399,7219,148,2851,10218,5969,9,0,0,9
8662,PRAKASAM,Lingasamudram,VISWANADHAPURAM,97,1,243,341,60,0,171,231,204,3556,0,10817,14373,9525,14,0,30,44
8663,PRAKASAM,Lingasamudram,YARRAREDDYPALEM,111,23,383,517,67,5,312,384,410,3254,164,21304,24722,16522,5,0,61,66
8664,PRAKASAM,Maddipadu,ANNANGI,231,17,256,504,0,0,1,1,1,0,0,20,20,10,0,0,0,0
8665,PRAKASAM,Maddipadu,BASAVANNAPALEM,296,16,56,368,120,7,13,140,156,5691,97,264,6052,4042,6,0,0,6
8666,PRAKASAM,Maddipadu,DODDA VARAM,457,1,500,958,175,0,140,315,293,4987,0,3035,8022,5590,4,0,2,6
8667,PRAKASAM,Maddipadu,DODDAVARAPPADU,241,6,127,374,149,3,70,222,239,3838,74,1561,5473,4502,0,0,0,0
8668,PRAKASAM,Maddipadu,Garlapadu,0,0,0,0,0,0,0,0,0,0,0,0,0,0,0,0,0,0
8669,PRAKASAM,Maddipadu,GHADIYAPUDI,254,0,14,268,0,0,1,1,0,0,0,20,20,0,0,0,0,0
8670,PRAKASAM,Maddipadu,GUNDLA PALLI,191,11,83,285,32,1,2,35,34,386,18,40,444,308,0,0,0,0
8671,PRAKASAM,Maddipadu,INAMANAMELLUR,311,64,605,980,181,5,307,493,493,6586,54,7590,14230,11719,4,0,3,7
8672,PRAKASAM,Maddipadu,KEERTHI PADU,254,0,70,324,176,0,23,199,210,9613,0,1416,11029,8789,11,0,1,12
8673,PRAKASAM,Maddipadu,KOLACHANAKOTA,232,86,84,402,132,9,47,188,185,5257,110,2255,7622,6800,2,0,1,3
8674,PRAKASAM,Maddipadu,LINGAMGUNTA,217,39,228,484,129,9,61,199,193,6408,136,2988,9532,8414,7,0,5,12
8675,PRAKASAM,Maddipadu,MADDIPADU,343,12,214,569,127,3,35,165,151,4605,52,662,5319,3758,5,0,0,5
8676,PRAKASAM,Maddipadu,MALLAVARAM,159,4,207,370,59,0,46,105,97,985,0,522,1507,1223,0,0,0,0
8677,PRAKASAM,Maddipadu,NAGANNA PALEM,139,1,68,208,98,0,34,132,128,6181,0,1748,7929,4968,19,0,5,24
8678,PRAKASAM,Maddipadu,NANDI PADU,151,2,114,267,92,0,59,151,155,4382,0,2839,7221,4893,3,0,8,11
8679,PRAKASAM,Maddipadu,NELATUR,266,8,336,610,155,1,105,261,247,4295,18,2903,7216,5092,0,0,0,0
8680,PRAKASAM,Maddipadu,PEDA KOTHA PALLI,410,3,294,707,223,0,99,322,329,10635,0,4505,15140,13530,6,0,3,9
8681,PRAKASAM,Maddipadu,RACHAVARI PALEM,214,3,269,486,117,1,86,204,208,2040,1,362,2403,1863,0,0,0,0
8682,PRAKASAM,Maddipadu,SEETHARAM PURAM,35,0,130,165,24,0,66,90,98,1030,0,2829,3859,2109,1,0,0,1
8683,PRAKASAM,Maddipadu,VELLAM PALLI,183,9,205,397,15,1,23,39,33,88,18,330,436,268,0,0,0,0
8684,PRAKASAM,Maddipadu,YEDUGUNDLAPADU,296,4,45,345,37,0,2,39,34,318,0,22,340,248,0,0,0,0
8685,PRAKASAM,Markapur,1BONDALA PADU,56,0,192,248,17,0,123,140,142,1013,0,2019,3032,1785,3,0,0,3
8686,PRAKASAM,Markapur,BHUPATHI PALLI,290,28,744,1062,95,13,195,303,314,3846,396,5880,10122,5632,5,1,2,8
8687,PRAKASAM,Markapur,BODAPADU,114,0,303,417,64,0,200,264,274,2548,0,7275,9823,6039,3,0,10,13
8688,PRAKASAM,Markapur,CHINTAKUNTA,251,0,644,895,108,0,420,528,578,5742,0,18130,23872,13690,18,0,37,55
8689,PRAKASAM,Markapur,GAJJALA KONDA,306,2,960,1268,73,0,599,672,904,1617,0,22239,23856,12446,1,0,10,11
8690,PRAKASAM,Markapur,GOGULADINNE,236,0,377,613,101,0,230,331,342,4711,0,11855,16566,9885,9,0,18,27
8691,PRAKASAM,Markapur,GOTTIPADIA,107,50,291,448,61,11,197,269,294,2264,437,9316,12017,5914,3,0,8,11
8692,PRAKASAM,Markapur,IDUPUR,333,0,773,1106,183,0,555,738,880,13039,0,29663,42702,26088,49,0,44,93
8693,PRAKASAM,Markapur,JAMMANA PALLI,86,10,187,283,78,0,176,254,289,4869,0,8968,13837,8144,19,0,8,27
8694,PRAKASAM,Markapur,K.KOTHAPALLI,10,0,182,192,7,0,145,152,190,466,0,8175,8641,5084,0,0,6,6
8695,PRAKASAM,Markapur,KOLABHIMUNIPADU,88,0,133,221,76,0,110,186,204,5406,0,8821,14227,9739,18,0,26,44
8696,PRAKASAM,Markapur,KONDE PALLI,75,0,487,562,36,0,345,381,332,2208,0,15136,17344,10062,5,0,12,17
8697,PRAKASAM,Markapur,MALYAVANTHUNI PADU,71,1,471,543,53,1,298,352,417,3446,58,20223,23727,11015,10,0,44,54
8698,PRAKASAM,Markapur,NAIDUPALLI,120,0,438,558,81,0,349,430,485,4892,0,23183,28075,14903,5,0,57,62
8699,PRAKASAM,Markapur,NIKARAMPALLI,40,0,428,468,28,0,368,396,439,1586,0,23391,24977,17701,3,0,39,42
8700,PRAKASAM,Markapur,PEDA NAGULAVARAM,47,50,543,640,41,15,348,404,456,3505,427,19309,23241,13424,11,0,48,59
8701,PRAKASAM,Markapur,PEDA YACHAVARAM,372,0,436,808,276,0,353,629,784,19378,0,24931,44309,23964,84,0,67,151
8702,PRAKASAM,Markapur,RAMACHENDRAPURAM,42,1,324,367,36,0,299,335,372,2152,0,18369,20521,12194,8,0,47,55
8703,PRAKASAM,Markapur,RAYAVARAM,221,2,960,1183,110,0,434,544,544,3188,0,18630,21818,13839,0,0,18,18
8704,PRAKASAM,Markapur,THIPPAYA PALEM,198,4,798,1000,118,1,502,621,736,7516,107,26707,34330,17623,22,1,70,93
8705,PRAKASAM,Markapur,VEMULAKOTA,155,3,851,1009,105,2,490,597,739,5881,194,23644,29719,19597,13,1,37,51
8706,PRAKASAM,Marripudi,ANKEPALLI,268,7,524,799,130,3,276,409,335,7675,193,15051,22919,13147,16,0,12,28
8707,PRAKASAM,Marripudi,AYYAPARAJU PALEM,162,4,293,459,21,0,76,97,88,210,0,1809,2019,1152,0,0,2,2
8708,PRAKASAM,Marripudi,CHILAMAKUR,224,3,279,506,24,0,146,170,175,338,0,2873,3211,2133,0,0,0,0
8709,PRAKASAM,Marripudi,CHIMATA,217,1,854,1072,94,0,363,457,402,2744,0,8690,11434,7908,1,0,1,2
8710,PRAKASAM,Marripudi,DHARMA VARAM,128,0,303,431,59,0,212,271,285,2423,0,15568,17991,11662,8,0,46,54
8711,PRAKASAM,Marripudi,GARLAPETA,176,27,612,815,83,3,242,328,301,4753,58,10150,14961,9743,6,0,11,17
8712,PRAKASAM,Marripudi,GUNDLASAMUDRAM,340,101,327,768,121,24,195,340,320,3638,261,6673,10572,7957,5,0,4,9
8713,PRAKASAM,Marripudi,JUVVI GUNTA,113,0,269,382,62,0,140,202,191,3767,0,5385,9152,5911,11,0,12,23
8714,PRAKASAM,Marripudi,KARKALA,758,25,562,1345,140,5,258,403,381,6527,124,10449,17100,11431,11,0,16,27
8715,PRAKASAM,Marripudi,KELLAM PALLI,391,6,543,940,146,4,237,387,370,6317,188,9708,16213,9710,4,0,7,11
8716,PRAKASAM,Marripudi,KUCHIPUDI,194,2,474,670,61,0,127,188,171,3124,0,3277,6401,4648,6,0,3,9
8717,PRAKASAM,Marripudi,MARRIPUDI,336,4,1374,1714,111,0,415,526,481,3131,0,13080,16211,9751,2,0,14,16
8718,PRAKASAM,Marripudi,NARASARAJUPALEM,90,10,319,419,46,0,113,159,155,978,0,3061,4039,2354,0,0,0,0
8719,PRAKASAM,Marripudi,PANNURU,111,7,189,307,26,4,146,176,182,970,194,5940,7104,4356,1,0,7,8
8720,PRAKASAM,Marripudi,RAMAYAPALEM,72,2,133,207,45,1,93,139,136,2630,9,5991,8630,5288,7,0,21,28
8721,PRAKASAM,Marripudi,RAVELLAVARIPALEM,115,2,75,192,75,0,18,93,100,4566,0,675,5241,3263,6,0,2,8
8722,PRAKASAM,Marripudi,REGALA GADDA,79,0,182,261,34,0,114,148,158,1177,0,5695,6872,4487,1,0,7,8
8723,PRAKASAM,Marripudi,THANGELLA,146,1,435,582,32,0,205,237,243,565,0,4716,5281,3522,0,0,0,0
8724,PRAKASAM,Marripudi,VALLAYAPALEM,126,0,174,300,62,0,112,174,202,2524,0,4622,7146,4995,0,0,4,4
8725,PRAKASAM,Marripudi,VEMA VARAM,174,0,274,448,40,0,23,63,60,940,0,88,1028,607,0,0,0,0
8726,PRAKASAM,Marripudi,VENKATAKRISHNA PURAM,81,0,101,182,40,0,84,124,119,2042,0,4615,6657,3837,4,0,11,15
8727,PRAKASAM,Martur,BOBBEPALLI,399,40,519,958,224,22,166,412,369,8908,484,6447,15839,9521,12,0,13,25
8728,PRAKASAM,Martur,BOLLA PALLI,369,4,405,778,8,0,57,65,63,142,0,909,1051,600,0,0,0,0
8729,PRAKASAM,Martur,CHIMMIRIBANDA,389,10,384,783,267,8,170,445,430,9445,313,6002,15760,8769,8,0,1,9
8730,PRAKASAM,Martur,DARSI,202,8,768,978,113,4,340,457,432,2450,89,9837,12376,8152,0,0,1,1
8731,PRAKASAM,Martur,DEGARAMUDI,70,10,232,312,41,2,83,126,117,1725,23,4039,5787,3958,0,0,0,0
8732,PRAKASAM,Martur,DRONADULA,611,100,728,1439,188,12,95,295,244,6176,270,2368,8814,4384,0,0,3,3
8733,PRAKASAM,Martur,JONNA THALI,190,37,362,589,140,14,205,359,435,7795,151,8157,16103,9668,16,0,6,22
8734,PRAKASAM,Martur,KOLALAPUDI,559,19,617,1195,114,3,225,342,298,3164,38,6895,10097,6528,2,0,3,5
8735,PRAKASAM,Martur,KONANKI,542,39,337,918,296,17,112,425,327,16660,916,2947,20523,11983,34,1,0,35
8736,PRAKASAM,Martur,Lakkavaram,234,0,0,234,0,0,0,0,0,0,0,0,0,0,0,0,0,0
8737,PRAKASAM,Martur,MARTUR,1395,565,1658,3618,408,39,409,856,825,13706,1154,19693,34553,29122,5,1,14,20
8738,PRAKASAM,Martur,NAGARAJUPALLI,230,222,427,879,154,38,157,349,334,9915,1484,6809,18208,11714,22,1,12,35
8739,PRAKASAM,Martur,RAJUGARIPALEM,24,26,458,508,11,18,313,342,318,747,928,21184,22859,13507,1,2,60,63
8740,PRAKASAM,Martur,RAJUPALEM,453,77,351,881,265,40,177,482,468,15119,2020,9043,26182,15828,34,2,19,55
8741,PRAKASAM,Martur,THATIVARIPALEM,191,0,275,466,115,0,137,252,229,7753,0,7792,15545,8141,27,0,12,39
8742,PRAKASAM,Martur,VALA PARLA,608,106,1143,1857,300,36,465,801,774,19780,2541,27924,50245,32057,45,3,78,126
8743,PRAKASAM,Mundlamuru,BHEEMAVARAM,111,7,296,414,80,0,233,313,269,1546,0,9147,10693,6137,1,0,5,6
8744,PRAKASAM,Mundlamuru,BOPPIDIVARI PALEM,19,0,246,265,12,0,173,185,193,114,0,7923,8037,5966,0,0,13,13
8745,PRAKASAM,Mundlamuru,EDARA,127,4,795,926,52,0,554,606,680,1148,0,16580,17728,9113,0,0,4,4
8746,PRAKASAM,Mundlamuru,JAMMALAMADAKA,135,34,225,394,44,16,109,169,159,539,155,3812,4506,2610,0,0,2,2
8747,PRAKASAM,Mundlamuru,KELLAM PALLI,150,146,609,905,84,87,399,570,599,1219,1364,9934,12517,7725,0,0,2,2
8748,PRAKASAM,Mundlamuru,KHAMBHAM PADU (EAST),121,0,292,413,84,0,184,268,252,3538,0,10291,13829,9573,6,0,13,19
8749,PRAKASAM,Mundlamuru,MARELLA,469,18,602,1089,293,3,276,572,549,12934,37,11773,24744,17286,14,0,12,26
8750,PRAKASAM,Mundlamuru,MUNDLAMUR,564,27,413,1004,402,3,273,678,660,16553,76,10074,26703,17825,14,0,1,15
8751,PRAKASAM,Mundlamuru,NAYUDUPALEM,201,15,567,783,108,8,235,351,329,3361,316,7968,11645,6800,3,1,6,10
8752,PRAKASAM,Mundlamuru,NUZELLA PALLI,75,0,508,583,54,0,399,453,384,1630,0,7504,9134,5607,0,0,0,0
8753,PRAKASAM,Mundlamuru,PASUPUGALLU,308,22,735,1065,89,5,400,494,432,2841,248,15470,18559,11822,1,0,5,6
8754,PRAKASAM,Mundlamuru,PEDAVULLAGALLU,318,0,775,1093,124,0,466,590,510,2946,0,7892,10838,5873,1,0,2,3
8755,PRAKASAM,Mundlamuru,POLAVARAM,395,0,343,738,246,0,213,459,475,15409,0,12793,28202,16966,28,0,32,60
8756,PRAKASAM,Mundlamuru,PULIPADU,220,153,342,715,105,112,269,486,477,4799,6569,11791,23159,14194,5,9,3,17
8757,PRAKASAM,Mundlamuru,PURIMETLA,90,0,495,585,1,0,409,410,374,19,0,16781,16800,9655,0,0,3,3
8758,PRAKASAM,Mundlamuru,SANKARA PURAM,136,31,437,604,98,15,301,414,380,3207,188,8562,11957,8016,1,0,2,3
8759,PRAKASAM,Mundlamuru,SINGANA PALEM,200,3,204,407,119,2,103,224,226,4282,134,4322,8738,5047,4,0,1,5
8760,PRAKASAM,Mundlamuru,UMAMAHESWARA PURAM,129,8,643,780,81,3,441,525,493,4694,73,15605,20372,10826,8,0,6,14
8761,PRAKASAM,Mundlamuru,VEMULA,374,18,991,1383,205,5,679,889,860,4492,184,25165,29841,17213,1,0,7,8
8762,PRAKASAM,Naguluppalapadu,AMMANA BROLU,502,79,426,1007,327,19,233,579,569,15119,768,5592,21479,13310,23,1,2,26
8763,PRAKASAM,Naguluppalapadu,CHADALAWADA,207,23,366,596,114,2,209,325,309,3288,107,7641,11036,9729,0,0,2,2
8764,PRAKASAM,Naguluppalapadu,CHEERVANUPPALA PADU,423,1,318,742,192,1,123,316,313,2526,97,3439,6062,3785,0,0,0,0
8765,PRAKASAM,Naguluppalapadu,CHEKURA PADU,235,10,51,296,146,1,15,162,198,6619,20,504,7143,5184,6,0,1,7
8766,PRAKASAM,Naguluppalapadu,CHOUTAPALEM,244,13,209,466,147,5,108,260,236,5716,170,3325,9211,5552,2,0,0,2
8767,PRAKASAM,Naguluppalapadu,EDUMUDI,291,8,341,640,171,4,232,407,357,5127,169,13251,18547,9759,1,1,9,11
8768,PRAKASAM,Naguluppalapadu,H.NIDAMANUR,705,10,380,1095,175,2,41,218,189,4850,36,1019,5905,3801,8,0,0,8
8769,PRAKASAM,Naguluppalapadu,K.THAKKELLAPADU,167,4,50,221,50,0,0,50,45,496,0,0,496,309,0,0,0,0
8770,PRAKASAM,Naguluppalapadu,KANDLAGUNTA,179,4,106,289,130,3,20,153,160,9932,93,1212,11237,6679,19,0,1,20
8771,PRAKASAM,Naguluppalapadu,KANUPARTHI,209,38,1171,1418,141,23,786,950,867,5220,1306,29420,35946,18567,1,3,20,24
8772,PRAKASAM,Naguluppalapadu,KOTHAKOTA,120,0,93,213,90,0,24,114,106,2270,0,267,2537,1737,0,0,0,0
8773,PRAKASAM,Naguluppalapadu,MACHAVARAM,235,0,188,423,188,0,3,191,194,10838,0,51,10889,6861,27,0,0,27
8774,PRAKASAM,Naguluppalapadu,MADDIRALA MUPPALLA,161,12,153,326,107,6,87,200,153,5241,282,2613,8136,3638,9,0,3,12
8775,PRAKASAM,Naguluppalapadu,MADDIRALA PADU,414,17,176,607,110,0,13,123,116,1616,0,203,1819,1390,0,0,0,0
8776,PRAKASAM,Naguluppalapadu,MATTIGUNTA,149,16,123,288,97,1,40,138,118,3743,4,973,4720,2851,0,0,0,0
8777,PRAKASAM,Naguluppalapadu,NAGULUPPALA PADU,342,0,221,563,172,0,64,236,222,6854,0,3377,10231,7226,13,0,6,19
8778,PRAKASAM,Naguluppalapadu,OBANNAPALEM,4,0,82,86,0,0,4,4,4,0,0,64,64,32,0,0,0,0
8779,PRAKASAM,Naguluppalapadu,OMMEVARAM,355,6,211,572,220,3,84,307,281,5872,92,2508,8472,6202,3,0,0,3
8780,PRAKASAM,Naguluppalapadu,POTHAVARAM,310,4,182,496,105,0,21,126,106,1606,0,445,2051,1207,0,0,0,0
8781,PRAKASAM,Naguluppalapadu,RAPARLA,183,48,160,391,127,13,112,252,248,5701,614,5486,11801,8169,5,2,9,16
8782,PRAKASAM,Naguluppalapadu,THIMMASAMUDRAM,707,29,546,1282,425,7,228,660,601,9238,485,6094,15817,8218,2,3,4,9
8783,PRAKASAM,Naguluppalapadu,UPPUGUNDUR,713,288,705,1706,416,68,297,781,699,16306,804,10131,27241,16249,13,0,0,13
8784,PRAKASAM,Naguluppalapadu,VINODARAYUNI PALEM,62,0,250,312,40,0,99,139,124,856,0,1404,2260,1578,0,0,0,0
8785,PRAKASAM,Ongole,BODDULURIVARI PALEM,44,1,107,152,39,0,60,99,88,1633,0,1738,3371,2214,1,0,0,1
8786,PRAKASAM,Ongole,CHEJARLA,128,2,249,379,108,0,148,256,262,3856,0,4453,8309,4802,0,0,0,0
8787,PRAKASAM,Ongole,CHERVU KOMMUPALEM,0,0,0,0,0,0,0,0,0,0,0,0,0,0,0,0,0,0
8788,PRAKASAM,Ongole,CHINTHAYAGARIPALEM,6,0,533,539,0,0,369,369,360,0,0,12964,12964,7439,0,0,1,1
8789,PRAKASAM,Ongole,DASARAJUPALLI,142,0,39,181,83,0,8,91,95,2999,0,253,3252,2896,0,0,0,0
8790,PRAKASAM,Ongole,DEVARAM PADU,0,0,124,124,0,0,82,82,76,0,0,5206,5206,3452,0,0,14,14
8791,PRAKASAM,Ongole,DEVARAM PADU HARIJANAWADA,237,0,39,276,179,0,30,209,211,10629,0,1700,12329,8335,24,0,4,28
8792,PRAKASAM,Ongole,GUNDAYAPALEM,1,0,621,622,1,0,378,379,364,21,0,21584,21605,12807,0,0,11,11
8793,PRAKASAM,Ongole,KARAVADI,539,5,311,855,244,1,54,299,277,11207,2,680,11889,7703,20,0,0,20
8794,PRAKASAM,Ongole,KOPPOLU,0,0,0,0,0,0,0,0,0,0,0,0,0,0,0,0,0,0
8795,PRAKASAM,Ongole,MANDUVAVARIPALEM,99,11,90,200,58,2,14,74,69,961,37,244,1242,837,0,0,0,0
8796,PRAKASAM,Ongole,MUKTHINUTHALA PADU,0,0,0,0,0,0,0,0,0,0,0,0,0,0,0,0,0,0
8797,PRAKASAM,Ongole,NARASA PURAM AGRAHARAM,0,0,0,0,0,0,0,0,0,0,0,0,0,0,0,0,0,0
8798,PRAKASAM,Ongole,PATHAPADU,0,18,194,212,0,0,154,154,153,0,0,13062,13062,8002,0,0,68,68
8799,PRAKASAM,Ongole,PELLUR,0,0,0,0,0,0,0,0,0,0,0,0,0,0,0,0,0,0
8800,PRAKASAM,Ongole,SARVEREDDI PALEM,217,1,208,426,116,1,141,258,209,6262,76,9883,16221,10374,9,0,18,27
8801,PRAKASAM,Ongole,THROVAGUNTA,0,0,0,0,0,0,0,0,0,0,0,0,0,0,0,0,0,0
8802,PRAKASAM,Ongole,ULICHI,281,0,172,453,214,0,61,275,261,7941,0,1226,9167,6603,3,0,0,3
8803,PRAKASAM,Ongole,VALETIVARIPALEM,70,0,108,178,1,0,4,5,4,14,0,68,82,48,0,0,0,0
8804,PRAKASAM,Ongole,VENGAMUKKAPALEM,0,0,0,0,0,0,0,0,0,0,0,0,0,0,0,0,0,0
8805,PRAKASAM,Ongole,YARAJERLA,240,5,552,797,85,0,276,361,347,4223,0,10985,15208,12190,8,0,0,8
8806,PRAKASAM,Pamur,AYYANNA KOTA,82,106,71,259,37,54,34,125,116,413,728,407,1548,874,0,0,0,0
8807,PRAKASAM,Pamur,AYYAVARI PALLI,103,11,182,296,43,7,20,70,68,925,153,619,1697,951,0,0,1,1
8808,PRAKASAM,Pamur,BALIJAPALEM,20,4,178,202,8,0,15,23,17,181,0,154,335,212,0,0,0,0
8809,PRAKASAM,Pamur,BODAWADA,54,7,199,260,2,0,3,5,5,25,0,43,68,34,0,0,0,0
8810,PRAKASAM,Pamur,BOTLA GUDUR,202,21,800,1023,13,1,128,142,127,221,36,3097,3354,2313,0,0,0,0
8811,PRAKASAM,Pamur,BUKKAPURAM,93,17,285,395,23,2,126,151,154,366,14,3464,3844,2697,0,0,1,1
8812,PRAKASAM,Pamur,CHILAMKUR,92,1,219,312,66,1,118,185,191,4367,19,7379,11765,8350,11,0,20,31
8813,PRAKASAM,Pamur,CHINTHALA PALEM,137,4,201,342,2,0,23,25,20,30,0,856,886,444,0,0,0,0
8814,PRAKASAM,Pamur,DADIREDDI PALLI,102,33,271,406,37,0,44,81,89,748,0,151,899,583,0,0,0,0
8815,PRAKASAM,Pamur,DUBHAGUNTA,142,19,555,716,75,8,175,258,280,3570,480,9343,13393,7872,7,0,15,22
8816,PRAKASAM,Pamur,EAST KODIGUDLA PADU,83,5,300,388,11,0,19,30,18,55,0,151,206,100,0,0,0,0
8817,PRAKASAM,Pamur,INIMERLA,222,0,354,576,141,0,239,380,440,6302,0,8625,14927,8352,18,0,6,24
8818,PRAKASAM,Pamur,KAMBHALADINNE,244,19,800,1063,73,0,242,315,292,1359,0,4266,5625,2997,0,0,0,0
8819,PRAKASAM,Pamur,KATTAKINDA PALLI,347,3,736,1086,0,0,2,2,1,0,0,34,34,10,0,0,0,0
8820,PRAKASAM,Pamur,KODIGUMPALA,116,3,371,490,15,0,67,82,93,361,0,2133,2494,1820,0,0,0,0
8821,PRAKASAM,Pamur,LAKSHMI NARASAPURAM,167,8,587,762,34,0,62,96,80,400,0,912,1312,796,0,0,0,0
8822,PRAKASAM,Pamur,MARKONDAPURAM,61,6,451,518,8,0,81,89,86,114,0,2187,2301,1608,0,0,0,0
8823,PRAKASAM,Pamur,MOPADU,115,21,579,715,56,1,218,275,253,2703,116,8269,11088,7462,3,1,15,19
8824,PRAKASAM,Pamur,NARRAMARELLA,288,19,364,671,0,0,2,2,3,0,0,40,40,18,0,0,0,0
8825,PRAKASAM,Pamur,NUTCHUPODA,105,0,385,490,1,0,22,23,24,8,0,218,226,136,0,0,0,0
8826,PRAKASAM,Pamur,PAMUR,141,31,1576,1748,1,0,130,131,110,5,0,3668,3673,3040,0,0,0,0
8827,PRAKASAM,Pamur,RAVIGUNTA PALLI,88,35,253,376,36,25,176,237,261,1509,509,10213,12231,7266,2,0,29,31
8828,PRAKASAM,Pamur,VAGGAM PALLI,132,50,629,811,42,17,28,87,86,2584,417,1103,4104,2360,10,0,2,12
8829,PRAKASAM,Pamur,VEERABHADRA PURAM,36,5,110,151,0,2,17,19,20,0,24,179,203,137,0,0,0,0
8830,PRAKASAM,Pamur,WEST KTTAKINDI PALLE,146,0,629,775,6,0,26,32,31,78,0,341,419,277,0,0,0,0
8831,PRAKASAM,Parchur,ADUSUMALLI,170,58,86,314,80,2,3,85,75,2573,37,12,2622,1328,0,0,0,0
8832,PRAKASAM,Parchur,ANNAMBHOTLAVARI PALEM,13,16,182,211,0,0,0,0,0,0,0,0,0,0,0,0,0,0
8833,PRAKASAM,Parchur,BHUSHAYA PALEM,0,18,54,72,0,1,18,19,9,0,5,163,168,63,0,0,0,0
8834,PRAKASAM,Parchur,BODAWADA MANDAGUNTA,110,13,130,253,55,4,61,120,72,2089,48,1923,4060,1646,1,0,0,1
8835,PRAKASAM,Parchur,CHENNUBHOTLAVARI PALEM,147,1,27,175,73,1,21,95,86,3209,84,1233,4526,2845,1,0,4,5
8836,PRAKASAM,Parchur,CHERUKURU,367,102,1473,1942,157,13,472,642,551,1939,90,6058,8087,4068,0,0,0,0
8837,PRAKASAM,Parchur,CHINA NANDIPADU,71,13,136,220,57,10,69,136,112,3385,680,2736,6801,3574,9,3,5,17
8838,PRAKASAM,Parchur,CHINTAGUNTAPALEM,8,0,67,75,0,0,27,27,26,0,0,2044,2044,1111,0,0,12,12
8839,PRAKASAM,Parchur,DEVARA PALLI,191,2,183,376,77,0,64,141,100,1188,0,1194,2382,1012,3,0,0,3
8840,PRAKASAM,Parchur,EDUBADU,174,1,103,278,119,0,65,184,101,1898,0,2151,4049,769,0,0,0,0
8841,PRAKASAM,Parchur,GARNEPUDI,304,11,100,415,147,0,6,153,154,5989,0,67,6056,3214,4,0,0,4
8842,PRAKASAM,Parchur,GOLLAPUDI,135,3,101,239,100,0,78,178,182,2179,0,3548,5727,2924,0,0,3,3
8843,PRAKASAM,Parchur,INAGALLU,146,2,142,290,111,2,37,150,141,6664,77,2311,9052,4999,20,0,3,23
8844,PRAKASAM,Parchur,KOLLAVARI PALEM,116,0,57,173,73,0,26,99,83,2006,0,692,2698,1371,0,0,1,1
8845,PRAKASAM,Parchur,KOMARNENIVARI PALEM,79,49,38,166,75,41,33,149,147,5173,3067,1999,10239,5167,16,13,8,37
8846,PRAKASAM,Parchur,KOTHAPALEM,17,29,129,175,16,23,92,131,125,703,1198,5086,6987,3550,0,2,1,3
8847,PRAKASAM,Parchur,NAGULAPALEM,341,24,334,699,86,9,132,227,173,1200,283,4888,6371,3302,0,0,6,6
8848,PRAKASAM,Parchur,NUTHALAPADU,266,17,648,931,141,2,137,280,248,5233,25,2767,8025,3933,4,0,0,4
8849,PRAKASAM,Parchur,PARCHUR,372,239,308,919,189,15,38,242,204,7420,408,728,8556,4670,12,0,0,12
8850,PRAKASAM,Parchur,PEDDIVARI PALEM,97,0,48,145,24,0,0,24,22,221,0,0,221,107,0,0,0,0
8851,PRAKASAM,Parchur,POTHUKATLA,160,2,362,524,101,2,169,272,287,2990,17,4404,7411,3902,2,0,1,3
8852,PRAKASAM,Parchur,RAMANAYAPALEM,21,32,150,203,8,19,98,125,119,349,679,4619,5647,2773,0,1,3,4
8853,PRAKASAM,Parchur,TANNERUVARI PALEM,10,110,93,213,4,83,16,103,105,45,4102,136,4283,2197,0,9,0,9
8854,PRAKASAM,Parchur,THIMMARAJU PALEM,0,4,70,74,0,0,0,0,0,0,0,0,0,0,0,0,0,0
8855,PRAKASAM,Parchur,UPPUTUR,64,6,397,467,24,4,231,259,8,902,56,9265,10223,42,2,0,4,6
8856,PRAKASAM,Parchur,VEERANNA PALEM,407,8,325,740,157,0,42,199,157,4613,0,1403,6016,3172,3,0,1,4
8857,PRAKASAM,Pedaaraveedu,BADVEEDU,49,30,389,468,40,24,296,360,373,2754,823,12624,16201,9422,12,0,6,18
8858,PRAKASAM,Pedaaraveedu,BADVEEDU CHERLOPALLI,184,0,474,658,119,0,384,503,589,3339,0,10321,13660,7105,0,0,0,0
8859,PRAKASAM,Pedaaraveedu,BOYADA GUMPULA,333,9,381,723,232,7,202,441,496,11324,360,8811,20495,10399,29,0,2,31
8860,PRAKASAM,Pedaaraveedu,CHATLA MITTA,71,27,322,420,52,3,228,283,355,4115,102,10781,14998,8755,18,0,13,31
8861,PRAKASAM,Pedaaraveedu,CUMBUMPADU,359,1,594,954,264,1,347,612,644,9668,121,13037,22826,11899,18,1,21,40
8862,PRAKASAM,Pedaaraveedu,DEVARAJU GATTU,52,7,327,386,48,0,221,269,316,2864,0,13523,16387,8938,5,0,23,28
8863,PRAKASAM,Pedaaraveedu,GOBBURU,190,32,733,955,116,18,359,493,512,1364,220,5359,6943,3419,0,0,1,1
8864,PRAKASAM,Pedaaraveedu,GUNDAMCHARLA,90,40,250,380,60,8,197,265,284,4827,554,12784,18165,8977,15,0,19,34
8865,PRAKASAM,Pedaaraveedu,KALANUTHALA,144,121,517,782,103,34,340,477,584,8444,1359,17473,27276,14155,41,0,26,67
8866,PRAKASAM,Pedaaraveedu,MADDALAKATLA,391,13,617,1021,247,8,464,719,845,10079,248,20317,30644,15423,13,0,12,25
8867,PRAKASAM,Pedaaraveedu,PEDA ARAVEEDU,308,51,950,1309,185,18,674,877,873,7695,955,33869,42519,22280,7,0,22,29
8868,PRAKASAM,Pedaaraveedu,PUCHAKAYALAPALLI,152,2,270,424,130,0,236,366,427,6387,0,11149,17536,10325,7,0,10,17
8869,PRAKASAM,Pedaaraveedu,RAMAYAPALEM,107,1,207,315,98,1,174,273,299,6409,66,11535,18010,9785,21,0,19,40
8870,PRAKASAM,Pedaaraveedu,REGUMANIPALLI,148,6,297,451,120,5,181,306,372,4483,55,8402,12940,6426,7,0,11,18
8871,PRAKASAM,Pedaaraveedu,S.KOTHA PALLI,55,3,242,300,47,3,201,251,280,1980,181,9042,11203,6111,0,0,3,3
8872,PRAKASAM,Pedaaraveedu,SANIKAVARAM,169,4,447,620,115,3,324,442,458,5449,100,11456,17005,9365,13,0,4,17
8873,PRAKASAM,Pedaaraveedu,SUNKESULA,381,9,608,998,266,8,495,769,879,11011,610,23377,34998,19332,14,1,33,48
8874,PRAKASAM,Pedaaraveedu,THANGIRALLAPALLI,207,3,618,828,117,3,183,303,338,1320,36,2969,4325,2297,0,0,2,2
8875,PRAKASAM,Pedaaraveedu,THOKA PALLI,227,4,436,667,172,0,289,461,580,9306,0,8334,17640,9237,14,0,15,29
8876,PRAKASAM,Pedacherlopalle,BATTUPALLI,68,0,115,183,30,0,28,58,62,1293,0,1072,2365,1746,1,0,0,1
8877,PRAKASAM,Pedacherlopalle,CHINAVARI MADUGU,134,1,220,355,68,0,36,104,96,1396,0,1221,2617,1578,3,0,2,5
8878,PRAKASAM,Pedacherlopalle,CHINTHAGUM PALLI,118,28,436,582,38,0,146,184,194,2088,0,5882,7970,4349,8,0,12,20
8879,PRAKASAM,Pedacherlopalle,CHOWTA GOGULA PALLE,7,0,161,168,6,0,97,103,105,478,0,6577,7055,5049,3,0,18,21
8880,PRAKASAM,Pedacherlopalle,GUDEVARI PALEM,227,6,352,585,96,2,66,164,146,3615,83,1741,5439,3302,5,0,2,7
8881,PRAKASAM,Pedacherlopalle,GUNTU PALLI,252,16,860,1128,112,4,219,335,337,3825,68,7658,11551,7092,0,0,8,8
8882,PRAKASAM,Pedacherlopalle,LAKSHMAKKA PALLI,58,29,358,445,37,12,152,201,207,707,341,3913,4961,2532,0,1,4,5
8883,PRAKASAM,Pedacherlopalle,MARELLA,62,1,349,412,33,0,81,114,115,451,0,3065,3516,2230,0,0,3,3
8884,PRAKASAM,Pedacherlopalle,MUDDAPADU,162,6,335,503,53,0,56,109,109,1215,0,2036,3251,1908,0,0,0,0
8885,PRAKASAM,Pedacherlopalle,MURUGUMMI,126,10,465,601,4,0,19,23,15,42,0,194,236,94,0,0,0,0
8886,PRAKASAM,Pedacherlopalle,NEREDU PALLI,83,2,559,644,17,0,249,266,240,314,0,5562,5876,4019,0,0,1,1
8887,PRAKASAM,Pedacherlopalle,PEDA ALAVALA PADU,159,11,703,873,69,2,238,309,274,2065,110,8922,11097,6521,0,1,8,9
8888,PRAKASAM,Pedacherlopalle,PEDA IRLA PADU,200,11,804,1015,29,1,151,181,178,848,74,6718,7640,4036,0,0,23,23
8889,PRAKASAM,Pedacherlopalle,PEDACHERLO PALLI,355,4,1130,1489,128,0,264,392,376,8146,0,14942,23088,12761,37,0,56,93
8890,PRAKASAM,Pedacherlopalle,POTHAVARAM,75,0,198,273,34,0,118,152,143,1459,0,5039,6498,4583,0,0,4,4
8891,PRAKASAM,Pedacherlopalle,TALAKONDAPADU,164,6,528,698,59,1,99,159,147,2016,3,2883,4902,2616,1,0,1,2
8892,PRAKASAM,Pedacherlopalle,VAPAGUM PALLI,12,0,181,193,1,0,19,20,20,20,0,306,326,170,0,0,0,0
8893,PRAKASAM,Pedacherlopalle,VENGALAYAPALLI,159,1,369,529,58,0,193,251,261,1476,0,8252,9728,5018,0,0,8,8
8894,PRAKASAM,Podili,AKKA CHERUVU,111,0,281,392,85,0,163,248,242,6432,0,12734,19166,13409,28,0,43,71
8895,PRAKASAM,Podili,AMUDALAPALLI,253,0,537,790,146,0,350,496,492,6354,0,12841,19195,10227,11,0,6,17
8896,PRAKASAM,Podili,ANNA VARAM,221,41,368,630,120,4,247,371,356,3437,101,11580,15118,9646,4,0,10,14
8897,PRAKASAM,Podili,EGALAPADU,131,10,272,413,85,4,192,281,305,4052,108,4379,8539,4811,3,0,0,3
8898,PRAKASAM,Podili,KAMBHALAPADU,474,68,845,1387,131,35,487,653,620,7429,2565,31766,41760,24889,19,6,79,104
8899,PRAKASAM,Podili,KONDAYA PALEM,149,0,351,500,20,0,66,86,76,220,0,857,1077,637,0,0,0,0
8900,PRAKASAM,Podili,KUNCHEPALLI,278,6,541,825,126,2,277,405,407,4688,84,12885,17657,12843,6,0,20,26
8901,PRAKASAM,Podili,MADALAVARI PALEM,247,33,268,548,127,0,160,287,301,6555,0,11397,17952,12701,13,0,28,41
8902,PRAKASAM,Podili,MALLAVARAM,161,0,322,483,95,0,189,284,309,5088,0,9638,14726,10023,7,0,9,16
8903,PRAKASAM,Podili,MUGACHINTHALA,210,5,198,413,140,4,135,279,281,5936,56,6092,12084,8234,9,0,2,11
8904,PRAKASAM,Podili,NANDI PALEM,133,16,254,403,43,7,134,184,183,1782,497,7888,10167,8038,2,1,15,18
8905,PRAKASAM,Podili,OBULAKKA PALLI,105,0,201,306,78,1,122,201,200,4287,37,8338,12662,7651,15,0,25,40
8906,PRAKASAM,Podili,PAMULAPADU,179,0,297,476,93,0,218,311,299,3428,0,6372,9800,5275,1,0,6,7
8907,PRAKASAM,Podili,PODILI,475,158,1464,2097,93,9,398,500,503,3231,276,14614,18121,13162,8,0,14,22
8908,PRAKASAM,Podili,SUDANAGUNTA,62,15,474,551,36,6,325,367,353,2129,306,17824,20259,12276,5,0,16,21
8909,PRAKASAM,Podili,THALAMALLA,182,6,289,477,75,2,79,156,149,2565,47,1623,4235,3592,1,0,0,1
8910,PRAKASAM,Podili,THUMMAGUNTA,207,0,147,354,150,0,94,244,249,12610,0,7430,20040,11494,72,0,31,103
8911,PRAKASAM,Podili,UPPALAPADU,191,35,442,668,99,9,284,392,372,2694,137,7508,10339,8426,2,0,0,2
8912,PRAKASAM,Podili,YELURU,258,4,623,885,128,1,331,460,431,6148,40,15775,21963,15255,9,0,10,19
8913,PRAKASAM,Podili,ZUVVALERU,79,1,217,297,67,0,192,259,280,5445,0,15164,20609,16622,23,0,53,76
8914,PRAKASAM,Ponnaluru,BOGANAMPADU,265,42,785,1092,130,7,467,604,519,1811,52,9227,11090,6723,0,0,0,0
8915,PRAKASAM,Ponnaluru,CHENNIPADU,184,9,329,522,78,0,164,242,229,2980,0,3347,6327,4268,3,0,0,3
8916,PRAKASAM,Ponnaluru,CHERUKUR,147,8,425,580,74,1,278,353,333,1429,2,6219,7650,5446,0,0,0,0
8917,PRAKASAM,Ponnaluru,CHOUTA PALEM,160,0,415,575,96,0,239,335,297,3920,0,9126,13046,7267,0,0,0,0
8918,PRAKASAM,Ponnaluru,IPPA GUNTA,211,3,425,639,138,2,286,426,423,10504,111,18438,29053,22857,32,1,29,62
8919,PRAKASAM,Ponnaluru,K.AGRAHARAM,4,0,199,203,2,0,152,154,155,127,0,8687,8814,6080,1,0,14,15
8920,PRAKASAM,Ponnaluru,KOTAPADU,201,8,422,631,114,4,288,406,396,6674,23,14721,21418,12546,16,0,14,30
8921,PRAKASAM,Ponnaluru,MALEPADU,85,16,564,665,46,1,193,240,221,1329,4,3626,4959,3327,0,0,0,0
8922,PRAKASAM,Ponnaluru,MEKAPADU,57,0,158,215,17,0,34,51,49,504,0,504,1008,625,0,0,0,0
8923,PRAKASAM,Ponnaluru,MUNDLAMURIVARI PALEM,29,0,284,313,17,0,201,218,210,456,0,4598,5054,3125,0,0,0,0
8924,PRAKASAM,Ponnaluru,MUPPALLA,152,7,231,390,100,5,106,211,192,1915,65,1863,3843,2604,0,0,0,0
8925,PRAKASAM,Ponnaluru,NAGIREDDY PALEM,79,75,288,442,50,2,173,225,208,2149,64,9768,11981,9859,1,0,2,3
8926,PRAKASAM,Ponnaluru,PEDAVENKANNA PALEM,98,0,152,250,76,0,131,207,219,3035,0,4550,7585,4809,0,0,0,0
8927,PRAKASAM,Ponnaluru,PONNALUR,194,28,703,925,111,0,412,523,513,4249,0,13538,17787,12688,7,0,3,10
8928,PRAKASAM,Ponnaluru,RAJOLUPADU,112,0,162,274,73,0,93,166,169,1961,0,4057,6018,3348,1,0,0,1
8929,PRAKASAM,Ponnaluru,RAVULA KOLLU,257,28,349,634,131,8,165,304,285,4324,122,3094,7540,5140,1,0,1,2
8930,PRAKASAM,Ponnaluru,REDDY PALEM,45,0,194,239,34,0,107,141,134,2488,0,5700,8188,6001,3,0,3,6
8931,PRAKASAM,Ponnaluru,SINGARA BOTLA PALEM,204,1,368,573,122,0,217,339,334,4570,0,8825,13395,9193,0,0,3,3
8932,PRAKASAM,Ponnaluru,SUNKIREDDY PALEM,83,0,58,141,51,0,33,84,85,1994,0,1607,3601,2797,1,0,1,2
8933,PRAKASAM,Ponnaluru,THIMMAPALEM,80,3,473,556,38,0,270,308,279,1578,0,8931,10509,6497,0,0,5,5
8934,PRAKASAM,Ponnaluru,UPPALA DINNE,160,0,94,254,102,0,20,122,124,5897,0,851,6748,4754,7,0,0,7
8935,PRAKASAM,Ponnaluru,VELLATURU,109,0,234,343,53,0,48,101,97,1208,0,612,1820,1329,0,0,0,0
8936,PRAKASAM,Ponnaluru,VEMPADU,130,0,192,322,45,0,38,83,85,2413,0,1691,4104,3069,2,0,2,4
8937,PRAKASAM,Ponnaluru,VENKUPALEM,91,37,270,398,30,8,63,101,89,380,265,618,1263,853,0,0,0,0
8938,PRAKASAM,Pullalacheruvu,CHAPALA MADUGU,381,10,717,1108,192,4,357,553,557,10106,73,11636,21815,11992,23,0,9,32
8939,PRAKASAM,Pullalacheruvu,GANGAVARAM,189,0,445,634,54,0,227,281,306,1361,0,3985,5346,2764,0,0,0,0
8940,PRAKASAM,Pullalacheruvu,ISUKATRIPURAVARAM,694,649,1292,2635,188,254,542,984,1086,3749,14180,17398,35327,17885,0,47,8,55
8941,PRAKASAM,Pullalacheruvu,KAVALA KUNTLA,143,2,476,621,103,1,376,480,500,4894,12,17650,22556,12273,12,0,32,44
8942,PRAKASAM,Pullalacheruvu,KOMAROLU,273,324,782,1379,199,103,543,845,794,13354,3653,34798,51805,25847,45,5,79,129
8943,PRAKASAM,Pullalacheruvu,MALLAPALEM,257,155,470,882,185,97,226,508,647,9641,4999,13722,28362,14538,8,1,22,31
8944,PRAKASAM,Pullalacheruvu,MANE PALLI,115,104,665,884,80,57,538,675,807,1617,2066,16122,19805,10525,0,1,4,5
8945,PRAKASAM,Pullalacheruvu,MARRIVEMULA,269,3,792,1064,128,1,371,500,513,4371,12,14377,18760,9295,3,0,14,17
8946,PRAKASAM,Pullalacheruvu,MUTUKULA,540,130,978,1648,315,30,471,816,841,11693,896,18103,30692,16981,15,0,27,42
8947,PRAKASAM,Pullalacheruvu,NAYUDUPALEM,208,2,437,647,95,2,292,389,410,3936,121,17375,21432,11169,6,0,24,30
8948,PRAKASAM,Pullalacheruvu,PIDIKITIVARI PALLI,51,0,460,511,46,0,331,377,424,3604,0,19882,23486,12052,9,0,56,65
8949,PRAKASAM,Pullalacheruvu,PULLALA CHERUVU,428,1345,1266,3039,90,401,542,1033,893,2095,20390,7833,30318,14918,1,33,1,35
8950,PRAKASAM,Pullalacheruvu,RACHA KONDA,519,378,1384,2281,184,152,748,1084,1131,6345,4626,38523,49494,24745,3,2,47,52
8951,PRAKASAM,Pullalacheruvu,SATHA KODU,332,298,599,1229,228,30,171,429,469,10586,3865,7709,22160,10949,15,19,10,44
8952,PRAKASAM,Pullalacheruvu,YENDRA PALLI,254,1182,151,1587,156,394,90,640,610,9114,18061,3896,31071,15172,20,21,8,49
8953,PRAKASAM,Racherla,AKAVEEDU,238,30,1193,1461,113,7,630,750,700,5311,117,39517,44945,23774,16,0,144,160
8954,PRAKASAM,Racherla,ANUMALA PALLI,35,6,384,425,24,2,299,325,354,1403,107,18981,20491,11766,0,0,68,68
8955,PRAKASAM,Racherla,CHINAGANI PALLI,112,14,538,664,46,3,281,330,311,2130,134,12452,14716,7444,2,0,7,9
8956,PRAKASAM,Racherla,CHOLLAVEEDU,98,7,740,845,62,3,408,473,416,3195,105,20678,23978,12627,12,0,67,79
8957,PRAKASAM,Racherla,EDAVALLI,233,5,508,746,139,3,212,354,338,9906,249,15788,25943,15509,23,0,55,78
8958,PRAKASAM,Racherla,GOWTHAVARAM,17,1,327,345,12,1,227,240,207,938,80,11158,12176,6613,6,0,10,16
8959,PRAKASAM,Racherla,GUDIMETLA,132,0,638,770,68,0,393,461,529,3783,0,20257,24040,13700,14,0,70,84
8960,PRAKASAM,Racherla,JALLYVANIPULLALACHERUVU,139,6,608,753,37,2,348,387,359,480,10,12570,13060,8158,0,0,28,28
8961,PRAKASAM,Racherla,KALVAPALLI,26,0,353,379,9,0,234,243,234,547,0,16834,17381,10031,1,0,72,73
8962,PRAKASAM,Racherla,ODDULAVAGU PALLI,21,2,436,459,8,0,233,241,240,263,0,8336,8599,5280,0,0,2,2
8963,PRAKASAM,Racherla,PALAKAVEEDU,123,10,733,866,62,2,447,511,506,2720,99,19783,22602,13261,2,0,12,14
8964,PRAKASAM,Racherla,RACHERLA,252,5,1180,1437,130,1,626,757,735,5800,41,21332,27173,16370,9,0,20,29
8965,PRAKASAM,Racherla,SATYAVOLU,96,2,320,418,37,1,218,256,237,291,46,15434,15771,9027,0,0,54,54
8966,PRAKASAM,Racherla,SOMIDEVI PALLI,17,0,444,461,12,0,243,255,223,665,0,13401,14066,8209,1,0,8,9
8967,PRAKASAM,Santhamaguluru,ADAVIPALEM,47,27,421,495,32,17,328,377,325,1158,577,9161,10896,6041,0,1,0,1
8968,PRAKASAM,Santhamaguluru,BANDIVARIPALEM,161,0,141,302,79,0,96,175,168,2624,0,2571,5195,3387,5,0,2,7
8969,PRAKASAM,Santhamaguluru,CHAVATAPALEM,7,7,412,426,4,3,220,227,204,40,231,11550,11821,5985,0,0,30,30
8970,PRAKASAM,Santhamaguluru,ELCHUR,425,48,1439,1912,231,15,617,863,816,10471,665,27472,38608,20965,13,0,19,32
8971,PRAKASAM,Santhamaguluru,GURIJE PALLI,219,14,94,327,127,4,66,197,199,3061,35,3245,6341,5425,3,0,6,9
8972,PRAKASAM,Santhamaguluru,KAME PALLI,180,29,463,672,65,16,301,382,297,726,178,6354,7258,3341,0,0,0,0
8973,PRAKASAM,Santhamaguluru,KOMMALA PADU,7,1,685,693,1,1,211,213,200,58,5,6387,6450,3855,0,0,3,3
8974,PRAKASAM,Santhamaguluru,KOPPARAM,3,182,671,856,1,31,194,226,195,28,913,3996,4937,2878,0,3,1,4
8975,PRAKASAM,Santhamaguluru,KUNDURU,231,122,740,1093,98,32,234,364,355,4329,1029,8261,13619,10375,2,0,2,4
8976,PRAKASAM,Santhamaguluru,MAKKENAVARIPALEM,401,0,713,1114,188,0,380,568,529,3234,0,7532,10766,6292,0,0,2,2
8977,PRAKASAM,Santhamaguluru,MAMILLA PALLI,170,0,364,534,94,0,193,287,281,5408,0,10177,15585,9176,14,0,24,38
8978,PRAKASAM,Santhamaguluru,MINNEKALLU,155,16,428,599,22,5,267,294,222,1056,196,10889,12141,5864,0,0,7,7
8979,PRAKASAM,Santhamaguluru,PARITALAVARIPALEM,49,3,397,449,37,0,328,365,314,1006,0,7963,8969,4635,0,0,0,0
8980,PRAKASAM,Santhamaguluru,PATHAMAGULUR,293,26,371,690,136,16,251,403,399,1463,822,11204,13489,7752,0,3,7,10
8981,PRAKASAM,Santhamaguluru,PATTEPURAM,2,51,283,336,0,2,213,215,191,0,14,10670,10684,6203,0,0,5,5
8982,PRAKASAM,Santhamaguluru,PUTTAVARIPALEM,14,13,266,293,5,1,163,169,162,140,28,5017,5185,3786,0,0,0,0
8983,PRAKASAM,Santhamaguluru,SAJJAPURAM,256,44,523,823,154,27,310,491,459,7134,964,16811,24909,13823,14,2,48,64
8984,PRAKASAM,Santhamaguluru,SANTHAMAGULUR,289,70,768,1127,168,2,330,500,455,2450,105,9381,11936,7431,0,0,6,6
8985,PRAKASAM,Santhamaguluru,TAGEDU MALLI,253,15,221,489,80,7,22,109,90,3178,217,569,3964,2445,4,0,0,4
8986,PRAKASAM,Santhamaguluru,VELLALA CHERUVU,340,33,712,1085,140,14,273,427,362,1577,169,3228,4974,2877,0,0,0,0
8987,PRAKASAM,Santhanuthlapadu,BODDUVARIPALEM,105,31,206,342,54,10,71,135,128,984,208,1574,2766,1910,0,0,0,0
8988,PRAKASAM,Santhanuthlapadu,CHANDRAPALEM,83,7,273,363,16,0,12,28,21,126,0,240,366,200,0,0,0,0
8989,PRAKASAM,Santhanuthlapadu,CHILAKAPADU,176,10,313,499,98,5,128,231,237,3004,91,2644,5739,4170,1,0,0,1
8990,PRAKASAM,Santhanuthlapadu,ENDLURU,249,0,348,597,113,0,136,249,216,6511,0,5243,11754,10422,16,0,16,32
8991,PRAKASAM,Santhanuthlapadu,GUMMALAMPADU,111,16,473,600,67,1,247,315,288,3782,39,6231,10052,5621,8,0,1,9
8992,PRAKASAM,Santhanuthlapadu,GURUVAREDDY PALEM,195,2,203,400,111,0,44,155,164,2763,0,1909,4672,3356,1,0,4,5
8993,PRAKASAM,Santhanuthlapadu,KAMEPALLIVARI PALEM,107,21,127,255,58,0,20,78,67,779,0,228,1007,694,0,0,0,0
8994,PRAKASAM,Santhanuthlapadu,KONAGANI VARI PALEM,7,15,151,173,0,0,11,11,4,0,0,136,136,28,0,0,0,0
8995,PRAKASAM,Santhanuthlapadu,LAKSHMI PURAM,86,2,140,228,3,0,5,8,9,26,0,49,75,75,0,0,0,0
8996,PRAKASAM,Santhanuthlapadu,MADDULURU,313,10,695,1018,151,2,231,384,359,4812,13,5316,10141,6510,8,0,4,12
8997,PRAKASAM,Santhanuthlapadu,MANGAMURU,543,7,317,867,290,4,192,486,497,7533,55,3747,11335,9655,3,0,0,3
8998,PRAKASAM,Santhanuthlapadu,MYNAMPADU,436,13,609,1058,117,0,143,260,226,950,0,2151,3101,2194,0,0,0,0
8999,PRAKASAM,Santhanuthlapadu,PADAMATI THAKKELLA PADU,162,0,204,366,112,0,119,231,229,5243,0,4577,9820,7169,4,0,1,5
9000,PRAKASAM,Santhanuthlapadu,PERNAMITTA,576,10,381,967,0,0,0,0,0,0,0,0,0,0,0,0,0,0
9001,PRAKASAM,Santhanuthlapadu,PIDAHALAGUDI PADU,202,3,321,526,39,2,108,149,139,1973,91,5391,7455,5634,7,0,7,14
9002,PRAKASAM,Santhanuthlapadu,RUDRAVARAM,208,1,230,439,124,0,45,169,158,6343,0,569,6912,5343,11,0,0,11
9003,PRAKASAM,Santhanuthlapadu,SANTHANUTHALAPADU,383,72,1053,1508,54,1,154,209,175,562,7,3721,4290,2982,0,0,0,0
9004,PRAKASAM,Santhanuthlapadu,VEMULAPADU,276,13,276,565,32,2,13,47,41,308,8,91,407,261,0,0,0,0
9005,PRAKASAM,Santhanuthlapadu,YENIKAPADU,294,43,267,604,150,15,146,311,287,5195,350,5930,11475,8201,3,0,2,5
9006,PRAKASAM,Singarayakonda,BINGINI PALLI,209,203,609,1021,107,83,368,558,533,5753,3628,20896,30277,19181,4,6,24,34
9007,PRAKASAM,Singarayakonda,KALIKIVAYA,407,14,686,1107,202,5,334,541,450,10509,259,18249,29017,22402,5,0,13,18
9008,PRAKASAM,Singarayakonda,KANUMALLA,264,115,386,765,95,46,233,374,340,5949,2960,19214,28123,20731,27,11,130,168
9009,PRAKASAM,Singarayakonda,MULAGUNTA PADU,353,62,281,696,200,36,83,319,298,13157,2352,5143,20652,15075,15,1,6,22
9010,PRAKASAM,Singarayakonda,PAKALA,824,44,1886,2754,484,19,514,1017,816,25860,835,24081,50776,29617,42,1,31,74
9011,PRAKASAM,Singarayakonda,SANAMPUDI,412,32,491,935,149,8,189,346,306,6006,31,12666,18703,14284,19,0,56,75
9012,PRAKASAM,Singarayakonda,SINGARAYA KONDA (OLD) U,270,132,597,999,174,39,341,554,516,9029,2062,22962,34053,25935,17,2,46,65
9013,PRAKASAM,Singarayakonda,SINGARAYAKONDA,77,145,872,1094,13,41,198,252,209,319,464,10302,11085,8186,0,0,10,10
9014,PRAKASAM,Singarayakonda,SOMARAJU PALLI,250,273,892,1415,86,135,416,637,576,4296,5546,26004,35846,24615,2,2,61,65
9015,PRAKASAM,Singarayakonda,WOOLLAPALEM,200,62,1469,1731,92,16,689,797,761,4285,678,36008,40971,28214,7,1,29,37
9016,PRAKASAM,Tangutur,ALAKURAPADU,575,21,479,1075,344,2,236,582,568,10883,31,6873,17787,13311,8,0,0,8
9017,PRAKASAM,Tangutur,ANANTHAVARAM,244,20,446,710,146,5,194,345,336,7744,271,6995,15010,11517,12,0,23,35
9018,PRAKASAM,Tangutur,JAMMULAPALEM,246,0,200,446,140,0,36,176,173,7985,0,1209,9194,7550,11,0,0,11
9019,PRAKASAM,Tangutur,JAYAVARAM,198,10,112,320,140,0,16,156,158,7799,0,456,8255,6735,16,0,1,17
9020,PRAKASAM,Tangutur,KAKUTURIVARIPALEM,206,13,91,310,151,1,51,203,201,9608,92,2188,11888,9121,25,0,5,30
9021,PRAKASAM,Tangutur,KANDULUR,370,3,311,684,63,2,82,147,135,2285,62,3282,5629,4265,3,0,6,9
9022,PRAKASAM,Tangutur,KARUMANCHI,499,68,189,756,287,5,43,335,308,13966,130,1122,15218,11336,23,0,0,23
9023,PRAKASAM,Tangutur,KONIJEDU,258,3,919,1180,137,0,486,623,548,7667,0,22071,29738,20594,14,0,8,22
9024,PRAKASAM,Tangutur,M.NIDAMALUR,518,1,328,847,357,1,160,518,518,21369,64,6460,27893,21580,46,0,9,55
9025,PRAKASAM,Tangutur,MALLAVARAPPADU,114,53,375,542,81,30,116,227,205,3432,550,2687,6669,4915,5,1,0,6
9026,PRAKASAM,Tangutur,MARLAPADU,388,5,436,829,273,0,216,489,476,16432,0,10767,27199,20839,39,0,15,54
9027,PRAKASAM,Tangutur,PONDUR,362,25,398,785,177,18,128,323,306,8611,922,3905,13438,9401,21,1,6,28
9028,PRAKASAM,Tangutur,SURAREDDY PALEM,160,0,275,435,104,0,192,296,277,4492,0,11589,16081,10199,5,0,25,30
9029,PRAKASAM,Tangutur,TANGUTUR,1236,57,571,1864,538,20,236,794,702,22524,172,8743,31439,26238,28,0,8,36
9030,PRAKASAM,Tangutur,THRPUNAIDUPALEM,168,59,87,314,66,34,46,146,118,3723,1480,2721,7924,4272,18,6,10,34
9031,PRAKASAM,Tangutur,VALLUR,184,15,352,551,103,3,129,235,217,4795,41,5909,10745,8765,2,0,7,9
9032,PRAKASAM,Tangutur,VASEPALLII PADU,116,0,179,295,80,0,157,237,235,4554,0,9960,14514,10029,7,0,18,25
9033,PRAKASAM,Tangutur,VELAGAPUDI,210,1,66,277,143,0,50,193,183,4564,0,2383,6947,5182,6,0,2,8
9034,PRAKASAM,Tarlapadu,CHENNA REDDI PALLI,245,2,655,902,153,0,384,537,514,5717,0,12457,18174,10965,2,0,1,3
9035,PRAKASAM,Tarlapadu,GANUGAPENTA,229,0,531,760,117,0,269,386,412,3770,0,6297,10067,5160,3,0,4,7
9036,PRAKASAM,Tarlapadu,GOLLA PALLI,177,38,464,679,76,23,269,368,370,4070,1911,16346,22327,11823,7,6,18,31
9037,PRAKASAM,Tarlapadu,JAGANNADHA PURAM,151,0,152,303,101,0,68,169,193,8192,0,5358,13550,7177,23,0,19,42
9038,PRAKASAM,Tarlapadu,KALUZUVVALAPADU,393,4,1231,1628,167,1,625,793,819,9721,19,33986,43726,22594,34,0,75,109
9039,PRAKASAM,Tarlapadu,KETHAGUDIPI,185,1,1002,1188,145,0,508,653,717,9459,0,30750,40209,21528,30,0,144,174
9040,PRAKASAM,Tarlapadu,MANGALA KUNTA,203,0,250,453,101,0,141,242,284,7012,0,10902,17914,9081,24,0,24,48
9041,PRAKASAM,Tarlapadu,MEERJA PETA,204,12,976,1192,92,7,437,536,579,5791,348,22339,28478,16141,13,1,35,49
9042,PRAKASAM,Tarlapadu,NAGENDLA MUDUPU,136,0,746,882,48,0,276,324,328,1942,0,14889,16831,9372,2,0,19,21
9043,PRAKASAM,Tarlapadu,POTHALAPADU,175,1,461,637,113,0,250,363,391,2493,0,7217,9710,4903,0,0,1,1
9044,PRAKASAM,Tarlapadu,RAGASAMUDRAM,158,0,178,336,81,0,115,196,198,6655,0,11144,17799,10691,28,0,61,89
9045,PRAKASAM,Tarlapadu,SEETHANAGULAVARAM,102,0,591,693,62,0,339,401,400,2023,0,19159,21182,12602,0,0,38,38
9046,PRAKASAM,Tarlapadu,SUREPALLI,50,0,194,244,28,0,119,147,150,814,0,4878,5692,3280,0,0,3,3
9047,PRAKASAM,Tarlapadu,TADIVARI PALLI,207,8,356,571,118,1,238,357,346,9332,39,12640,22011,13334,36,0,16,52
9048,PRAKASAM,Tarlapadu,TARLUPADU,277,11,1264,1552,151,4,658,813,836,7419,152,38785,46356,29099,11,0,59,70
9049,PRAKASAM,Tarlapadu,THUMMALACHERUVUU,91,0,870,961,55,0,477,532,498,3098,0,28402,31500,16318,8,0,33,41
9050,PRAKASAM,Thallur,BELLAMKONDAVARI PALEM,19,21,206,246,11,12,180,203,208,570,638,10460,11668,6728,1,0,15,16
9051,PRAKASAM,Thallur,BODDIKURA PADU,374,11,836,1221,199,7,346,552,566,6047,72,5651,11770,7785,6,0,3,9
9052,PRAKASAM,Thallur,DOSAKAYALAPADU,164,12,325,501,95,2,200,297,298,5255,27,6548,11830,7776,12,0,2,14
9053,PRAKASAM,Thallur,EAST GANGAVARAM,391,98,636,1125,193,22,82,297,273,3946,932,1922,6800,4348,1,1,0,2
9054,PRAKASAM,Thallur,KORRAPATIVARI PALEM,126,1,158,285,84,0,61,145,148,1306,0,1149,2455,1612,0,0,0,0
9055,PRAKASAM,Thallur,LAKKAVARAM,419,15,549,983,232,4,104,340,304,2475,48,1252,3775,2097,0,0,0,0
9056,PRAKASAM,Thallur,MADHAVARAM,165,6,310,481,72,3,102,177,169,1067,96,4313,5476,3100,0,0,7,7
9057,PRAKASAM,Thallur,MALKAPURAM,145,30,417,592,100,0,140,240,247,3920,0,2643,6563,3931,2,0,1,3
9058,PRAKASAM,Thallur,MANNEPALLI,160,10,224,394,99,1,84,184,192,2081,8,4398,6487,3779,0,0,10,10
9059,PRAKASAM,Thallur,NAGAM BHOTLA PALEM,351,2,864,1217,219,1,358,578,535,8084,6,8363,16453,8368,5,0,3,8
9060,PRAKASAM,Thallur,RAMABHADRAPURAM,1,2,256,259,1,0,163,164,149,19,0,5729,5748,3498,0,0,1,1
9061,PRAKASAM,Thallur,SIVARAMAPURAM,306,6,733,1045,157,2,387,546,529,6092,30,16543,22665,13055,9,0,7,16
9062,PRAKASAM,Thallur,THALLUR,471,50,739,1260,192,5,192,389,347,4337,94,6881,11312,7476,1,0,3,4
9063,PRAKASAM,Thallur,TURAKAPALEM,20,0,617,637,3,0,196,199,174,23,0,3104,3127,1963,0,0,1,1
9064,PRAKASAM,Thallur,VELUGUVARI PALEM,131,15,648,794,1,1,191,193,178,6,52,4827,4885,2502,0,0,3,3
9065,PRAKASAM,Thallur,VITTALAPURAM,193,7,419,619,36,1,97,134,115,321,41,3412,3774,2026,0,0,1,1
9066,PRAKASAM,Tripuranthakam,D.V.N.COLONY,39,58,48,145,25,37,29,91,110,2226,2666,1112,6004,3431,13,9,0,22
9067,PRAKASAM,Tripuranthakam,DUPADU,405,1,672,1078,98,0,234,332,362,2367,0,9452,11819,6985,1,0,7,8
9068,PRAKASAM,Tripuranthakam,ENDURIVARI PALEM,121,188,434,743,72,50,329,451,435,2957,1920,9040,13917,7304,2,1,3,6
9069,PRAKASAM,Tripuranthakam,G.UMMADIVARAM,221,2,561,784,66,1,202,269,277,1270,15,4985,6270,3679,0,0,2,2
9070,PRAKASAM,Tripuranthakam,GANAPAVARAM,228,0,668,896,168,0,551,719,744,4425,0,17483,21908,12199,2,0,7,9
9071,PRAKASAM,Tripuranthakam,GOLLA PALLI,217,8,523,748,151,0,338,489,562,9697,0,22832,32529,17316,15,0,45,60
9072,PRAKASAM,Tripuranthakam,K.ANNASAMUDRAM,120,5,327,452,95,3,241,339,348,3411,103,7410,10924,5800,1,0,3,4
9073,PRAKASAM,Tripuranthakam,KANKANALA PALLI,247,26,195,468,92,0,82,174,215,6222,0,1642,7864,4087,19,0,0,19
9074,PRAKASAM,Tripuranthakam,KESINENIPALLI,47,29,413,489,27,15,246,288,309,1009,238,10392,11639,6814,1,0,7,8
9075,PRAKASAM,Tripuranthakam,LELLAPALLI,227,14,547,788,172,13,480,665,817,10845,890,21734,33469,17075,23,1,13,37
9076,PRAKASAM,Tripuranthakam,MEDAPI,177,40,564,781,101,1,342,444,502,1247,10,9248,10505,5745,0,0,2,2
9077,PRAKASAM,Tripuranthakam,MIRIAM PALLI,151,0,125,276,99,0,86,185,171,2912,0,3736,6648,4011,1,0,3,4
9078,PRAKASAM,Tripuranthakam,MITTAPALEM,235,0,423,658,112,0,265,377,351,1504,0,9197,10701,5471,0,0,7,7
9079,PRAKASAM,Tripuranthakam,MUDIVEMULA,114,2,506,622,40,1,273,314,301,759,20,5175,5954,3141,0,0,4,4
9080,PRAKASAM,Tripuranthakam,NADIGADDA,200,9,623,832,101,0,484,585,601,4864,0,24260,29124,15338,7,0,52,59
9081,PRAKASAM,Tripuranthakam,ODDUPALEM,2,11,194,207,0,5,153,158,161,0,123,9221,9344,5373,0,0,28,28
9082,PRAKASAM,Tripuranthakam,PATHA ANNASAMUDRAM,129,0,601,730,86,0,133,219,223,5998,0,4496,10494,5701,20,0,6,26
9083,PRAKASAM,Tripuranthakam,RAJU PALEM,219,1,625,845,120,0,366,486,532,4803,0,12705,17508,10513,3,0,8,11
9084,PRAKASAM,Tripuranthakam,RAMASAMUDRAM,261,4,607,872,113,1,345,459,412,1535,6,4026,5567,2820,0,0,0,0
9085,PRAKASAM,Tripuranthakam,SOMEPALLI,172,8,684,864,53,3,564,620,636,806,121,21049,21976,11185,0,0,3,3
9086,PRAKASAM,Tripuranthakam,TRIPURANTHAKAM,529,108,1382,2019,289,15,908,1212,1251,10414,303,30079,40796,26913,1,0,2,3
9087,PRAKASAM,Tripuranthakam,VELLAMPALLI,269,3,553,825,15,0,2,17,8,106,0,15,121,35,0,0,0,0
9088,PRAKASAM,Tripuranthakam,VISWANADHAPURAM,153,14,524,691,98,4,170,272,319,1611,46,3037,4694,2486,0,0,1,1
9089,PRAKASAM,Ulavapadu,ATMAKUR,268,0,207,475,192,0,40,232,217,11175,0,2014,13189,8975,29,0,1,30
9090,PRAKASAM,Ulavapadu,BADDIPUDI,292,10,290,592,157,4,141,302,306,7941,292,7953,16186,11988,21,1,23,45
9091,PRAKASAM,Ulavapadu,BHEEMA VARAM,431,20,691,1142,231,3,346,580,542,12912,83,18933,31928,25057,11,0,26,37
9092,PRAKASAM,Ulavapadu,CHAGALLU,120,150,222,492,87,70,130,287,234,4817,2259,7034,14110,8766,14,4,23,41
9093,PRAKASAM,Ulavapadu,CHAKI CHERLA,369,68,562,999,154,1,300,455,428,8867,38,14571,23476,17410,16,0,19,35
9094,PRAKASAM,Ulavapadu,KAREDU,565,619,1919,3103,104,35,88,227,181,2685,839,5940,9464,5431,3,0,22,25
9095,PRAKASAM,Ulavapadu,KRISHNA PURAM,16,59,391,466,10,11,256,277,253,436,109,14432,14977,9996,1,0,44,45
9096,PRAKASAM,Ulavapadu,MANNETI KOTA,192,62,308,562,144,1,182,327,315,12576,20,9892,22488,18166,82,0,23,105
9097,PRAKASAM,Ulavapadu,PEDDA PATTAPUPALEM,5,28,1033,1066,0,0,642,642,658,0,0,37539,37539,32744,0,0,31,31
9098,PRAKASAM,Ulavapadu,RAMAYA PATNAM,109,59,367,535,79,27,258,364,366,5864,1508,16785,24157,16861,27,4,45,76
9099,PRAKASAM,Ulavapadu,ULAVAPADU,692,284,666,1642,335,23,253,611,558,16342,619,18620,35581,25417,33,0,92,125
9100,PRAKASAM,Ulavapadu,VEERE PALLI,206,293,137,636,93,17,81,191,173,5947,471,5870,12288,9217,27,2,15,44
9101,PRAKASAM,Veligandla,BALLAVARAM,120,0,229,349,59,0,143,202,205,3449,0,9833,13282,8874,11,0,28,39
9102,PRAKASAM,Veligandla,CHODAVARAM,26,1,149,176,13,1,118,132,144,493,68,6482,7043,5375,0,0,7,7
9103,PRAKASAM,Veligandla,GANNAVARAM,173,5,728,906,31,1,118,150,123,1494,36,3374,4904,2857,2,0,0,2
9104,PRAKASAM,Veligandla,GOKULAM,163,0,330,493,70,0,108,178,181,5189,0,8021,13210,7300,22,0,39,61
9105,PRAKASAM,Veligandla,GUDIPATIPALLI,279,0,495,774,152,0,269,421,444,7698,0,11824,19522,10934,16,0,13,29
9106,PRAKASAM,Veligandla,HUSSAINPURAM,178,14,866,1058,62,5,373,440,422,2681,139,23887,26707,16870,3,0,66,69
9107,PRAKASAM,Veligandla,IMMADI CHERUVU,193,0,320,513,84,0,135,219,222,5766,0,10490,16256,9584,23,0,48,71
9108,PRAKASAM,Veligandla,JALLAPALEM,115,1,205,321,69,0,149,218,220,3917,0,5399,9316,5737,7,0,2,9
9109,PRAKASAM,Veligandla,KANKANAM PADU,328,0,800,1128,100,0,482,582,612,5306,0,23828,29134,16673,16,0,30,46
9110,PRAKASAM,Veligandla,KOTALAPALLI,85,49,276,410,24,23,135,182,192,983,1353,4093,6429,3767,0,9,1,10
9111,PRAKASAM,Veligandla,MARAPAGUNTLA,237,0,277,514,61,0,168,229,185,2161,0,7555,9716,5847,2,0,14,16
9112,PRAKASAM,Veligandla,MOGALLUR,209,2,747,958,126,1,414,541,496,6332,6,16722,23060,13951,21,0,5,26
9113,PRAKASAM,Veligandla,MOTUPALLI,66,0,269,335,38,0,186,224,235,3364,0,8930,12294,7651,22,0,3,25
9114,PRAKASAM,Veligandla,NAGIREDDY PALLI,108,1,344,453,48,0,193,241,231,2613,0,8200,10813,8670,4,0,5,9
9115,PRAKASAM,Veligandla,PANDUVA,171,0,237,408,101,0,123,224,247,7318,0,6524,13842,8334,23,0,7,30
9116,PRAKASAM,Veligandla,PANDUVA NAGULA VARAM,186,0,412,598,106,0,192,298,301,5761,0,11472,17233,10006,21,0,22,43
9117,PRAKASAM,Veligandla,PULIKUNTLA RALLA PALLI,244,4,645,893,110,0,258,368,420,3822,0,8857,12679,6996,2,0,26,28
9118,PRAKASAM,Veligandla,RAMAGOPALAPURAM,80,0,368,448,42,0,222,264,258,1410,0,10968,12378,7490,1,0,8,9
9119,PRAKASAM,Veligandla,RAMALINGA PURAM,54,0,355,409,23,0,166,189,171,867,0,7666,8533,6161,0,0,6,6
9120,PRAKASAM,Veligandla,VEDULLA CHERUVU,103,0,211,314,55,0,148,203,226,2347,0,3976,6323,3526,0,0,1,1
9121,PRAKASAM,Veligandla,VELIGANDLA,153,5,402,560,76,1,193,270,264,4455,6,10362,14823,9665,9,0,13,22
9122,PRAKASAM,Vetapalem,AKKAYA PALEM,83,73,1090,1246,3,2,314,319,263,36,24,5727,5787,3447,0,0,3,3
9123,PRAKASAM,Vetapalem,BATCHULAVARI PALEM,32,55,879,966,10,16,376,402,359,99,318,13177,13594,6486,0,0,2,2
9124,PRAKASAM,Vetapalem,CHALLAREDDY PALEM,97,60,1573,1730,27,1,847,875,816,281,6,13164,13451,6633,0,0,17,17
9125,PRAKASAM,Vetapalem,DESAIPETA,977,168,1013,2158,102,7,65,174,157,1022,141,1636,2799,2016,0,0,0,0
9126,PRAKASAM,Vetapalem,KOTHAPETA,0,0,0,0,0,0,0,0,0,0,0,0,0,0,0,0,0,0
9127,PRAKASAM,Vetapalem,PANDILLA PALLI,190,38,660,888,70,3,88,161,121,1948,57,2301,4306,2374,0,0,0,0
9128,PRAKASAM,Vetapalem,PAPAYA PALEM,102,0,735,837,75,0,450,525,441,2012,0,6169,8181,4899,0,0,0,0
9129,PRAKASAM,Vetapalem,PULLARI PALEM,0,22,0,22,0,0,0,0,0,0,0,0,0,0,0,0,0,0
9130,PRAKASAM,Vetapalem,RAMANNA PETA,22,223,482,727,1,21,21,43,38,20,179,336,535,287,0,0,0,0
9131,PRAKASAM,Vetapalem,VETAPALEM,286,62,633,981,102,11,104,217,201,3048,246,2407,5701,4585,5,0,0,5
9132,PRAKASAM,Voletivaripalem,AMMAPALEM,76,11,337,424,18,6,137,161,162,661,228,7460,8349,6034,1,0,20,21
9133,PRAKASAM,Voletivaripalem,ANKABHUPALAPURAM,74,17,406,497,46,5,265,316,325,2012,23,15019,17054,11509,4,0,14,18
9134,PRAKASAM,Voletivaripalem,AYYAVARI PALLI,80,33,415,528,49,1,188,238,257,2495,8,9978,12481,10352,5,0,20,25
9135,PRAKASAM,Voletivaripalem,BADEVARIPALEM,233,3,404,640,138,0,208,346,349,10533,0,5866,16399,13210,48,0,0,48
9136,PRAKASAM,Voletivaripalem,CHUNDI,107,21,809,937,50,9,496,555,564,2432,672,28071,31175,22470,1,3,55,59
9137,PRAKASAM,Voletivaripalem,KAKUTUR,267,1,293,561,157,0,239,396,411,7827,0,20657,28484,20007,16,0,105,121
9138,PRAKASAM,Voletivaripalem,KALAVALLA,281,2,408,691,195,0,261,456,449,13610,0,16525,30135,21537,57,0,38,95
9139,PRAKASAM,Voletivaripalem,KONDA SAMUDRAM,87,0,268,355,1,0,37,38,31,6,0,481,487,190,0,0,0,0
9140,PRAKASAM,Voletivaripalem,KONDAREDDI PALEM,74,1,31,106,43,1,19,63,50,2360,65,1187,3612,2165,1,0,2,3
9141,PRAKASAM,Voletivaripalem,LINGAPALEM,239,0,190,429,128,0,111,239,255,3079,0,3548,6627,4831,1,0,3,4
9142,PRAKASAM,Voletivaripalem,NALADALAPUR,208,0,317,525,122,0,208,330,305,6683,0,8120,14803,8601,19,0,7,26
9143,PRAKASAM,Voletivaripalem,NEKUNAM PURAM,110,20,349,479,80,0,168,248,202,4807,0,7880,12687,8450,6,0,6,12
9144,PRAKASAM,Voletivaripalem,NUKAVARAM,112,0,96,208,58,0,72,130,124,3851,0,4168,8019,5775,13,0,2,15
9145,PRAKASAM,Voletivaripalem,POKURU,825,5,670,1500,405,4,308,717,690,19202,349,19399,38950,31051,40,1,22,63
9146,PRAKASAM,Voletivaripalem,POLINENI CHERUVU,242,41,369,652,125,18,258,401,408,5167,354,14882,20403,11493,12,0,41,53
9147,PRAKASAM,Voletivaripalem,POLINENIPALEM,348,6,724,1078,231,4,440,675,633,12071,130,25648,37849,25686,14,0,40,54
9148,PRAKASAM,Voletivaripalem,SAKHAVARAM,511,2,448,961,25,0,186,211,207,203,0,1572,1775,1496,0,0,0,0
9149,PRAKASAM,Voletivaripalem,SAMEERA PALEM,224,48,306,578,135,18,198,351,340,7461,123,11164,18748,12850,17,0,8,25
9150,PRAKASAM,Voletivaripalem,SINGAMAENI PALLE,300,16,418,734,125,7,202,334,297,3990,400,12100,16490,11738,0,2,23,25
9151,PRAKASAM,Voletivaripalem,VOLETIVARI PALEM,227,47,663,937,66,2,297,365,344,1938,43,9981,11962,8679,0,0,1,1
9152,PRAKASAM,Voletivaripalem,Z.Uppalapadu,90,1,260,351,0,0,0,0,0,0,0,0,0,0,0,0,0,0
9153,PRAKASAM,Yeddanapudi,ANANTHA VARAM,159,11,480,650,111,4,71,186,183,4860,154,2945,7959,4760,4,0,7,11
9154,PRAKASAM,Yeddanapudi,CHIMATAVARI PALEM,2,8,209,219,0,5,75,80,79,0,297,3802,4099,1953,0,1,10,11
9155,PRAKASAM,Yeddanapudi,GANNAVARAM,323,6,313,642,227,1,38,266,204,11183,8,1585,12776,5746,13,0,0,13
9156,PRAKASAM,Yeddanapudi,JAGARLAMUDI,318,0,449,767,228,0,279,507,514,10490,0,11147,21637,11604,17,0,10,27
9157,PRAKASAM,Yeddanapudi,MUNNANGIVARI PALEM,4,0,150,154,1,0,64,65,60,19,0,2390,2409,1217,0,0,0,0
9158,PRAKASAM,Yeddanapudi,PEDDIVARI PALEM,1,0,116,117,0,0,65,65,55,0,0,3702,3702,2085,0,0,6,6
9159,PRAKASAM,Yeddanapudi,POLURU,183,2,447,632,100,0,120,220,193,3270,0,1922,5192,2412,6,0,2,8
9160,PRAKASAM,Yeddanapudi,PUNURU,534,18,536,1088,254,4,178,436,349,12978,181,9885,23044,10016,51,0,29,80
9161,PRAKASAM,Yeddanapudi,SURAVARAPU PALLI,65,8,194,267,28,1,66,95,103,183,5,790,978,678,0,0,0,0
9162,PRAKASAM,Yeddanapudi,SYAMAKLAVARI PALEM,1,6,114,121,0,0,27,27,21,0,0,191,191,93,0,0,0,0
9163,PRAKASAM,Yeddanapudi,TANUBODDIVARI PALEM,116,39,88,243,4,0,2,6,6,23,0,16,39,35,0,0,0,0
9164,PRAKASAM,Yeddanapudi,VINJANAM PADU,184,3,71,258,52,0,9,61,50,1405,0,110,1515,637,0,0,0,0
9165,PRAKASAM,Yeddanapudi,YANAMADALA,451,84,477,1012,222,32,78,332,334,7053,526,1607,9186,5966,2,0,0,2
9166,PRAKASAM,Yeddanapudi,YEDDANAPUDI,261,19,453,733,113,5,251,369,375,2537,74,11676,14287,9165,1,0,11,12
9167,PRAKASAM,Yerragondapalem,AMMANIGUDIPADU,582,2,1343,1927,187,1,469,657,531,2417,45,12330,14792,7637,0,0,2,2
9168,PRAKASAM,Yerragondapalem,BOYALA PALLI,382,25,1140,1547,186,2,493,681,726,5498,48,22965,28511,15294,1,0,29,30
9169,PRAKASAM,Yerragondapalem,GANGAPALEM,195,37,703,935,157,15,507,679,690,8157,262,24762,33181,17300,3,0,6,9
9170,PRAKASAM,Yerragondapalem,GANJIVARI PALLI,245,762,643,1650,145,133,400,678,670,8425,25935,20968,55328,28414,16,88,12,116
9171,PRAKASAM,Yerragondapalem,GOLLAVIDIPI,215,2,398,615,123,0,306,429,445,3922,0,16826,20748,11560,0,0,20,20
9172,PRAKASAM,Yerragondapalem,GURIJE PALLI,411,10,865,1286,112,1,359,472,390,2071,57,6399,8527,3801,0,0,0,0
9173,PRAKASAM,Yerragondapalem,GURRAPUSALA,296,23,525,844,207,17,399,623,679,8005,1178,19615,28798,14509,4,1,28,33
9174,PRAKASAM,Yerragondapalem,KOLUKULA,383,7,1247,1637,99,2,662,763,678,5772,155,37723,43650,22129,20,0,95,115
9175,PRAKASAM,Yerragondapalem,MELLAMPALLI,404,678,638,1720,134,258,295,687,721,7521,12260,12515,32296,17396,15,17,17,49
9176,PRAKASAM,Yerragondapalem,MOGULLAPALLI,209,36,323,568,158,0,241,399,423,11214,0,17321,28535,15401,46,0,90,136
9177,PRAKASAM,Yerragondapalem,NARASAYA PALEM,196,4,388,588,36,1,130,167,117,495,2,2087,2584,1208,0,0,0,0
9178,PRAKASAM,Yerragondapalem,TAMADAPALLI,168,30,524,722,116,14,280,410,434,7218,615,9285,17118,8682,24,0,2,26
9179,PRAKASAM,Yerragondapalem,VADAMPALLI,242,12,403,657,109,0,33,142,125,1709,0,699,2408,1248,0,0,0,0
9180,PRAKASAM,Yerragondapalem,VEERABHADRA PURAM,422,341,1037,1800,328,68,600,996,1068,15492,7631,29554,52677,28024,12,23,39,74
9181,PRAKASAM,Yerragondapalem,VENKATADRI PALEM,265,1852,510,2627,160,551,324,1035,946,15290,33345,29647,78282,40235,76,104,142,322
9182,PRAKASAM,Yerragondapalem,YERRAGONDAPALEM,550,518,2217,3285,193,152,964,1309,1307,8233,14845,33539,56617,31063,16,57,33,106
9183,PRAKASAM,Zarugumilli,AKKACHERUVU PALEM,0,2,117,119,0,0,70,70,67,0,0,2742,2742,1563,0,0,1,1
9184,PRAKASAM,Zarugumilli,CHATUKU PADU,304,22,137,463,193,11,56,260,242,14215,683,4195,19093,13217,28,1,9,38
9185,PRAKASAM,Zarugumilli,CHINTHALAPALEM,421,51,339,811,193,17,140,350,351,8980,672,6884,16536,11283,7,0,4,11
9186,PRAKASAM,Zarugumilli,CHIRRIKURA PADU,223,10,222,455,154,3,116,273,262,12098,267,8107,20472,13530,53,2,20,75
9187,PRAKASAM,Zarugumilli,DAVAGUDUR,148,28,294,470,95,24,208,327,306,6809,1914,15743,24466,16453,7,2,16,25
9188,PRAKASAM,Zarugumilli,K.BITRAGUNTA,241,141,364,746,96,60,110,266,252,1590,2216,1849,5655,4515,0,3,0,3
9189,PRAKASAM,Zarugumilli,KAME PALLI,187,16,697,900,111,1,346,458,401,6453,20,19282,25755,17865,18,0,40,58
9190,PRAKASAM,Zarugumilli,N.N.KANDRIKA,102,2,320,424,48,2,172,222,194,1994,138,5840,7972,4880,1,0,3,4
9191,PRAKASAM,Zarugumilli,NANDANAVANAM,217,4,255,476,90,0,149,239,226,2629,0,4643,7272,5321,2,0,0,2
9192,PRAKASAM,Zarugumilli,NARASINGOLU,176,1,493,670,84,0,184,268,243,5776,0,12810,18586,11524,15,0,32,47
9193,PRAKASAM,Zarugumilli,PAIDI PADU,143,3,177,323,88,0,83,171,155,3132,0,2500,5632,3436,1,0,0,1
9194,PRAKASAM,Zarugumilli,PALETI PADU,346,4,397,747,213,3,199,415,386,10913,83,10797,21793,15061,16,0,30,46
9195,PRAKASAM,Zarugumilli,PATCHAVA,276,17,328,621,170,7,196,373,346,6197,138,6916,13251,8538,2,0,0,2
9196,PRAKASAM,Zarugumilli,RAMACHANDRA PURAM,88,0,173,261,68,0,137,205,196,3674,0,9530,13204,8802,7,0,24,31
9197,PRAKASAM,Zarugumilli,REDDY PALEM,8,0,261,269,5,0,99,104,88,167,0,3861,4028,2207,0,0,5,5
9198,PRAKASAM,Zarugumilli,THUMADU,218,14,163,395,149,12,96,257,227,8771,508,6491,15770,10310,16,0,12,28
9199,PRAKASAM,Zarugumilli,VARDHINENIVARI PALEM,151,11,360,522,80,5,130,215,199,2487,22,3101,5610,3747,0,0,0,0
9200,PRAKASAM,Zarugumilli,VAVILETI PADU,234,38,180,452,76,11,28,115,113,997,205,606,1808,1110,0,0,0,0
9201,PRAKASAM,Zarugumilli,YEDLURU PADU,253,86,439,778,146,59,276,481,447,6448,2760,13148,22356,15474,0,1,2,3
9202,PRAKASAM,Zarugumilli,ZARUGUMALLI,452,9,350,811,284,1,151,436,414,16994,51,7694,24739,18383,32,0,13,45
9203,SRIKAKULAM,Amadalavalasa,AKKULAPETA,56,0,124,180,38,0,81,119,103,2424,0,6699,9123,5838,5,0,35,40
9204,SRIKAKULAM,Amadalavalasa,BELAMAM,45,1,393,439,30,0,260,290,232,582,0,7500,8082,4577,0,0,0,0
9205,SRIKAKULAM,Amadalavalasa,BOBBILIPETA,6,0,354,360,1,0,261,262,213,113,0,21611,21724,12985,1,0,89,90
9206,SRIKAKULAM,Amadalavalasa,CHEEMALAVALASA,71,1,404,476,46,0,286,332,276,3130,0,10081,13211,9120,10,0,3,13
9207,SRIKAKULAM,Amadalavalasa,CHINTALAPETA,53,0,313,366,41,0,196,237,217,3804,0,16885,20689,12454,19,0,76,95
9208,SRIKAKULAM,Amadalavalasa,CHITTIVALASA,4,0,146,150,4,0,116,120,110,347,0,10952,11299,8448,2,0,72,74
9209,SRIKAKULAM,Amadalavalasa,DUSI,32,0,464,496,7,0,175,182,156,149,0,2766,2915,1642,0,0,0,0
9210,SRIKAKULAM,Amadalavalasa,GAJULAKOLLIVALASA,42,0,271,313,15,0,117,132,125,953,0,6828,7781,6838,2,0,15,17
9211,SRIKAKULAM,Amadalavalasa,GARIMELLA KOTHAVALASA,14,0,284,298,9,0,183,192,113,302,0,3841,4143,1661,0,0,0,0
9212,SRIKAKULAM,Amadalavalasa,K.MUNAGAVALASA,80,0,334,414,60,0,243,303,273,5077,0,15638,20715,14353,34,0,27,61
9213,SRIKAKULAM,Amadalavalasa,KALIVARAM,63,0,464,527,44,0,292,336,283,1906,0,12500,14406,8983,5,0,16,21
9214,SRIKAKULAM,Amadalavalasa,KANUGULAVALASA,3,0,541,544,2,0,213,215,169,171,0,14542,14713,10133,1,0,59,60
9215,SRIKAKULAM,Amadalavalasa,KATYACHARYULAPETA,24,3,298,325,18,3,183,204,202,1329,142,13812,15283,11958,6,0,46,52
9216,SRIKAKULAM,Amadalavalasa,KORAPAM,14,0,279,293,7,0,199,206,164,86,0,3701,3787,1952,0,0,0,0
9217,SRIKAKULAM,Amadalavalasa,KORLAKOTA,85,1,692,778,60,1,472,533,454,2474,31,14892,17397,12012,1,0,0,1
9218,SRIKAKULAM,Amadalavalasa,KOTHAVALASA,8,0,283,291,7,0,181,188,157,219,0,3823,4042,2226,0,0,0,0
9219,SRIKAKULAM,Amadalavalasa,NELLIPARTHI,43,0,638,681,16,0,328,344,301,903,0,17942,18845,11227,1,0,70,71
9220,SRIKAKULAM,Amadalavalasa,NIMMATHORLAWADA,56,0,553,609,46,0,359,405,345,1637,0,10191,11828,6386,1,0,0,1
9221,SRIKAKULAM,Amadalavalasa,RAMACHANDRA PURAM,34,1,562,597,23,1,389,413,427,1079,28,14504,15611,10889,1,0,10,11
9222,SRIKAKULAM,Amadalavalasa,SRINIVASACHARYULAPETA,35,0,435,470,28,0,270,298,266,1846,0,20570,22416,16834,5,0,67,72
9223,SRIKAKULAM,Amadalavalasa,SYLADA,20,1,244,265,15,1,166,182,166,1358,103,15852,17313,10894,10,1,99,110
9224,SRIKAKULAM,Amadalavalasa,T.JONNAVALASA,38,3,371,412,27,2,209,238,214,1415,42,9534,10991,7726,2,0,12,14
9225,SRIKAKULAM,Amadalavalasa,THOGARAGAM,60,0,359,419,40,0,204,244,207,3479,0,13566,17045,11536,12,0,35,47
9226,SRIKAKULAM,Amadalavalasa,THOTADA,23,2,566,591,11,0,308,319,288,258,0,17381,17639,10035,0,0,44,44
9227,SRIKAKULAM,Amadalavalasa,THURAKA PETA,15,0,206,221,13,0,158,171,151,1294,0,10718,12012,7816,9,0,28,37
9228,SRIKAKULAM,Amadalavalasa,VANJANGI,18,0,615,633,14,0,458,472,449,965,0,32392,33357,24662,4,0,72,76
9229,SRIKAKULAM,Amadalavalasa,VANJANGIPETA,1,0,206,207,0,0,162,162,137,0,0,16465,16465,9910,0,0,118,118
9230,SRIKAKULAM,Amadalavalasa,VEDULLAVALASA,51,0,129,180,39,0,81,120,85,2679,0,4400,7079,4458,5,0,5,10
9231,SRIKAKULAM,Bhamini,BALERU,429,279,746,1454,255,234,367,856,910,9509,14386,5269,29164,15907,0,43,0,43
9232,SRIKAKULAM,Bhamini,BATTILI,561,58,552,1171,273,32,224,529,540,13117,1089,9559,23765,14854,10,1,6,17
9233,SRIKAKULAM,Bhamini,BELLUMADA,71,28,279,378,51,16,121,188,171,1846,484,3322,5652,3802,2,0,1,3
9234,SRIKAKULAM,Bhamini,BHAMANI,184,444,180,808,166,347,124,637,770,11274,19521,5830,36625,19492,33,48,12,93
9235,SRIKAKULAM,Bhamini,BURUJOLA,129,87,122,338,88,71,82,241,237,3810,4191,3011,11012,6815,4,4,1,9
9236,SRIKAKULAM,Bhamini,CHINNADIMILI,128,12,269,409,80,7,153,240,195,5518,532,9066,15116,8220,23,1,24,48
9237,SRIKAKULAM,Bhamini,DIMMIDIJOLA,112,113,230,455,96,99,124,319,347,7173,6335,6221,19729,11887,33,21,10,64
9238,SRIKAKULAM,Bhamini,GHANASARA,88,76,540,704,70,68,342,480,503,4053,5319,14146,23518,13351,1,18,4,23
9239,SRIKAKULAM,Bhamini,KAIRAGADDA (B),9,1,319,329,5,0,238,243,236,368,0,17576,17944,10142,2,0,74,76
9240,SRIKAKULAM,Bhamini,KEESARA,31,4,271,306,18,3,168,189,183,466,99,4701,5266,3083,0,0,1,1
9241,SRIKAKULAM,Bhamini,KORAMA,81,6,227,314,52,4,148,204,202,2947,62,5251,8260,5854,4,0,2,6
9242,SRIKAKULAM,Bhamini,KOSALI,184,2,252,438,150,1,158,309,296,11304,7,9385,20696,11747,52,0,29,81
9243,SRIKAKULAM,Bhamini,LIVIRI,363,79,322,764,108,64,113,285,309,4964,5247,5385,15596,8350,13,24,12,49
9244,SRIKAKULAM,Bhamini,MANIGA,17,313,1,331,15,210,1,226,253,1317,19952,22,21291,11097,7,118,0,125
9245,SRIKAKULAM,Bhamini,MANUMAKONDA,11,501,16,528,4,373,10,387,377,149,25848,360,26357,13549,0,94,0,94
9246,SRIKAKULAM,Bhamini,NERADI-B,223,118,491,832,145,73,229,447,424,8195,2420,7585,18200,11502,17,0,9,26
9247,SRIKAKULAM,Bhamini,NULAKAJODU,132,28,330,490,94,18,182,294,279,5387,501,7516,13404,8280,14,0,11,25
9248,SRIKAKULAM,Bhamini,PASUKUDI,19,58,167,244,3,28,72,103,106,98,1150,1782,3030,2176,0,2,1,3
9249,SRIKAKULAM,Bhamini,PEDDADIMILI,166,69,287,522,117,48,203,368,374,8602,3984,14722,27308,17229,39,22,64,125
9250,SRIKAKULAM,Bhamini,SATHIVADA,29,249,206,484,7,209,170,386,368,231,15811,10641,26683,14362,0,58,38,96
9251,SRIKAKULAM,Bhamini,THALADA,108,91,229,428,85,75,154,314,318,3932,6716,6480,17128,9917,3,40,11,54
9252,SRIKAKULAM,Bhamini,VADDANGI,51,246,173,470,34,169,122,325,351,3146,14775,11883,29804,16405,17,83,68,168
9253,SRIKAKULAM,Burja,A.P.PETA,103,49,329,481,72,19,235,326,319,7184,1765,17094,26043,15168,49,13,60,122
9254,SRIKAKULAM,Burja,ALLENA,56,0,479,535,42,0,392,434,413,2608,0,4478,7086,3782,5,0,0,5
9255,SRIKAKULAM,Burja,ANNAMPETA,115,200,248,563,91,162,195,448,436,7158,14237,16420,37815,20698,36,75,88,199
9256,SRIKAKULAM,Burja,BURJA,145,1,541,687,76,0,379,455,413,3374,0,23980,27354,14791,3,0,95,98
9257,SRIKAKULAM,Burja,CHEEDIVALASA,60,0,427,487,48,0,303,351,324,3526,0,22423,25949,16181,13,0,72,85
9258,SRIKAKULAM,Burja,CHINNALANKAM,36,0,243,279,24,0,139,163,132,683,0,1730,2413,1264,0,0,0,0
9259,SRIKAKULAM,Burja,DONKALAPARTHA,97,38,277,412,74,37,228,339,344,4891,2813,15411,23115,14838,15,10,37,62
9260,SRIKAKULAM,Burja,GUTTAVALLI,31,0,427,458,24,0,351,375,305,955,0,10864,11819,6257,0,0,3,3
9261,SRIKAKULAM,Burja,KALAPARTHI,50,4,355,409,41,4,284,329,290,3100,292,22768,26160,15199,9,1,92,102
9262,SRIKAKULAM,Burja,KANTLAM,74,0,275,349,65,0,228,293,279,5395,0,17466,22861,14529,24,0,63,87
9263,SRIKAKULAM,Burja,KOLLIVALASA,65,2,194,261,50,1,151,202,210,4773,54,14831,19658,11893,28,0,90,118
9264,SRIKAKULAM,Burja,KORAGAM,112,0,455,567,83,0,318,401,397,9059,0,32072,41131,22179,56,0,203,259
9265,SRIKAKULAM,Burja,LABHAM,62,0,201,263,26,0,87,113,90,1050,0,2069,3119,1747,2,0,1,3
9266,SRIKAKULAM,Burja,LAKKUPURAM,49,2,465,516,45,1,377,423,391,3545,21,14424,17990,9545,15,0,1,16
9267,SRIKAKULAM,Burja,LANKAM,9,0,187,196,6,0,144,150,142,434,0,7462,7896,4534,1,0,13,14
9268,SRIKAKULAM,Burja,MAMIDIVALASA,45,0,359,404,31,0,272,303,258,547,0,4142,4689,2221,0,0,0,0
9269,SRIKAKULAM,Burja,NEELADEVIPURAM,52,1,372,425,45,0,282,327,327,4161,0,27285,31446,18281,20,0,148,168
9270,SRIKAKULAM,Burja,O.V.PETA,64,0,395,459,52,0,299,351,324,4295,0,22331,26626,15715,19,0,91,110
9271,SRIKAKULAM,Burja,P.L.DEVIPETA,44,17,164,225,33,3,109,145,140,1854,73,6486,8413,5232,0,0,4,4
9272,SRIKAKULAM,Burja,PALAVALASA,49,17,455,521,38,16,378,432,419,2662,1432,27912,32006,18589,10,7,108,125
9273,SRIKAKULAM,Burja,PEDDAPETA,20,96,485,601,11,58,262,331,321,190,839,4794,5823,3178,0,0,0,0
9274,SRIKAKULAM,Burja,SINGANNAPALEM,24,2,235,261,19,0,171,190,172,1119,0,10099,11218,7255,2,0,19,21
9275,SRIKAKULAM,Burja,T.D.R.RAJUPETA,91,1,345,437,52,1,222,275,270,4164,58,13945,18167,12219,18,0,38,56
9276,SRIKAKULAM,Burja,THOTAVADA,145,1,691,837,92,1,468,561,530,8269,18,19161,27448,15420,39,0,36,75
9277,SRIKAKULAM,Burja,UPPINIVALASA,165,2,423,590,141,2,306,449,435,11175,136,23064,34375,22006,54,1,108,163
9278,SRIKAKULAM,Burja,VAVAM,57,0,244,301,33,0,162,195,173,2777,0,10553,13330,7087,13,0,30,43
9279,SRIKAKULAM,Burja,VYKUNTAPURAM,3,0,254,257,3,0,199,202,172,297,0,19128,19425,10793,2,0,137,139
9280,SRIKAKULAM,Etcherla,AJJARAM,19,1,492,512,4,1,176,181,187,43,10,3206,3259,2326,0,0,0,0
9281,SRIKAKULAM,Etcherla,ALLINAGARAM,36,6,399,441,28,3,282,313,299,2285,108,22025,24418,19505,14,1,55,70
9282,SRIKAKULAM,Etcherla,ARINAM AKKIVALASA,105,0,307,412,82,0,237,319,312,7818,0,18883,26701,17761,40,0,53,93
9283,SRIKAKULAM,Etcherla,BADEVONIPETA,2,0,670,672,0,0,505,505,488,0,0,16656,16656,11346,0,0,24,24
9284,SRIKAKULAM,Etcherla,BHAGIRADHIPURAM,0,0,552,552,0,0,377,377,336,0,0,33629,33629,22746,0,0,145,145
9285,SRIKAKULAM,Etcherla,BONTALAKODURU,48,0,529,577,40,0,403,443,423,2909,0,28102,31011,20851,9,0,71,80
9286,SRIKAKULAM,Etcherla,BUDAGATLAPALEM,0,0,283,283,0,0,0,0,0,0,0,0,0,0,0,0,0,0
9287,SRIKAKULAM,Etcherla,CHILAKAPALEM,69,1,666,736,55,1,471,527,509,3454,92,17624,21170,18026,3,0,5,8
9288,SRIKAKULAM,Etcherla,D.MATCHILESAM,3,0,1067,1070,0,0,773,773,745,0,0,13714,13714,10809,0,0,0,0
9289,SRIKAKULAM,Etcherla,DHARMAVARAM,120,16,1195,1331,80,5,896,981,937,7162,391,60625,68178,36796,39,0,87,126
9290,SRIKAKULAM,Etcherla,DOMAM,0,0,494,494,0,0,363,363,350,0,0,26100,26100,21350,0,0,55,55
9291,SRIKAKULAM,Etcherla,ETCHERLA,148,2,586,736,59,0,381,440,357,2579,0,19921,22500,16470,0,0,18,18
9292,SRIKAKULAM,Etcherla,FAREEDPETA,68,1,873,942,38,1,76,115,102,294,6,1519,1819,1007,0,0,0,0
9293,SRIKAKULAM,Etcherla,IBRAHIMBAD,8,0,486,494,5,0,311,316,289,182,0,12685,12867,10270,0,0,0,0
9294,SRIKAKULAM,Etcherla,JARAJAM,66,0,571,637,53,0,467,520,524,4544,0,34901,39445,29195,21,0,93,114
9295,SRIKAKULAM,Etcherla,KESAVARAOPETA,65,2,739,806,49,0,484,533,503,2838,0,28315,31153,24365,2,0,22,24
9296,SRIKAKULAM,Etcherla,KONGARAM,12,17,899,928,9,13,654,676,650,750,816,43657,45223,35509,5,1,39,45
9297,SRIKAKULAM,Etcherla,KOTTAPETA,82,1,673,756,56,0,483,539,518,4183,0,36332,40515,22409,17,0,128,145
9298,SRIKAKULAM,Etcherla,KOYYAM,51,2,905,958,34,0,593,627,637,3081,0,41500,44581,35412,16,0,120,136
9299,SRIKAKULAM,Etcherla,KUPPILI,71,3,983,1057,58,3,496,557,581,5836,256,35481,41573,25977,38,2,128,168
9300,SRIKAKULAM,Etcherla,KUSULAPURAM,53,2,873,928,29,2,564,595,519,2427,50,5203,7680,4329,9,0,0,9
9301,SRIKAKULAM,Etcherla,MUDDADA,135,9,1186,1330,115,7,896,1018,986,8227,161,38935,47323,30484,6,0,0,6
9302,SRIKAKULAM,Etcherla,PONNADA,87,1,1441,1529,60,1,1200,1261,1257,4418,42,76701,81161,62327,16,0,119,135
9303,SRIKAKULAM,Etcherla,PUDIVALASA,42,0,426,468,30,0,225,255,243,1550,0,9729,11279,9166,1,0,2,3
9304,SRIKAKULAM,Etcherla,S.M.PURAM,136,1,648,785,108,1,462,571,539,6788,57,24192,31037,20715,11,0,24,35
9305,SRIKAKULAM,Etcherla,S.S.R.PURAM,78,0,757,835,71,0,595,666,654,4582,0,31010,35592,21773,1,0,14,15
9306,SRIKAKULAM,Etcherla,THAMMUNAIDUPETA,83,0,429,512,47,0,276,323,294,805,0,5782,6587,5095,0,0,0,0
9307,SRIKAKULAM,Etcherla,THOTAPALEM,293,3,739,1035,210,3,498,711,669,4545,82,16403,21030,13224,0,0,4,4
9308,SRIKAKULAM,Ganguvari Singadam,ANANDAPURAM,39,0,729,768,33,0,550,583,599,2234,0,26734,28968,17059,4,0,19,23
9309,SRIKAKULAM,Ganguvari Singadam,BATHUVA,54,0,880,934,35,0,703,738,774,2804,0,35885,38689,22665,13,0,27,40
9310,SRIKAKULAM,Ganguvari Singadam,CHETTUPODILAM,106,0,199,305,80,0,140,220,183,5305,0,8897,14202,8861,16,0,16,32
9311,SRIKAKULAM,Ganguvari Singadam,DALEMRAJUVALASA,51,5,531,587,41,4,424,469,472,4198,295,35043,39536,23515,35,0,211,246
9312,SRIKAKULAM,Ganguvari Singadam,DEVARAVALASA,6,0,453,459,2,0,113,115,118,24,0,6010,6034,3301,0,0,15,15
9313,SRIKAKULAM,Ganguvari Singadam,DHAVALAPETA,36,0,255,291,29,0,194,223,175,894,0,10101,10995,5793,0,0,18,18
9314,SRIKAKULAM,Ganguvari Singadam,G. SIGADAM,96,1,928,1025,65,1,573,639,636,2803,4,30183,32990,19919,0,0,36,36
9315,SRIKAKULAM,Ganguvari Singadam,GEDDAKANCHARAM,92,35,532,659,87,33,456,576,569,8320,3405,33162,44887,29078,48,18,109,175
9316,SRIKAKULAM,Ganguvari Singadam,GOBBURU,34,0,133,167,27,0,108,135,118,2345,0,7781,10126,6491,15,0,23,38
9317,SRIKAKULAM,Ganguvari Singadam,JADA,115,0,426,541,81,0,226,307,294,3793,0,4888,8681,5522,1,0,0,1
9318,SRIKAKULAM,Ganguvari Singadam,JAGANNADHAVALASA,58,1,347,406,40,1,259,300,274,3053,76,19606,22735,13859,10,0,76,86
9319,SRIKAKULAM,Ganguvari Singadam,KAPPARAM,0,0,92,92,0,0,69,69,70,0,0,4736,4736,2673,0,0,22,22
9320,SRIKAKULAM,Ganguvari Singadam,MADHUPAM,39,0,272,311,31,0,196,227,190,2018,0,13721,15739,9709,5,0,50,55
9321,SRIKAKULAM,Ganguvari Singadam,MARRIVALASA,62,10,151,223,52,10,126,188,156,4912,832,10937,16681,8222,27,3,55,85
9322,SRIKAKULAM,Ganguvari Singadam,METTAVALASA,39,0,508,547,35,0,390,425,380,1923,0,17049,18972,10561,2,0,11,13
9323,SRIKAKULAM,Ganguvari Singadam,MUSHINIVALASA,80,4,286,370,57,1,179,237,248,4905,121,15397,20423,14810,29,1,85,115
9324,SRIKAKULAM,Ganguvari Singadam,NADIMIVALASA,61,2,333,396,49,1,275,325,336,3462,46,19697,23205,15161,6,0,58,64
9325,SRIKAKULAM,Ganguvari Singadam,NAGULAVALASA,48,0,111,159,41,0,64,105,94,3089,0,4483,7572,4415,12,0,10,22
9326,SRIKAKULAM,Ganguvari Singadam,NIDDAM,122,3,594,719,92,2,462,556,510,6838,84,26645,33567,18692,13,0,20,33
9327,SRIKAKULAM,Ganguvari Singadam,PALAKHANDYAM,34,0,451,485,20,0,343,363,361,1347,0,22209,23556,13837,4,0,73,77
9328,SRIKAKULAM,Ganguvari Singadam,PENTA,63,0,435,498,50,0,365,415,415,3513,0,21096,24609,14768,14,0,35,49
9329,SRIKAKULAM,Ganguvari Singadam,PUNNAM,77,1,312,390,62,1,269,332,331,5221,69,22964,28254,15957,23,0,126,149
9330,SRIKAKULAM,Ganguvari Singadam,S.P.R.PURAM,3,0,218,221,1,0,176,177,180,90,0,14501,14591,9796,0,0,54,54
9331,SRIKAKULAM,Ganguvari Singadam,SANTHAVURITY,181,1,295,477,133,1,196,330,258,10065,34,8924,19023,10248,40,0,0,40
9332,SRIKAKULAM,Ganguvari Singadam,SEETHAMPETA,116,0,576,692,109,0,479,588,568,9804,0,33663,43467,24010,55,0,117,172
9333,SRIKAKULAM,Ganguvari Singadam,SETHUBHEMAVARAM,51,21,466,538,42,7,360,409,418,3298,449,25911,29658,17174,16,2,82,100
9334,SRIKAKULAM,Ganguvari Singadam,T.D.VALASA,97,0,139,236,86,0,98,184,162,6634,0,7087,13721,8772,29,0,29,58
9335,SRIKAKULAM,Ganguvari Singadam,VANDRANGI,80,1,447,528,57,1,327,385,398,2904,27,20491,23422,13691,5,0,81,86
9336,SRIKAKULAM,Ganguvari Singadam,VELAGADA,84,11,341,436,69,11,294,374,386,5141,835,26158,32134,18511,24,4,142,170
9337,SRIKAKULAM,Ganguvari Singadam,VENKAYYAPETA,53,2,132,187,43,2,102,147,124,3572,21,8972,12565,6924,18,0,54,72
9338,SRIKAKULAM,Ganguvari Singadam,YENDUVA,25,0,356,381,19,0,271,290,253,1475,0,21459,22934,11930,5,0,81,86
9339,SRIKAKULAM,Gara,AMBALLAVALASA,24,0,217,241,18,0,172,190,174,1013,0,11965,12978,8647,3,0,41,44
9340,SRIKAKULAM,Gara,AMPOLU,97,2,1958,2057,73,1,1328,1402,1320,4964,32,54846,59842,44635,16,0,45,61
9341,SRIKAKULAM,Gara,BALARAMPURAM,22,1,279,302,19,1,186,206,197,897,38,7599,8534,6937,1,0,3,4
9342,SRIKAKULAM,Gara,BANDERUVANI PETA,1,0,602,603,0,0,10,10,6,0,0,517,517,262,0,0,0,0
9343,SRIKAKULAM,Gara,BORAVANI PETA,2,0,297,299,0,0,219,219,205,0,0,8847,8847,5771,0,0,1,1
9344,SRIKAKULAM,Gara,BURAVALLI,53,0,278,331,44,0,215,259,249,2707,0,7887,10594,7169,2,0,2,4
9345,SRIKAKULAM,Gara,GARA,56,0,720,776,38,0,491,529,434,1411,0,13110,14521,8210,2,0,6,8
9346,SRIKAKULAM,Gara,GONTI,32,0,415,447,19,0,251,270,248,1387,0,16620,18007,14312,3,0,17,20
9347,SRIKAKULAM,Gara,K.MATCHALESAM,0,1,191,192,0,1,116,117,111,0,100,7544,7644,5743,0,1,18,19
9348,SRIKAKULAM,Gara,KALINGAPATANAM,17,1,576,594,14,1,425,440,403,1061,63,27285,28409,20352,4,0,52,56
9349,SRIKAKULAM,Gara,KORLAM,40,1,560,601,30,1,374,405,376,2039,55,24875,26969,18547,4,0,63,67
9350,SRIKAKULAM,Gara,KORNI,17,0,340,357,10,0,233,243,190,498,0,10804,11302,6723,0,0,9,9
9351,SRIKAKULAM,Gara,KOTTURU SYRIGAM,43,0,307,350,41,0,244,285,248,3351,0,10746,14097,10342,15,0,9,24
9352,SRIKAKULAM,Gara,NIZAMABAD,38,0,314,352,31,0,263,294,307,2369,0,17884,20253,13444,11,0,64,75
9353,SRIKAKULAM,Gara,PUSARLAPUDU,39,1,322,362,35,0,254,289,271,2278,0,16658,18936,11327,6,0,25,31
9354,SRIKAKULAM,Gara,RAMACHANDRAPURAM,55,13,679,747,34,12,479,525,540,2242,983,27856,31081,23507,10,4,45,59
9355,SRIKAKULAM,Gara,SALIHUNDAM,136,3,335,474,103,3,241,347,307,5129,194,13985,19308,13147,2,1,8,11
9356,SRIKAKULAM,Gara,SATIVADA,45,2,384,431,32,2,284,318,278,1604,110,12839,14553,9441,1,0,9,10
9357,SRIKAKULAM,Gara,SRIKURMAM,263,4,2839,3106,109,4,1775,1888,1785,5782,190,80865,86837,61183,7,0,137,144
9358,SRIKAKULAM,Gara,THONANGI,2,0,366,368,1,0,271,272,249,42,0,9407,9449,7063,0,0,1,1
9359,SRIKAKULAM,Gara,TULUGU,16,0,912,928,7,0,666,673,676,387,0,45223,45610,29629,0,0,119,119
9360,SRIKAKULAM,Gara,VADADA,58,2,928,988,39,2,595,636,607,3555,143,50289,53987,45546,26,0,262,288
9361,SRIKAKULAM,Gara,VATSAVALASA,1,0,713,714,1,0,579,580,600,93,0,43557,43650,35249,0,0,175,175
9362,SRIKAKULAM,Gara,VOMARAVALLI,52,1,585,638,38,1,500,539,547,1055,46,23554,24655,19487,1,0,17,18
9363,SRIKAKULAM,Hiramandalam,AKKARAPALLI,11,240,181,432,6,168,106,280,238,535,10134,6138,16807,9287,3,29,17,49
9364,SRIKAKULAM,Hiramandalam,AMBAVILLI,109,0,223,332,58,0,140,198,141,1878,0,5872,7750,4492,1,0,7,8
9365,SRIKAKULAM,Hiramandalam,BHAGIRADHIPURAM,1,30,29,60,0,0,13,13,12,0,0,548,548,312,0,0,0,0
9366,SRIKAKULAM,Hiramandalam,CHINNAKOLLIVALASA,35,1,129,165,23,1,84,108,83,1545,47,4949,6541,3555,5,0,15,20
9367,SRIKAKULAM,Hiramandalam,CHORLANGI,62,98,271,431,36,61,173,270,247,1384,2489,8021,11894,7892,0,2,7,9
9368,SRIKAKULAM,Hiramandalam,DHANUPURAM,39,0,324,363,28,0,176,204,180,860,0,5455,6315,4416,0,0,1,1
9369,SRIKAKULAM,Hiramandalam,DUGGUPURAM,174,84,332,590,99,47,202,348,278,3273,3920,5510,12703,6038,6,16,0,22
9370,SRIKAKULAM,Hiramandalam,GARLAPADU,99,261,332,692,60,216,199,475,463,2865,14999,10536,28400,14552,10,55,22,87
9371,SRIKAKULAM,Hiramandalam,GOTTA,46,26,258,330,24,14,179,217,187,977,186,7949,9112,6883,1,0,17,18
9372,SRIKAKULAM,Hiramandalam,GULUMURU,74,91,378,543,56,73,262,391,317,4303,5985,16283,26571,13784,20,30,57,107
9373,SRIKAKULAM,Hiramandalam,HIRAMANDALAM,324,96,1607,2027,44,34,199,277,242,891,903,3914,5708,4327,0,1,0,1
9374,SRIKAKULAM,Hiramandalam,KALLATA,77,10,266,353,46,7,89,142,131,1912,338,3028,5278,3583,1,1,1,3
9375,SRIKAKULAM,Hiramandalam,KITTALAPADU,48,93,255,396,12,12,149,173,175,764,48,8686,9498,5953,2,0,28,30
9376,SRIKAKULAM,Hiramandalam,KOMANAPALLE,52,0,190,242,39,0,118,157,141,1543,0,2955,4498,3242,1,0,2,3
9377,SRIKAKULAM,Hiramandalam,KONDARAGOLU,51,0,458,509,31,0,308,339,301,1197,0,11377,12574,8511,1,0,6,7
9378,SRIKAKULAM,Hiramandalam,MAHALAKSHMI PURAM,60,229,273,562,43,126,207,376,351,1204,3324,9799,14327,9369,1,5,17,23
9379,SRIKAKULAM,Hiramandalam,PADALI,133,251,796,1180,111,172,455,738,676,5764,4878,14043,24685,13483,5,3,2,10
9380,SRIKAKULAM,Hiramandalam,PEDDASANKILI,87,119,252,458,52,65,108,225,184,1809,3409,5165,10383,5482,1,7,3,11
9381,SRIKAKULAM,Hiramandalam,PINDRUVADA,177,113,428,718,33,43,159,235,209,2041,1300,8521,11862,7000,2,1,11,14
9382,SRIKAKULAM,Hiramandalam,RUGADA,105,83,405,593,53,13,193,259,217,2470,556,7714,10740,6961,4,3,3,10
9383,SRIKAKULAM,Hiramandalam,TAMPA,48,15,211,274,22,11,45,78,65,1160,600,1072,2832,1998,1,1,1,3
9384,SRIKAKULAM,Hiramandalam,TULAGAM,118,2,246,366,97,2,183,282,241,5374,135,9336,14845,9207,17,0,15,32
9385,SRIKAKULAM,Hiramandalam,TUNGATAMPARA,0,0,70,70,0,0,46,46,38,0,0,3156,3156,2263,0,0,8,8
9386,SRIKAKULAM,Ichchapuram,ARAKABHADRA,8,0,328,336,5,0,208,213,239,156,0,7359,7515,7036,0,0,1,1
9387,SRIKAKULAM,Ichchapuram,BALAKRISHANPURAM,8,0,387,395,8,0,331,339,380,548,0,25533,26081,26030,2,0,90,92
9388,SRIKAKULAM,Ichchapuram,BIRLANGI,18,1,402,421,11,1,248,260,294,482,21,12438,12941,12632,0,0,7,7
9389,SRIKAKULAM,Ichchapuram,BODDABADA,9,0,106,115,9,0,70,79,92,348,0,4364,4712,3837,0,0,10,10
9390,SRIKAKULAM,Ichchapuram,BURJAPADU,0,2,987,989,0,2,874,876,989,0,47,29251,29298,25977,0,0,16,16
9391,SRIKAKULAM,Ichchapuram,DHARMAPURAM,4,0,454,458,3,0,349,352,363,265,0,27249,27514,27089,0,0,38,38
9392,SRIKAKULAM,Ichchapuram,EDUPURAM,5,23,1592,1620,0,17,966,983,986,0,155,42768,42923,38800,0,0,47,47
9393,SRIKAKULAM,Ichchapuram,HARIPURAM,31,0,382,413,29,0,303,332,379,1392,0,18854,20246,18315,1,0,41,42
9394,SRIKAKULAM,Ichchapuram,KEDARIPURAM,16,0,323,339,16,0,298,314,341,1096,0,20049,21145,18659,4,0,49,53
9395,SRIKAKULAM,Ichchapuram,KEERTHIPURAM,3,0,352,355,1,0,194,195,205,116,0,14209,14325,12414,1,0,35,36
9396,SRIKAKULAM,Ichchapuram,KESUPURAM,23,2,715,740,13,0,465,478,536,315,0,26359,26674,25010,0,0,14,14
9397,SRIKAKULAM,Ichchapuram,KOLIGAM,22,0,140,162,15,0,82,97,86,1430,0,6193,7623,5902,6,0,26,32
9398,SRIKAKULAM,Ichchapuram,KOTHARI,6,0,487,493,2,0,291,293,298,188,0,20388,20576,19550,1,0,45,46
9399,SRIKAKULAM,Ichchapuram,LODDAPUTTI,7,0,844,851,1,0,515,516,557,28,0,28743,28771,28659,0,0,18,18
9400,SRIKAKULAM,Ichchapuram,MANDAPALLI,10,5,904,919,8,5,612,625,681,622,205,40924,41751,40457,3,0,43,46
9401,SRIKAKULAM,Ichchapuram,MASAKHAPURAM,5,0,258,263,5,0,148,153,175,264,0,7928,8192,7922,0,0,10,10
9402,SRIKAKULAM,Ichchapuram,MUCHINDRA,7,2,316,325,6,2,229,237,277,325,146,18393,18864,18424,0,0,37,37
9403,SRIKAKULAM,Ichchapuram,PAITHARI,46,0,242,288,21,0,165,186,186,888,0,11273,12161,11152,2,0,21,23
9404,SRIKAKULAM,Ichchapuram,T.BERHAMPURAM,15,0,238,253,10,0,128,138,146,356,0,5059,5415,4851,0,0,0,0
9405,SRIKAKULAM,Ichchapuram,TELUKUNCHI,17,0,401,418,10,0,308,318,356,376,0,15855,16231,15399,1,0,23,24
9406,SRIKAKULAM,Ichchapuram,TULASIGAM,12,1,735,748,7,1,484,492,517,615,23,38276,38914,37975,3,0,149,152
9407,SRIKAKULAM,Jalumuru,AKKURADA,130,0,492,622,77,0,336,413,371,5753,0,19305,25058,14974,22,0,38,60
9408,SRIKAKULAM,Jalumuru,ALLADA,95,1,682,778,74,1,387,462,376,5165,34,17807,23006,13066,16,0,8,24
9409,SRIKAKULAM,Jalumuru,ALLADAPETA,2,2,192,196,2,2,157,161,146,127,64,13358,13549,9453,0,0,79,79
9410,SRIKAKULAM,Jalumuru,ANDHAVARAM,80,0,442,522,64,0,288,352,335,3947,0,15917,19864,10807,13,0,36,49
9411,SRIKAKULAM,Jalumuru,ATCHUTAPURAM,15,0,271,286,12,0,213,225,207,467,0,9857,10324,7578,0,0,5,5
9412,SRIKAKULAM,Jalumuru,BASIVADA,9,0,294,303,8,0,204,212,210,563,0,15046,15609,11381,2,0,52,54
9413,SRIKAKULAM,Jalumuru,BODDAPADU,7,0,184,191,4,0,126,130,119,311,0,9813,10124,7549,2,0,50,52
9414,SRIKAKULAM,Jalumuru,CHALLAVANIPETA,15,0,317,332,12,0,211,223,197,634,0,12363,12997,11444,0,0,28,28
9415,SRIKAKULAM,Jalumuru,CHENNAYAVALASA,20,0,313,333,13,0,252,265,237,652,0,16379,17031,11825,3,0,38,41
9416,SRIKAKULAM,Jalumuru,CHINADUGAM,7,15,240,262,5,11,180,196,192,361,587,12189,13137,9335,1,1,14,16
9417,SRIKAKULAM,Jalumuru,DARIVADA,23,0,258,281,18,0,169,187,171,1027,0,9494,10521,7501,3,0,18,21
9418,SRIKAKULAM,Jalumuru,GOTIVADA,84,0,503,587,60,0,354,414,375,2393,0,19393,21786,14432,2,0,40,42
9419,SRIKAKULAM,Jalumuru,GUGGILI,42,1,319,362,26,0,199,225,207,2058,0,14049,16107,10283,8,0,52,60
9420,SRIKAKULAM,Jalumuru,HUSAINPURAM,17,1,334,352,12,0,236,248,238,655,0,15223,15878,10036,0,0,25,25
9421,SRIKAKULAM,Jalumuru,JALUMURU,172,27,348,547,81,16,189,286,274,3543,366,9702,13611,9105,3,0,15,18
9422,SRIKAKULAM,Jalumuru,JONANKI,5,0,459,464,4,0,321,325,303,183,0,20405,20588,14602,0,0,50,50
9423,SRIKAKULAM,Jalumuru,KARAKAVALASA,22,0,321,343,18,0,239,257,249,1114,0,17005,18119,12809,3,0,48,51
9424,SRIKAKULAM,Jalumuru,KARAVANJA,27,0,309,336,21,0,224,245,225,954,0,11461,12415,8066,0,0,13,13
9425,SRIKAKULAM,Jalumuru,KOMANAPALLE,72,0,315,387,46,0,178,224,213,2071,0,5598,7669,4629,3,0,2,5
9426,SRIKAKULAM,Jalumuru,KONDAPOLAVALASA,2,1,230,233,1,1,164,166,159,55,46,9302,9403,6845,0,0,14,14
9427,SRIKAKULAM,Jalumuru,KURMANADHAPURAM,28,1,166,195,20,0,112,132,108,903,0,5498,6401,4441,1,0,4,5
9428,SRIKAKULAM,Jalumuru,LINGALAVALASA,29,5,480,514,13,3,282,298,251,625,177,15424,16226,11975,0,0,8,8
9429,SRIKAKULAM,Jalumuru,MAKIVALASA,46,0,262,308,30,0,208,238,214,1976,0,14773,16749,10580,5,0,51,56
9430,SRIKAKULAM,Jalumuru,MARRIVALASA,11,58,280,349,6,48,201,255,251,371,4708,9933,15012,8972,1,28,7,36
9431,SRIKAKULAM,Jalumuru,MOKKALINGAM,61,0,628,689,48,0,477,525,435,3707,0,25537,29244,16054,16,0,26,42
9432,SRIKAKULAM,Jalumuru,NAGARIKATAKAM,67,0,337,404,49,0,215,264,254,3251,0,10900,14151,9600,6,0,17,23
9433,SRIKAKULAM,Jalumuru,PAGODU,49,9,462,520,35,7,326,368,326,2564,354,22683,25601,15743,10,0,59,69
9434,SRIKAKULAM,Jalumuru,PARLAM,52,10,190,252,41,0,124,165,151,1845,0,5283,7128,4102,0,0,7,7
9435,SRIKAKULAM,Jalumuru,PEDDADUGAM,5,0,352,357,3,0,274,277,240,160,0,16807,16967,10564,0,0,2,2
9436,SRIKAKULAM,Jalumuru,RAMAYYAVALASA,1,0,222,223,0,0,163,163,144,0,0,14140,14140,10344,0,0,84,84
9437,SRIKAKULAM,Jalumuru,RANA,47,0,529,576,42,0,462,504,488,2281,0,21337,23618,16128,3,0,10,13
9438,SRIKAKULAM,Jalumuru,RAVIPADU,9,5,481,495,3,4,340,347,333,153,275,25195,25623,18793,0,1,80,81
9439,SRIKAKULAM,Jalumuru,SUBRAHMANYAPURAM,0,0,260,260,0,0,181,181,175,0,0,10146,10146,6421,0,0,27,27
9440,SRIKAKULAM,Jalumuru,SURAVARAM,16,4,257,277,8,4,168,180,167,190,199,6653,7042,4525,0,0,8,8
9441,SRIKAKULAM,Jalumuru,SYRIGAM,37,5,389,431,28,4,314,346,301,1686,125,24304,26115,17233,4,0,104,108
9442,SRIKAKULAM,Jalumuru,TALATARIYA,36,2,703,741,23,2,502,527,505,792,25,21723,22540,15146,0,0,21,21
9443,SRIKAKULAM,Jalumuru,TEKKLALIPADU,5,0,363,368,3,0,247,250,251,140,0,14243,14383,11529,0,0,16,16
9444,SRIKAKULAM,Jalumuru,TIMADAM,4,0,267,271,3,0,214,217,206,197,0,16838,17035,10700,0,0,70,70
9445,SRIKAKULAM,Jalumuru,VENKATAPURAM,15,0,327,342,12,0,278,290,262,683,0,16861,17544,12060,1,0,22,23
9446,SRIKAKULAM,Jalumuru,YELAMANCHILI,14,10,566,590,7,9,373,389,397,164,240,14198,14602,10345,0,0,3,3
9447,SRIKAKULAM,Kanchili,AMPURAM,35,2,585,622,14,0,272,286,284,812,0,14739,15551,13441,0,0,13,13
9448,SRIKAKULAM,Kanchili,BELLUPADA,36,2,339,377,24,0,232,256,219,1901,0,11614,13515,9340,12,0,9,21
9449,SRIKAKULAM,Kanchili,BHYRIPURAM,34,6,175,215,21,4,120,145,154,943,210,5322,6475,5301,0,0,6,6
9450,SRIKAKULAM,Kanchili,BOGHABENI,16,14,482,512,12,2,307,321,307,306,39,11339,11684,8796,1,0,3,4
9451,SRIKAKULAM,Kanchili,BURAGAM,51,0,446,497,41,0,363,404,382,2909,0,24263,27172,23078,5,0,42,47
9452,SRIKAKULAM,Kanchili,CHINNAKHOJIRIA,2,0,202,204,0,0,131,131,121,0,0,5333,5333,2999,0,0,2,2
9453,SRIKAKULAM,Kanchili,DOLAGOVINDAPURAM,30,4,212,246,20,3,125,148,129,940,84,4950,5974,4567,0,0,2,2
9454,SRIKAKULAM,Kanchili,GOKARNAPURAM,33,1,535,569,19,0,339,358,342,1717,0,18652,20369,15696,12,0,23,35
9455,SRIKAKULAM,Kanchili,JADUPUDI,11,0,634,645,4,0,432,436,457,174,0,14196,14370,12867,0,0,1,1
9456,SRIKAKULAM,Kanchili,JALANTRAKOTA,47,254,679,980,18,53,516,587,674,439,697,22513,23649,19556,0,0,23,23
9457,SRIKAKULAM,Kanchili,KANCHILI,18,0,564,582,2,0,425,427,480,167,0,27444,27611,22611,1,0,74,75
9458,SRIKAKULAM,Kanchili,KATTIVARAM,14,0,314,328,3,0,204,207,208,78,0,5750,5828,3949,0,0,3,3
9459,SRIKAKULAM,Kanchili,KESARIPADA,30,12,571,613,19,8,326,353,347,632,124,10220,10976,8490,0,0,0,0
9460,SRIKAKULAM,Kanchili,KOKKILIPUTTUGA,2,235,24,261,1,211,20,232,273,69,12220,1165,13454,10263,0,27,4,31
9461,SRIKAKULAM,Kanchili,KOLLURU,8,16,947,971,6,1,565,572,573,147,55,20419,20621,18401,0,0,4,4
9462,SRIKAKULAM,Kanchili,KONNAIPUTTUGA,1,133,70,204,0,0,0,0,0,0,0,0,0,0,0,0,0,0
9463,SRIKAKULAM,Kanchili,KUMBARINOWGAM,33,271,209,513,21,158,82,261,277,705,5270,1301,7276,4511,2,4,0,6
9464,SRIKAKULAM,Kanchili,KUTTUMA,27,4,305,336,14,2,170,186,164,941,150,12808,13899,10224,2,0,36,38
9465,SRIKAKULAM,Kanchili,M.S.PALLI,21,3,822,846,12,1,431,444,430,468,17,14565,15050,12964,0,0,4,4
9466,SRIKAKULAM,Kanchili,MAKARAMPURAM,15,0,660,675,2,0,265,267,284,61,0,7382,7443,5343,0,0,12,12
9467,SRIKAKULAM,Kanchili,MANDAPALLE,24,1,538,563,18,1,308,327,277,1096,43,13684,14823,9424,2,0,22,24
9468,SRIKAKULAM,Kanchili,MUNDALA,38,1,436,475,29,0,222,251,227,1356,0,8750,10106,7882,3,0,10,13
9469,SRIKAKULAM,Kanchili,PEDDA SREERAMPURAM,27,2,708,737,0,2,207,209,209,0,10,3948,3958,3053,0,0,2,2
9470,SRIKAKULAM,Kanchili,PEDDAKHOJIRIA,11,0,219,230,8,0,120,128,89,228,0,6151,6379,3534,0,0,5,5
9471,SRIKAKULAM,Kanchili,POLERU,17,2,1105,1124,9,1,489,499,437,223,20,36011,36254,28431,0,0,46,46
9472,SRIKAKULAM,Kanchili,PURUSHOTHAPURAM,12,1,389,402,0,1,262,263,301,0,134,13366,13500,11183,0,1,25,26
9473,SRIKAKULAM,Kanchili,S.R.C.PURAM,2,0,222,224,0,0,152,152,163,0,0,7295,7295,5729,0,0,4,4
9474,SRIKAKULAM,Kanchili,SASANAM,7,18,498,523,6,16,374,396,414,221,1055,16536,17812,14571,0,3,18,21
9475,SRIKAKULAM,Kanchili,TALATAMPARA,8,601,307,916,3,436,136,575,561,138,13756,2587,16481,10914,0,2,0,2
9476,SRIKAKULAM,Kanchili,YEKKALA,12,4,442,458,4,1,370,375,394,207,104,14498,14809,12683,0,1,5,6
9477,SRIKAKULAM,Kaviti,B.G.PUTTUGA,1,1,562,564,0,1,332,333,323,0,6,7377,7383,5298,0,0,0,0
9478,SRIKAKULAM,Kaviti,BALLIPUTTUGA,6,12,721,739,0,9,394,403,430,0,107,6291,6398,4948,0,0,0,0
9479,SRIKAKULAM,Kaviti,BEJJIPUTTUGA,9,2,983,994,2,0,132,134,125,36,0,2119,2155,1427,0,0,0,0
9480,SRIKAKULAM,Kaviti,BELAGAM,7,1,663,671,0,0,261,261,256,0,0,8684,8684,7965,0,0,0,0
9481,SRIKAKULAM,Kaviti,BHYRIPURAM,7,0,304,311,3,0,174,177,178,86,0,7325,7411,5982,0,0,5,5
9482,SRIKAKULAM,Kaviti,BORIVANKA,19,128,792,939,18,116,187,321,306,1641,4873,5665,12179,8634,7,0,1,8
9483,SRIKAKULAM,Kaviti,D.G.PUTTUGA,79,1,456,536,24,1,89,114,78,452,51,1607,2110,1424,0,0,0,0
9484,SRIKAKULAM,Kaviti,GORRELAPADU,33,0,325,358,7,0,227,234,264,316,0,12385,12701,11506,0,0,22,22
9485,SRIKAKULAM,Kaviti,JAGATHI,25,2,811,838,6,2,454,462,444,83,17,9839,9939,7969,0,0,1,1
9486,SRIKAKULAM,Kaviti,KAPASAKUDDI,0,0,1026,1026,0,0,620,620,725,0,0,25654,25654,24030,0,0,19,19
9487,SRIKAKULAM,Kaviti,KARAPADU,28,1,567,596,12,1,211,224,246,313,36,8238,8587,7586,0,0,1,1
9488,SRIKAKULAM,Kaviti,KAVITI,25,5,2064,2094,0,0,297,297,261,0,0,5965,5965,4466,0,0,10,10
9489,SRIKAKULAM,Kaviti,KOJJIRIA,8,4,448,460,0,3,285,288,289,0,83,9473,9556,8254,0,0,5,5
9490,SRIKAKULAM,Kaviti,KUSUMPURAM,0,58,607,665,0,37,351,388,439,0,909,13236,14145,11334,0,0,0,0
9491,SRIKAKULAM,Kaviti,LANDARIPUTTUGA,4,1,928,933,1,1,483,485,509,16,18,20766,20800,18313,0,0,48,48
9492,SRIKAKULAM,Kaviti,MANIKYAPURAM,9,454,363,826,4,192,38,234,232,39,1306,1236,2581,2068,0,0,0,0
9493,SRIKAKULAM,Kaviti,NELAVANKA,21,63,1197,1281,7,46,607,660,604,458,1027,21831,23316,19191,0,0,1,1
9494,SRIKAKULAM,Kaviti,RAJAPURAM,36,1,885,922,17,0,568,585,654,1107,0,18715,19822,17293,0,0,27,27
9495,SRIKAKULAM,Kaviti,SAHALALAPUTTUGA,0,0,699,699,0,0,2,2,2,0,0,41,41,41,0,0,0,0
9496,SRIKAKULAM,Kaviti,SILAGAM,17,0,500,517,6,0,273,279,302,359,0,21602,21961,17267,0,0,79,79
9497,SRIKAKULAM,Kaviti,VARAKHA,7,110,379,496,2,71,156,229,211,36,2519,4102,6657,4662,0,0,0,0
9498,SRIKAKULAM,Kotabommili,AKKAYYAVALASA,45,0,232,277,23,0,153,176,173,1279,0,8814,10093,6684,1,0,10,11
9499,SRIKAKULAM,Kotabommili,CHEEPURLAPADU,79,4,527,610,60,3,351,414,403,1847,81,9396,11324,7722,0,0,1,1
9500,SRIKAKULAM,Kotabommili,CHINABAMMIDI,26,0,322,348,0,0,10,10,4,0,0,35,35,21,0,0,0,0
9501,SRIKAKULAM,Kotabommili,CHINASANA,86,35,287,408,65,14,189,268,224,4509,1020,11105,16634,9038,18,4,25,47
9502,SRIKAKULAM,Kotabommili,CHITTIVALASA,47,0,565,612,1,0,410,411,428,20,0,16445,16465,9542,0,0,5,5
9503,SRIKAKULAM,Kotabommili,DANTHA,52,39,388,479,26,24,193,243,212,1644,1180,11523,14347,8954,3,2,33,38
9504,SRIKAKULAM,Kotabommili,DUPPALAPADU,8,1,331,340,6,1,183,190,156,295,21,7146,7462,4782,0,0,1,1
9505,SRIKAKULAM,Kotabommili,GANGARAM,35,0,282,317,25,0,178,203,193,1510,0,9868,11378,6514,0,0,5,5
9506,SRIKAKULAM,Kotabommili,HARICHANDRAPURAM,41,5,1629,1675,14,1,774,789,654,284,11,21606,21901,12854,0,0,39,39
9507,SRIKAKULAM,Kotabommili,JARJANGI,33,1,370,404,17,1,227,245,208,276,21,7355,7652,4432,0,0,1,1
9508,SRIKAKULAM,Kotabommili,JIYYANNAPETA,30,0,270,300,16,0,161,177,155,1018,0,9265,10283,6807,1,0,19,20
9509,SRIKAKULAM,Kotabommili,KANNEVALASA,62,2,267,331,28,0,180,208,193,963,0,10134,11097,8565,0,0,18,18
9510,SRIKAKULAM,Kotabommili,KASTURIPADU,16,32,353,401,10,27,150,187,169,177,1276,6213,7666,5187,0,1,4,5
9511,SRIKAKULAM,Kotabommili,KISTUPURAM,56,0,394,450,35,0,244,279,260,1405,0,15077,16482,12400,0,0,30,30
9512,SRIKAKULAM,Kotabommili,KOTABOMMILI,212,2,1229,1443,58,1,445,504,454,806,20,17550,18376,11850,1,0,15,16
9513,SRIKAKULAM,Kotabommili,KOTHAPALLI,81,4,430,515,55,0,221,276,260,2248,0,6649,8897,6506,3,0,4,7
9514,SRIKAKULAM,Kotabommili,KOTTAPETA,5,5,374,384,1,2,174,177,175,8,37,5802,5847,4092,0,0,0,0
9515,SRIKAKULAM,Kotabommili,KURUDU,270,7,988,1265,124,1,586,711,633,4746,12,27779,32537,19525,5,0,31,36
9516,SRIKAKULAM,Kotabommili,LAKKAMDIDDI,32,0,693,725,26,0,385,411,376,727,0,11781,12508,7518,0,0,0,0
9517,SRIKAKULAM,Kotabommili,MAHASAHEBPETA,16,31,311,358,5,10,176,191,155,121,285,6647,7053,4024,0,0,2,2
9518,SRIKAKULAM,Kotabommili,NARAYANAVALASA,16,1,292,309,8,1,179,188,179,641,47,6280,6968,5427,1,0,0,1
9519,SRIKAKULAM,Kotabommili,NEELAMPETA,44,68,347,459,32,57,232,321,266,2182,4374,13339,19895,10481,8,16,16,40
9520,SRIKAKULAM,Kotabommili,NIMMADA,32,1,864,897,19,1,600,620,592,891,15,27139,28045,15655,0,0,7,7
9521,SRIKAKULAM,Kotabommili,PATTUPURAM,13,7,363,383,10,3,262,275,271,481,186,12283,12950,9650,0,0,6,6
9522,SRIKAKULAM,Kotabommili,PEDAMAMMIDI,43,4,407,454,31,3,312,346,331,1279,80,13431,14790,10652,1,0,0,1
9523,SRIKAKULAM,Kotabommili,RAMASWARAM,95,0,61,156,31,0,20,51,50,247,0,158,405,280,0,0,0,0
9524,SRIKAKULAM,Kotabommili,REGULAPADU,30,0,436,466,22,0,342,364,359,487,0,9822,10309,7537,0,0,0,0
9525,SRIKAKULAM,Kotabommili,SARIABODDUPADU,0,0,346,346,0,0,248,248,234,0,0,12353,12353,7087,0,0,11,11
9526,SRIKAKULAM,Kotabommili,SARIAPALLI,35,15,203,253,20,11,147,178,176,1166,826,8556,10548,6978,2,4,7,13
9527,SRIKAKULAM,Kotabommili,SOWDAM,44,1,270,315,31,1,206,238,227,1594,3,9345,10942,7755,2,0,5,7
9528,SRIKAKULAM,Kotabommili,SRIJAGANNADHAPURAM,23,3,573,599,19,2,375,396,344,880,114,20177,21171,13020,1,0,33,34
9529,SRIKAKULAM,Kotabommili,TARLIPETA,5,0,298,303,1,0,179,180,192,30,0,8780,8810,6411,0,0,18,18
9530,SRIKAKULAM,Kotabommili,THATIPARTHI,24,4,234,262,14,3,147,164,172,658,40,3678,4376,2907,0,0,0,0
9531,SRIKAKULAM,Kotabommili,TILARU,33,1,548,582,12,1,336,349,322,518,40,12317,12875,9655,0,0,3,3
9532,SRIKAKULAM,Kotabommili,VANDRADA,18,2,408,428,13,2,290,305,297,665,52,12877,13594,8899,0,0,8,8
9533,SRIKAKULAM,Kotabommili,VISWANADHAPURAM,102,39,325,466,53,32,159,244,223,3393,2209,9784,15386,11225,6,6,21,33
9534,SRIKAKULAM,Kotabommili,YELAMANCHILI,4,0,755,759,0,0,469,469,432,0,0,11976,11976,7127,0,0,1,1
9535,SRIKAKULAM,Kotabommili,YETHURALLAPADU,41,0,261,302,26,0,161,187,183,839,0,4078,4917,3077,0,0,0,0
9536,SRIKAKULAM,Kothuru,AKULATAMPARA,10,3,392,405,6,2,223,231,195,215,54,11646,11915,7203,0,0,6,6
9537,SRIKAKULAM,Kothuru,ALTHI,1,235,0,236,0,186,0,186,177,0,13647,0,13647,7703,0,60,0,60
9538,SRIKAKULAM,Kothuru,BALADA,113,2,379,494,69,1,219,289,308,4795,65,14361,19221,12333,17,0,28,45
9539,SRIKAKULAM,Kothuru,BAMMIDI,103,30,351,484,76,26,251,353,340,3169,1120,4236,8525,4907,0,1,0,1
9540,SRIKAKULAM,Kothuru,DIMILI,89,128,339,556,59,103,160,322,295,2776,7208,6595,16579,9678,1,22,9,32
9541,SRIKAKULAM,Kothuru,GOTTIPALLI,5,717,3,725,3,604,2,609,647,36,28773,36,28845,15127,0,46,0,46
9542,SRIKAKULAM,Kothuru,GUNABHADRA,88,90,218,396,63,69,152,284,293,2598,4281,5834,12713,8371,0,11,0,11
9543,SRIKAKULAM,Kothuru,GURANDI,83,55,534,672,39,45,303,387,355,2154,1671,11946,15771,9070,6,2,14,22
9544,SRIKAKULAM,Kothuru,HAMSA,14,3,175,192,11,2,115,128,115,660,121,5703,6484,4562,0,0,5,5
9545,SRIKAKULAM,Kothuru,IRAPADU,178,147,452,777,120,120,276,516,465,7651,5221,15942,28814,16094,17,2,10,29
9546,SRIKAKULAM,Kothuru,KADUMU,219,0,498,717,174,0,271,445,415,10524,0,5990,16514,11718,10,0,1,11
9547,SRIKAKULAM,Kothuru,KALIGAM,70,1,323,394,47,1,195,243,225,2015,15,6250,8280,5542,1,0,2,3
9548,SRIKAKULAM,Kothuru,KARELEMMA,275,181,504,960,138,78,215,431,387,7814,3757,12550,24121,14011,14,12,26,52
9549,SRIKAKULAM,Kothuru,KOTTURU,458,2,1270,1730,278,1,791,1070,1044,11969,43,39484,51496,34054,11,0,61,72
9550,SRIKAKULAM,Kothuru,KUDDIGAM,29,2,329,360,25,2,230,257,238,990,62,14399,15451,9163,1,0,21,22
9551,SRIKAKULAM,Kothuru,KUNTIBADRA,118,0,784,902,85,0,605,690,641,5861,0,48156,54017,27938,18,0,225,243
9552,SRIKAKULAM,Kothuru,KURIGAM,65,14,233,312,33,11,107,151,150,866,397,3779,5042,3316,0,0,2,2
9553,SRIKAKULAM,Kothuru,LABBA,42,317,92,451,36,208,54,298,288,3267,12545,4137,19949,10344,13,49,16,78
9554,SRIKAKULAM,Kothuru,M.J.PURAM,37,10,75,122,25,10,52,87,83,1925,959,3907,6791,4048,8,5,17,30
9555,SRIKAKULAM,Kothuru,MADANAPURAM,185,53,604,842,116,36,383,535,476,5476,1706,19743,26925,14995,12,2,28,42
9556,SRIKAKULAM,Kothuru,MAKAVARAM,25,135,443,603,21,125,292,438,406,788,3654,13575,18017,10138,0,0,9,9
9557,SRIKAKULAM,Kothuru,MATHALA,52,0,370,422,42,0,266,308,271,2931,0,14579,17510,11106,10,0,24,34
9558,SRIKAKULAM,Kothuru,METTURU,84,112,226,422,51,86,133,270,244,3199,4139,8379,15717,10253,9,4,27,40
9559,SRIKAKULAM,Kothuru,N K PURAM,98,21,388,507,62,18,279,359,335,2131,471,11206,13808,7603,2,0,10,12
9560,SRIKAKULAM,Kothuru,NERADI,21,34,605,660,11,25,415,451,416,603,2022,31163,33788,19211,2,10,124,136
9561,SRIKAKULAM,Kothuru,NIVAGAM,196,1,269,466,91,0,168,259,249,5210,0,8528,13738,10583,9,0,5,14
9562,SRIKAKULAM,Kothuru,ONDRUZOLA,66,111,239,416,45,61,164,270,246,3876,4886,13466,22228,13357,20,21,52,93
9563,SRIKAKULAM,Kothuru,PARAPURAM,116,2,543,661,48,1,269,318,291,1787,38,9367,11192,7918,0,0,1,1
9564,SRIKAKULAM,Kothuru,PONNUTURU,60,23,407,490,34,18,207,259,254,1739,1109,13100,15948,11070,4,2,28,34
9565,SRIKAKULAM,Kothuru,RAYALA,66,110,59,235,42,85,36,163,149,2322,3431,2178,7931,4392,1,1,7,9
9566,SRIKAKULAM,Kothuru,SIRUSUVADA,145,2,446,593,102,0,253,355,321,3925,0,5894,9819,5902,0,0,0,0
9567,SRIKAKULAM,Kothuru,SOMARAJAPURAM,3,41,308,352,0,27,207,234,213,0,612,9748,10360,5554,0,0,7,7
9568,SRIKAKULAM,Kothuru,VASAPA,55,2,505,562,36,1,357,394,348,2875,42,24539,27456,16705,15,0,58,73
9569,SRIKAKULAM,Laveru,ADAPAKA,114,9,934,1057,27,1,554,582,526,2118,77,39102,41297,25078,15,0,144,159
9570,SRIKAKULAM,Laveru,APPAPURAM,95,1,327,423,79,1,188,268,266,7889,87,17591,25567,15547,55,0,97,152
9571,SRIKAKULAM,Laveru,BEJJIPURAM,118,3,1092,1213,59,3,635,697,692,3062,132,30716,33910,28254,5,0,32,37
9572,SRIKAKULAM,Laveru,BUDATHAVALASA,111,0,539,650,106,0,485,591,573,7235,0,30119,37354,22514,27,0,39,66
9573,SRIKAKULAM,Laveru,BUDUMURU,100,1,640,741,74,1,407,482,451,2176,47,18304,20527,13273,0,0,22,22
9574,SRIKAKULAM,Laveru,CHINAMURAPAKA,30,6,617,653,24,5,427,456,444,1525,379,28160,30064,21705,6,0,71,77
9575,SRIKAKULAM,Laveru,GOVINDAPURAM,53,0,571,624,44,0,476,520,503,3233,0,32714,35947,21535,9,0,98,107
9576,SRIKAKULAM,Laveru,GUMADAM,146,9,607,762,108,3,453,564,563,7931,345,39766,48042,26642,26,3,207,236
9577,SRIKAKULAM,Laveru,GURRALAPALEM,56,3,181,240,27,2,121,150,134,1705,131,7271,9107,4797,2,0,12,14
9578,SRIKAKULAM,Laveru,GURUGUBILLI,148,0,92,240,116,0,55,171,142,9670,0,3372,13042,7119,39,0,4,43
9579,SRIKAKULAM,Laveru,KESAVARAYUNI PALEM,143,0,401,544,123,0,301,424,403,8408,0,17037,25445,16533,18,0,34,52
9580,SRIKAKULAM,Laveru,KOTHAKOTA,103,12,284,399,85,0,209,294,291,6091,0,12311,18402,12522,23,0,33,56
9581,SRIKAKULAM,Laveru,KOTHAKUNKAM,185,4,829,1018,135,4,628,767,784,13577,308,62713,76598,38287,97,1,423,521
9582,SRIKAKULAM,Laveru,LAKSHMIPURAM,78,2,691,771,34,2,405,441,421,2271,189,29261,31721,19317,7,1,152,160
9583,SRIKAKULAM,Laveru,LAVERU,366,129,1352,1847,206,104,624,934,817,13867,8317,38384,60568,33788,55,38,99,192
9584,SRIKAKULAM,Laveru,LOPENTA,56,3,626,685,47,3,343,393,421,4078,93,22186,26357,18206,21,0,65,86
9585,SRIKAKULAM,Laveru,MURAPAKA,170,0,1295,1465,104,0,833,937,875,7284,0,49524,56808,42282,29,0,110,139
9586,SRIKAKULAM,Laveru,PATHAKUNKAM,64,0,364,428,51,0,316,367,328,4411,0,27985,32396,17572,23,0,160,183
9587,SRIKAKULAM,Laveru,PEDDAKOTTAPALLE,54,0,305,359,49,0,246,295,309,4800,0,22550,27350,18902,31,0,126,157
9588,SRIKAKULAM,Laveru,PEDDALINGALAVALASA,128,0,476,604,96,0,305,401,374,6188,0,19104,25292,16210,11,0,32,43
9589,SRIKAKULAM,Laveru,PEDDARAOPALLE,67,1,490,558,34,0,271,305,246,2187,0,21477,23664,15143,6,0,115,121
9590,SRIKAKULAM,Laveru,POTHAYYAVALASA,81,0,140,221,58,0,98,156,138,4207,0,6437,10644,6181,17,0,20,37
9591,SRIKAKULAM,Laveru,SIGIRIKOTHAPALLE,38,0,250,288,29,0,151,180,165,2019,0,9009,11028,7146,3,0,17,20
9592,SRIKAKULAM,Laveru,TALLAVALASA,226,1,428,655,154,0,224,378,338,12624,0,15781,28405,18466,53,0,42,95
9593,SRIKAKULAM,Laveru,THAMVADA,34,5,931,970,25,2,714,741,723,1256,146,43782,45184,26230,0,1,63,64
9594,SRIKAKULAM,Laveru,VENKATAPURAM,44,2,545,591,35,2,355,392,399,2643,120,23350,26113,15122,7,1,32,40
9595,SRIKAKULAM,LaxmiNarsuPeta,BORRAMPETA,94,18,248,360,63,1,183,247,199,4753,74,13612,18439,10828,19,0,46,65
9596,SRIKAKULAM,LaxmiNarsuPeta,BOTTADASINGI,63,22,361,446,49,18,267,334,313,2826,779,15955,19560,12726,10,2,44,56
9597,SRIKAKULAM,LaxmiNarsuPeta,CHINTALABADAVANJA,27,1,521,549,11,0,332,343,311,656,0,20639,21295,12210,1,0,71,72
9598,SRIKAKULAM,LaxmiNarsuPeta,CHORLANGI,2,428,180,610,1,210,136,347,338,119,14740,12338,27197,15631,1,53,74,128
9599,SRIKAKULAM,LaxmiNarsuPeta,DABBAPADU,23,2,204,229,19,1,142,162,150,523,56,4603,5182,2939,0,0,0,0
9600,SRIKAKULAM,LaxmiNarsuPeta,DHANUKUVADA,39,1,249,289,31,1,188,220,203,2109,26,13020,15155,10560,7,0,43,50
9601,SRIKAKULAM,LaxmiNarsuPeta,GOTTIPALLE,62,2,271,335,44,0,176,220,199,3062,0,12464,15526,10170,11,0,34,45
9602,SRIKAKULAM,LaxmiNarsuPeta,KARAKAVALASA,153,5,526,684,88,2,333,423,377,5633,116,20259,26008,16113,16,0,66,82
9603,SRIKAKULAM,LaxmiNarsuPeta,KOMMUVALASA,75,3,257,335,41,2,142,185,163,2826,105,9901,12832,8348,9,0,26,35
9604,SRIKAKULAM,LaxmiNarsuPeta,KOVILAM,42,0,391,433,33,0,254,287,279,2196,0,8354,10550,6994,6,0,8,14
9605,SRIKAKULAM,LaxmiNarsuPeta,L.N.PETA,114,4,1086,1204,52,3,563,618,562,2379,92,28846,31317,20192,3,0,33,36
9606,SRIKAKULAM,LaxmiNarsuPeta,MIRIAPALLI,52,2,308,362,39,2,230,271,260,3093,92,18217,21402,13716,11,0,75,86
9607,SRIKAKULAM,LaxmiNarsuPeta,MUNGANNAPADU,6,0,277,283,6,0,258,264,264,615,0,24797,25412,15043,5,0,168,173
9608,SRIKAKULAM,LaxmiNarsuPeta,PEDDAKOLLIVALASA,74,2,556,632,55,2,401,458,427,2622,67,17342,20031,13721,1,0,9,10
9609,SRIKAKULAM,LaxmiNarsuPeta,RAVICHANDRI,53,0,333,386,31,0,206,237,219,900,0,4823,5723,3527,0,0,0,0
9610,SRIKAKULAM,LaxmiNarsuPeta,SIDDANTHAM,24,0,95,119,21,0,71,92,87,1886,0,5693,7579,5133,12,0,30,42
9611,SRIKAKULAM,LaxmiNarsuPeta,SUMANTHAPURAM,0,0,174,174,0,0,139,139,126,0,0,10398,10398,6713,0,0,31,31
9612,SRIKAKULAM,LaxmiNarsuPeta,TURAKAPETA KRISHNAPURAM,19,2,426,447,12,2,224,238,240,968,202,17578,18748,12581,3,1,74,78
9613,SRIKAKULAM,LaxmiNarsuPeta,YEMBARAM,30,0,620,650,19,0,321,340,289,1387,0,18723,20110,11168,5,0,46,51
9614,SRIKAKULAM,Mandasa,AMBUGAM,30,1,803,834,8,1,553,562,574,259,81,33725,34065,28604,0,0,55,55
9615,SRIKAKULAM,Mandasa,B.S.PURAM,49,7,717,773,40,4,553,597,642,2392,342,40490,43224,30083,5,1,135,141
9616,SRIKAKULAM,Mandasa,BAHADAPALLE,16,0,540,556,10,0,418,428,430,717,0,25919,26636,19246,2,0,35,37
9617,SRIKAKULAM,Mandasa,BALIGAM,77,3,356,436,31,2,256,289,268,2295,168,20661,23124,16955,3,0,96,99
9618,SRIKAKULAM,Mandasa,BARUVA PATTANGI,96,0,312,408,47,0,234,281,331,1503,0,12531,14034,9885,4,0,21,25
9619,SRIKAKULAM,Mandasa,BELLUPATIA,28,1,287,316,12,1,220,233,240,282,41,13190,13513,10108,0,0,28,28
9620,SRIKAKULAM,Mandasa,BETHALAPURAM,0,0,944,944,0,0,631,631,648,0,0,24317,24317,19561,0,0,17,17
9621,SRIKAKULAM,Mandasa,BHOGABANDA,17,300,76,393,10,211,35,256,258,844,14900,3347,19091,10823,3,66,14,83
9622,SRIKAKULAM,Mandasa,BHOGAPURAM,70,15,389,474,38,6,249,293,285,1573,192,11793,13558,9473,2,0,12,14
9623,SRIKAKULAM,Mandasa,BINNALA,63,3,345,411,46,1,221,268,237,3048,30,15552,18630,11468,8,0,65,73
9624,SRIKAKULAM,Mandasa,BUDARISINGI,73,333,369,775,51,246,281,578,557,2826,14035,18291,35152,20016,8,46,60,114
9625,SRIKAKULAM,Mandasa,CHEEPI,28,291,40,359,21,193,24,238,254,1608,8469,1272,11349,6435,5,8,1,14
9626,SRIKAKULAM,Mandasa,DUNNAVOORU,5,0,625,630,4,0,466,470,492,211,0,32754,32965,26510,0,0,75,75
9627,SRIKAKULAM,Mandasa,HAMSARALI,8,163,331,502,7,72,266,345,342,488,4731,24630,29849,17265,2,6,114,122
9628,SRIKAKULAM,Mandasa,HARIPURAM,38,0,333,371,18,0,147,165,148,398,0,3792,4190,2994,0,0,0,0
9629,SRIKAKULAM,Mandasa,HONNALI,49,8,298,355,45,8,263,316,335,3107,582,19382,23071,14038,10,1,56,67
9630,SRIKAKULAM,Mandasa,JULLUNDA,6,0,560,566,4,0,409,413,401,132,0,18357,18489,12545,0,0,8,8
9631,SRIKAKULAM,Mandasa,KONDALOGAM,2,669,2,673,0,445,1,446,476,0,29094,6,29100,16448,0,114,0,114
9632,SRIKAKULAM,Mandasa,KONKADAPUTTI,50,245,280,575,33,183,199,415,426,1768,14715,15442,31925,19685,3,72,74,149
9633,SRIKAKULAM,Mandasa,KOTHAPALLE,22,1,186,209,8,0,95,103,82,315,0,5298,5613,3421,0,0,9,9
9634,SRIKAKULAM,Mandasa,KOTTAPALLI,17,0,162,179,9,0,114,123,120,272,0,5323,5595,4222,0,0,0,0
9635,SRIKAKULAM,Mandasa,KUNTIKOTA,27,0,349,376,17,0,199,216,204,853,0,13790,14643,10732,2,0,49,51
9636,SRIKAKULAM,Mandasa,LOHARIBANDA,10,0,735,745,5,0,588,593,601,120,0,31418,31538,22117,0,0,54,54
9637,SRIKAKULAM,Mandasa,MAJARAJOLA,27,1,321,349,17,0,265,282,265,1039,0,23905,24944,18341,3,0,114,117
9638,SRIKAKULAM,Mandasa,MANDASA,166,44,974,1184,84,32,533,649,653,3500,1896,24739,30135,24757,8,5,22,35
9639,SRIKAKULAM,Mandasa,MULIPADU,59,0,316,375,28,0,233,261,244,1831,0,13742,15573,10898,1,0,27,28
9640,SRIKAKULAM,Mandasa,NARAYANAPURAM,2,1,689,692,1,0,433,434,413,21,0,17620,17641,13490,0,0,34,34
9641,SRIKAKULAM,Mandasa,NARISINGUPURAM,5,80,335,420,2,66,231,299,304,70,4779,13656,18505,11914,0,25,40,65
9642,SRIKAKULAM,Mandasa,PIDIMANDASA,8,38,376,422,5,32,280,317,297,309,3081,18488,21878,14259,0,14,49,63
9643,SRIKAKULAM,Mandasa,PITHATHOLI,2,0,230,232,0,0,162,162,170,0,0,10469,10469,6120,0,0,34,34
9644,SRIKAKULAM,Mandasa,RAMPURAM,29,1,536,566,27,0,364,391,370,1442,0,18336,19778,13805,1,0,17,18
9645,SRIKAKULAM,Mandasa,SABAKOTA,35,296,76,407,26,165,17,208,223,1831,8375,883,11089,7123,4,15,0,19
9646,SRIKAKULAM,Mandasa,SARIYAPALLE,0,0,622,622,0,0,328,328,347,0,0,16700,16700,11529,0,0,20,20
9647,SRIKAKULAM,Mandasa,SIDDIGAM,36,0,266,302,23,0,219,242,248,2391,0,21224,23615,14615,17,0,146,163
9648,SRIKAKULAM,Mandasa,SIRIPURAM,21,6,353,380,16,6,202,224,251,1041,270,9567,10878,8274,4,0,17,21
9649,SRIKAKULAM,Mandasa,SONDIPUDI,86,1,300,387,49,1,194,244,230,2154,65,11396,13615,10343,1,0,22,23
9650,SRIKAKULAM,Mandasa,SUVARNAPURAM,52,0,560,612,35,0,336,371,353,1203,0,16192,17395,12497,1,0,12,13
9651,SRIKAKULAM,Mandasa,TALLAGURATI,29,309,157,495,19,204,76,299,279,995,16196,6274,23465,13166,3,79,26,108
9652,SRIKAKULAM,Mandasa,V.G.PURAM,27,0,235,262,9,0,158,167,152,702,0,12787,13489,9575,0,0,53,53
9653,SRIKAKULAM,Meilaputti,BANAPURAM,15,159,258,432,15,140,223,378,377,1713,14116,20298,36127,22976,12,85,115,212
9654,SRIKAKULAM,Meilaputti,BHARANIKOTA,6,470,148,624,1,348,104,453,464,108,38628,10119,48855,25522,1,279,65,345
9655,SRIKAKULAM,Meilaputti,CHAPARA,159,18,681,858,60,1,358,419,399,4067,41,22475,26583,20823,20,0,63,83
9656,SRIKAKULAM,Meilaputti,CHEEPURUPALLE,24,116,285,425,18,84,213,315,309,1406,5763,19291,26460,17675,5,23,105,133
9657,SRIKAKULAM,Meilaputti,DEENABANDHUPURAM,48,225,39,312,43,192,23,258,272,2929,15990,1069,19988,13745,11,81,2,94
9658,SRIKAKULAM,Meilaputti,GANGARAJUPURAM,15,0,261,276,12,0,106,118,99,738,0,4000,4738,3003,2,0,2,4
9659,SRIKAKULAM,Meilaputti,GOKARNAPURAM,46,0,386,432,33,0,276,309,259,3058,0,29470,32528,18140,24,0,220,244
9660,SRIKAKULAM,Meilaputti,GOPPILI,30,2,449,481,23,1,349,373,350,880,39,14395,15314,10593,0,0,2,2
9661,SRIKAKULAM,Meilaputti,JADUPALLI,79,120,314,513,42,95,174,311,307,3699,8913,13919,26531,16478,18,55,67,140
9662,SRIKAKULAM,Meilaputti,JODURU,15,121,226,362,11,88,180,279,313,814,7243,13573,21630,14632,2,33,56,91
9663,SRIKAKULAM,Meilaputti,KARAJADA,16,0,375,391,10,0,246,256,256,503,0,22920,23423,18218,3,0,146,149
9664,SRIKAKULAM,Meilaputti,KERASINGI,58,850,34,942,46,557,13,616,594,3157,48512,379,52048,27197,13,269,0,282
9665,SRIKAKULAM,Meilaputti,KOSAMALA,10,2,317,329,5,2,233,240,226,394,127,16938,17459,13304,1,0,67,68
9666,SRIKAKULAM,Meilaputti,MARADIKOTA,11,118,161,290,5,98,88,191,211,106,7340,4294,11740,7754,0,35,10,45
9667,SRIKAKULAM,Meilaputti,MARRIPADU (C),27,101,272,400,24,90,227,341,342,2373,9234,19452,31059,21832,16,72,91,179
9668,SRIKAKULAM,Meilaputti,MARRIPADU (K),15,92,276,383,14,75,201,290,298,1096,7049,16443,24588,16884,6,41,83,130
9669,SRIKAKULAM,Meilaputti,MEILAPUTTI,66,14,318,398,47,10,224,281,265,3770,949,18718,23437,19954,19,5,75,99
9670,SRIKAKULAM,Meilaputti,MUKTHAPURAM,53,16,266,335,31,10,129,170,161,3099,952,12635,16686,10049,21,4,65,90
9671,SRIKAKULAM,Meilaputti,NADASANDRA,23,2,160,185,11,0,81,92,60,1275,0,8680,9955,4977,10,0,68,78
9672,SRIKAKULAM,Meilaputti,PADDA,15,231,189,435,8,170,145,323,347,511,14612,10251,25374,16298,2,88,45,135
9673,SRIKAKULAM,Meilaputti,PARUSHURAMAPURAM,64,400,62,526,34,307,27,368,401,2770,23232,1666,27668,15868,15,114,3,132
9674,SRIKAKULAM,Meilaputti,PATTUPURAM,0,33,180,213,0,28,158,186,196,0,3310,13334,16644,11919,0,27,71,98
9675,SRIKAKULAM,Meilaputti,PEDALAXMIPURAM,7,0,192,199,2,0,150,152,147,210,0,13163,13373,9172,1,0,83,84
9676,SRIKAKULAM,Meilaputti,PEDDAPADMAPURAM,19,65,346,430,13,48,201,262,229,658,4315,12221,17194,11987,1,25,43,69
9677,SRIKAKULAM,Meilaputti,RATTINI,77,0,90,167,63,0,69,132,128,4288,0,4750,9038,6236,14,0,15,29
9678,SRIKAKULAM,Meilaputti,SANTHALAXMIPURAM,13,61,368,442,8,46,292,346,303,790,4550,28244,33584,20623,6,32,197,235
9679,SRIKAKULAM,Meilaputti,SEKHARAPURAM,32,0,155,187,25,0,117,142,129,2053,0,8882,10935,6823,8,0,27,35
9680,SRIKAKULAM,Meilaputti,SIRIAKHANDI,17,0,180,197,11,0,132,143,137,1144,0,10029,11173,8318,9,0,55,64
9681,SRIKAKULAM,Meilaputti,SUNDARADA,2,104,148,254,0,81,91,172,155,0,5812,6468,12280,7876,0,28,27,55
9682,SRIKAKULAM,Meilaputti,VASANDARA,25,1,291,317,17,0,146,163,168,908,0,8326,9234,7161,0,0,11,11
9683,SRIKAKULAM,Meilaputti,VENKATAPURAM,7,570,56,633,3,396,35,434,436,151,28215,1999,30365,17915,0,90,6,96
9684,SRIKAKULAM,Nandigam,ANANDAPURAM,44,0,343,387,27,0,216,243,184,1107,0,11089,12196,7321,1,0,11,12
9685,SRIKAKULAM,Nandigam,ANNAPURAM,1,84,142,227,0,31,64,95,72,0,657,3708,4365,2038,0,0,5,5
9686,SRIKAKULAM,Nandigam,BADAGAM,71,63,476,610,40,42,258,340,303,2960,2244,18446,23650,13589,10,4,53,67
9687,SRIKAKULAM,Nandigam,BEJJIPALLE,79,0,216,295,43,0,130,173,146,3143,0,9263,12406,7198,11,0,30,41
9688,SRIKAKULAM,Nandigam,BORUBHADRA,3,5,332,340,1,1,250,252,206,15,23,17262,17300,10454,0,0,58,58
9689,SRIKAKULAM,Nandigam,DEENABANDUPURAM,25,0,286,311,17,0,135,152,142,533,0,4792,5325,3326,0,0,0,0
9690,SRIKAKULAM,Nandigam,DEVALABHADRA,103,2,275,380,81,2,211,294,270,4708,84,8439,13231,7349,5,0,0,5
9691,SRIKAKULAM,Nandigam,DEVUPURAM,13,8,511,532,10,6,339,355,306,613,281,19420,20314,12141,0,0,25,25
9692,SRIKAKULAM,Nandigam,DIMIDIJOLA,20,47,349,416,7,41,211,259,221,263,2557,6792,9612,5155,0,3,0,3
9693,SRIKAKULAM,Nandigam,DIMILADA,37,0,323,360,29,0,204,233,191,1252,0,10104,11356,5806,0,0,3,3
9694,SRIKAKULAM,Nandigam,GOLLAVOORU,28,68,120,216,21,62,85,168,160,1428,3905,5923,11256,6244,5,10,24,39
9695,SRIKAKULAM,Nandigam,HARIDASUPURAM,69,1,347,417,43,0,197,240,209,3267,0,12839,16106,11241,15,0,35,50
9696,SRIKAKULAM,Nandigam,HARSHABADA,34,263,178,475,27,185,132,344,318,1828,11400,8104,21332,11049,8,44,25,77
9697,SRIKAKULAM,Nandigam,KANITHIVOORU,3,0,342,345,1,0,220,221,207,13,0,10991,11004,8785,0,0,16,16
9698,SRIKAKULAM,Nandigam,KARLAPUDI,30,0,288,318,16,0,195,211,173,489,0,5503,5992,2919,0,0,5,5
9699,SRIKAKULAM,Nandigam,KAVITI,15,1,414,430,9,0,331,340,365,596,0,21356,21952,15143,1,0,25,26
9700,SRIKAKULAM,Nandigam,KHALLADA,52,86,487,625,35,61,307,403,352,2203,4618,14227,21048,11432,8,20,19,47
9701,SRIKAKULAM,Nandigam,KOTHAGRAHARAM,53,11,487,551,31,7,323,361,312,1508,465,17999,19972,13471,1,1,35,37
9702,SRIKAKULAM,Nandigam,LAKHIDASUPURAM,7,0,339,346,6,0,262,268,220,216,0,11291,11507,5953,0,0,0,0
9703,SRIKAKULAM,Nandigam,MARLAPADU,2,0,194,196,2,0,155,157,142,94,0,8012,8106,5509,0,0,4,4
9704,SRIKAKULAM,Nandigam,MONDRAYAVALASA,0,0,387,387,0,0,324,324,300,0,0,24822,24822,13773,0,0,84,84
9705,SRIKAKULAM,Nandigam,NANDIGAM,292,11,891,1194,176,7,535,718,599,7031,393,19776,27200,17368,1,0,3,4
9706,SRIKAKULAM,Nandigam,NARENDRAPURAM,92,0,158,250,62,0,121,183,147,5779,0,6635,12414,6970,30,0,11,41
9707,SRIKAKULAM,Nandigam,NARSIPURAM,92,0,206,298,60,0,144,204,163,3154,0,6325,9479,4869,4,0,3,7
9708,SRIKAKULAM,Nandigam,NOWGAM,65,1,418,484,38,0,260,298,288,2105,0,16836,18941,11963,4,0,48,52
9709,SRIKAKULAM,Nandigam,P.V.PURAM,40,0,257,297,26,0,185,211,204,1183,0,12622,13805,9578,1,0,33,34
9710,SRIKAKULAM,Nandigam,PEDDABANAPURAM,50,0,166,216,45,0,148,193,131,1923,0,9490,11413,6527,2,0,29,31
9711,SRIKAKULAM,Nandigam,PEDDALAVUNIPALLE,88,1,242,331,45,1,137,183,173,2756,48,9011,11815,8062,5,0,26,31
9712,SRIKAKULAM,Nandigam,PEDDATAMARAPALLI,59,7,369,435,16,2,221,239,188,375,71,8384,8830,5263,0,0,0,0
9713,SRIKAKULAM,Nandigam,RADHAJANABODDAPADU,15,166,162,343,12,74,106,192,170,388,1126,2600,4114,2487,0,0,0,0
9714,SRIKAKULAM,Nandigam,RAMPURAM,11,42,187,240,3,32,130,165,143,149,2574,7903,10626,5622,0,14,9,23
9715,SRIKAKULAM,Nandigam,SIVARAMPURAM,20,0,588,608,12,0,414,426,404,490,0,21946,22436,13636,0,0,19,19
9716,SRIKAKULAM,Nandigam,SUBHADRAPURAM,65,0,199,264,53,0,160,213,200,3389,0,12470,15859,9768,13,0,57,70
9717,SRIKAKULAM,Nandigam,SYLADA,112,0,516,628,69,0,418,487,468,3318,0,31003,34321,18473,1,0,96,97
9718,SRIKAKULAM,Nandigam,TEMBURU,28,0,569,597,20,0,325,345,282,1310,0,18127,19437,10299,6,0,31,37
9719,SRIKAKULAM,Nandigam,UYYALAPETA,1,0,150,151,0,0,112,112,103,0,0,7381,7381,4850,0,0,22,22
9720,SRIKAKULAM,Nandigam,VALLABHARAYAPADU,18,0,305,323,15,0,213,228,199,735,0,11105,11840,6156,0,0,2,2
9721,SRIKAKULAM,Narasannapeta,BADAM,34,0,148,182,31,0,76,107,88,2549,0,5642,8191,5085,13,0,22,35
9722,SRIKAKULAM,Narasannapeta,BALASEEMA,38,2,345,385,19,1,183,203,195,1369,65,12492,13926,9431,4,0,46,50
9723,SRIKAKULAM,Narasannapeta,BORIGIVALASA,1,0,353,354,0,0,184,184,186,0,0,14822,14822,13634,0,0,16,16
9724,SRIKAKULAM,Narasannapeta,CHENNAPURAM,44,1,684,729,31,1,391,423,382,2116,67,20134,22317,15141,5,0,18,23
9725,SRIKAKULAM,Narasannapeta,CHIKKALAVALASA,31,0,277,308,18,0,108,126,117,1447,0,9640,11087,6620,7,0,57,64
9726,SRIKAKULAM,Narasannapeta,CHINNABORIGIVALASA,20,0,174,194,18,0,127,145,145,1095,0,9612,10707,9841,1,0,10,11
9727,SRIKAKULAM,Narasannapeta,CHODAVARAM,46,1,280,327,30,0,189,219,196,1154,0,9097,10251,6985,0,0,5,5
9728,SRIKAKULAM,Narasannapeta,DEVADI,49,1,323,373,30,1,198,229,224,877,25,10252,11154,8921,1,0,14,15
9729,SRIKAKULAM,Narasannapeta,GOPALAPENTA,32,0,321,353,22,0,213,235,223,1941,0,9604,11545,7699,9,0,2,11
9730,SRIKAKULAM,Narasannapeta,GOTTIPALLE,46,1,308,355,29,0,212,241,236,2303,0,16954,19257,12898,11,0,71,82
9731,SRIKAKULAM,Narasannapeta,JAMMU,40,2,588,630,24,1,398,423,427,1665,61,30159,31885,26536,3,0,105,108
9732,SRIKAKULAM,Narasannapeta,KAMBAKAYA,30,5,510,545,24,2,384,410,341,2051,162,27022,29235,21012,6,0,51,57
9733,SRIKAKULAM,Narasannapeta,KAMESWARIPETA,49,1,457,507,32,1,257,290,225,1728,38,15619,17385,8367,5,0,42,47
9734,SRIKAKULAM,Narasannapeta,KARAGAM,14,0,768,782,11,0,552,563,532,508,0,24469,24977,18769,0,0,14,14
9735,SRIKAKULAM,Narasannapeta,KILLAM,17,0,221,238,10,0,156,166,150,763,0,10468,11231,7648,4,0,28,32
9736,SRIKAKULAM,Narasannapeta,KOBAGAM,32,0,149,181,28,0,111,139,115,1987,0,8061,10048,5798,9,0,35,44
9737,SRIKAKULAM,Narasannapeta,KOMARTHI,34,2,586,622,10,1,302,313,306,540,39,17295,17874,13745,1,0,24,25
9738,SRIKAKULAM,Narasannapeta,KOTHAPALAVALASA,20,0,341,361,14,0,205,219,207,547,0,9087,9634,6378,0,0,11,11
9739,SRIKAKULAM,Narasannapeta,LUKALAM,7,0,404,411,5,0,225,230,206,210,0,17384,17594,11246,0,0,69,69
9740,SRIKAKULAM,Narasannapeta,MADAPAM,45,0,770,815,29,0,485,514,441,1601,0,28046,29647,18042,2,0,42,44
9741,SRIKAKULAM,Narasannapeta,MAKIVALASA,60,0,447,507,22,0,224,246,251,1307,0,14551,15858,11755,4,0,8,12
9742,SRIKAKULAM,Narasannapeta,MUSIDIGATTU,2,1,303,306,1,1,211,213,208,102,114,18365,18581,11032,1,1,90,92
9743,SRIKAKULAM,Narasannapeta,NADAGAM,10,0,469,479,8,0,274,282,260,470,0,19855,20325,13683,1,0,69,70
9744,SRIKAKULAM,Narasannapeta,NARASANNAPETA,164,3,2035,2202,50,0,859,909,788,1563,0,32362,33925,26453,0,0,20,20
9745,SRIKAKULAM,Narasannapeta,PARASELLI,12,1,379,392,10,1,264,275,244,662,98,19573,20333,12938,1,0,78,79
9746,SRIKAKULAM,Narasannapeta,POTHAYYAVALASA,19,0,237,256,16,0,119,135,115,1142,0,9891,11033,6816,3,0,40,43
9747,SRIKAKULAM,Narasannapeta,RAVULAVALASA,22,12,426,460,15,9,297,321,315,488,155,11637,12280,9595,0,0,1,1
9748,SRIKAKULAM,Narasannapeta,SATYAVARAM (R),3,0,340,343,0,0,205,205,174,0,0,12690,12690,9612,0,0,10,10
9749,SRIKAKULAM,Narasannapeta,SUNDARAPURAM,28,1,251,280,18,0,119,137,110,1003,0,6475,7478,5473,0,0,2,2
9750,SRIKAKULAM,Narasannapeta,TAMARAPALLI,40,1,380,421,22,0,217,239,227,1847,0,18716,20563,17414,10,0,111,121
9751,SRIKAKULAM,Narasannapeta,TELAGAVALASA,42,0,349,391,22,0,160,182,171,1469,0,12793,14262,8842,3,0,60,63
9752,SRIKAKULAM,Narasannapeta,URLAM,115,0,683,798,62,0,363,425,431,4755,0,21382,26137,17060,18,0,48,66
9753,SRIKAKULAM,Narasannapeta,V N PURAM,4,0,354,358,3,0,234,237,247,280,0,16916,17196,11233,2,0,79,81
9754,SRIKAKULAM,Narasannapeta,YARABADA,44,2,492,538,36,2,305,343,360,2417,79,19562,22058,14260,7,0,54,61
9755,SRIKAKULAM,Palakonda,AMPILI,43,0,258,301,2,0,12,14,8,34,0,185,219,92,0,0,0,0
9756,SRIKAKULAM,Palakonda,ANNAVARAM,108,0,156,264,57,0,67,124,127,2443,0,2002,4445,3708,1,0,0,1
9757,SRIKAKULAM,Palakonda,ARADALA,112,0,134,246,69,0,96,165,145,3185,0,5383,8568,5454,6,0,11,17
9758,SRIKAKULAM,Palakonda,ATTALI,62,0,135,197,37,0,96,133,129,2868,0,5355,8223,6103,9,0,11,20
9759,SRIKAKULAM,Palakonda,AVALANGI,49,1,172,222,32,0,128,160,132,840,0,5883,6723,4140,0,0,4,4
9760,SRIKAKULAM,Palakonda,BEJJI,48,1,314,363,34,1,205,240,212,3211,26,16464,19701,13826,19,0,92,111
9761,SRIKAKULAM,Palakonda,BHASURU,69,7,357,433,33,4,223,260,240,2403,221,13425,16049,11934,14,1,35,50
9762,SRIKAKULAM,Palakonda,BUKKURU,104,2,234,340,65,1,170,236,237,3029,36,7546,10611,8478,6,0,9,15
9763,SRIKAKULAM,Palakonda,CHINAMANGALAPURAM,89,1,336,426,63,1,161,225,217,4990,25,5257,10272,7560,25,0,6,31
9764,SRIKAKULAM,Palakonda,CHINTADA,59,6,142,207,41,3,87,131,107,3110,205,4788,8103,5982,16,1,8,25
9765,SRIKAKULAM,Palakonda,DOLAMADA,45,111,220,376,22,53,137,212,189,717,1386,6305,8408,4974,3,2,16,21
9766,SRIKAKULAM,Palakonda,DUGGI,17,5,182,204,13,5,129,147,136,1232,485,10855,12572,8229,8,2,51,61
9767,SRIKAKULAM,Palakonda,GOPALAPURAM,64,4,209,277,0,0,0,0,0,0,0,0,0,0,0,0,0,0
9768,SRIKAKULAM,Palakonda,GOTTAMANGALAPURAM,36,11,447,494,30,6,294,330,322,2158,353,11293,13804,10058,10,1,18,29
9769,SRIKAKULAM,Palakonda,JAMPARAKOTA,22,236,124,382,8,129,59,196,156,441,4372,2697,7510,3954,2,16,12,30
9770,SRIKAKULAM,Palakonda,KONDAPURAM,136,0,315,451,89,0,21,110,94,3263,0,472,3735,2620,5,0,0,5
9771,SRIKAKULAM,Palakonda,L.L.PURAM,93,38,222,353,32,3,96,131,123,1145,63,4336,5544,4209,0,0,3,3
9772,SRIKAKULAM,Palakonda,LUMBURU,107,9,457,573,17,4,189,210,181,111,27,1409,1547,1048,0,0,0,0
9773,SRIKAKULAM,Palakonda,M.SINGU PURAM,83,104,494,681,27,56,257,340,298,1663,4172,10937,16772,10248,4,15,15,34
9774,SRIKAKULAM,Palakonda,NAVAGAM,116,2,179,297,46,0,67,113,111,1428,0,2088,3516,2803,0,0,0,0
9775,SRIKAKULAM,Palakonda,PALAKONDA,142,49,2228,2419,1,0,9,10,6,2,0,68,70,24,0,0,0,0
9776,SRIKAKULAM,Palakonda,PANUKUVALASA,37,3,246,286,21,2,167,190,190,613,60,7616,8289,5568,1,0,10,11
9777,SRIKAKULAM,Palakonda,PEDAKOTIPALLE,43,67,211,321,17,48,101,166,128,685,1706,4735,7126,3952,0,1,8,9
9778,SRIKAKULAM,Palakonda,POTLI,65,1,276,342,49,1,142,192,189,2806,52,9276,12134,8997,6,0,24,30
9779,SRIKAKULAM,Palakonda,SINGANNAVALASA,109,28,267,404,79,21,189,289,268,3446,1028,8314,12788,9297,5,0,8,13
9780,SRIKAKULAM,Palakonda,T.K.RAJAPURAM,43,16,116,175,20,9,76,105,100,1189,550,4611,6350,5416,3,1,11,15
9781,SRIKAKULAM,Palakonda,TAMPATAPALLE,226,42,404,672,106,13,212,331,327,7297,711,12967,20975,16429,34,1,22,57
9782,SRIKAKULAM,Palakonda,TUMMARADA,94,1,270,365,50,1,140,191,169,3625,94,9627,13346,9789,15,0,39,54
9783,SRIKAKULAM,Palakonda,V.P.RAJUPETA,33,3,140,176,14,1,68,83,78,66,2,409,477,318,0,0,0,0
9784,SRIKAKULAM,Palakonda,VATAPAGU,75,7,376,458,50,5,240,295,266,3019,368,13168,16555,12199,7,2,31,40
9785,SRIKAKULAM,Palakonda,VELAGAVADA,112,69,422,603,78,49,283,410,373,4780,2496,16073,23349,15640,15,3,36,54
9786,SRIKAKULAM,Palakonda,VONI,72,106,204,382,42,62,124,228,219,1045,1841,5633,8519,6174,0,0,7,7
9787,SRIKAKULAM,Palakonda,YERAKARAYAPURAM,36,5,202,243,29,3,87,119,124,1752,158,1973,3883,3231,5,0,1,6
9788,SRIKAKULAM,Palasa,ALLUKOLA,8,81,182,271,5,46,122,173,155,389,1365,11199,12953,8517,1,0,53,54
9789,SRIKAKULAM,Palasa,AMALAKUDIYA,5,0,290,295,4,0,212,216,186,249,0,17059,17308,11347,0,0,79,79
9790,SRIKAKULAM,Palasa,BANTUKOTTURU,43,0,345,388,39,0,278,317,309,3634,0,24125,27759,18822,24,0,130,154
9791,SRIKAKULAM,Palasa,BODDAPADU,23,0,528,551,15,0,353,368,353,440,0,21262,21702,15941,0,0,46,46
9792,SRIKAKULAM,Palasa,BRAHMANTRALA,63,0,407,470,38,0,258,296,298,2630,0,15230,17860,14808,11,0,26,37
9793,SRIKAKULAM,Palasa,CHINANCHALA,39,7,489,535,33,5,402,440,419,3133,591,36803,40527,26463,18,5,214,237
9794,SRIKAKULAM,Palasa,GARUDAKHANDI,15,1,244,260,8,1,188,197,181,357,20,9373,9750,6861,1,0,21,22
9795,SRIKAKULAM,Palasa,GURUDASU PURAM,0,0,303,303,0,0,180,180,157,0,0,10078,10078,7292,0,0,21,21
9796,SRIKAKULAM,Palasa,KEDARIPURAM,31,1,479,511,24,0,398,422,383,2069,0,36278,38347,23338,9,0,188,197
9797,SRIKAKULAM,Palasa,LAXMIPURAM,7,0,255,262,2,0,184,186,157,87,0,9431,9518,6996,0,0,11,11
9798,SRIKAKULAM,Palasa,LODDABADRA,4,49,709,762,0,35,277,312,311,0,1487,15631,17118,12209,0,2,58,60
9799,SRIKAKULAM,Palasa,LUTHURU,1,357,9,367,0,167,0,167,157,0,6871,0,6871,3497,0,10,0,10
9800,SRIKAKULAM,Palasa,MAKANNAPALLI,9,0,255,264,1,0,214,215,187,54,0,15619,15673,11849,0,0,74,74
9801,SRIKAKULAM,Palasa,MAMIDIMETTU,5,0,263,268,2,0,133,135,132,127,0,3392,3519,3411,1,0,2,3
9802,SRIKAKULAM,Palasa,NEELAVATHI,0,0,337,337,0,0,243,243,201,0,0,20032,20032,13212,0,0,108,108
9803,SRIKAKULAM,Palasa,PEDANCHALA,12,20,362,394,9,18,309,336,336,698,1481,23709,25888,17569,2,8,112,122
9804,SRIKAKULAM,Palasa,RENTIKOTA,24,2,572,598,4,2,399,405,381,85,34,17137,17256,12138,0,0,18,18
9805,SRIKAKULAM,Palasa,TARLAKOTA,20,232,181,433,2,188,119,309,299,170,8294,6834,15298,9873,0,21,7,28
9806,SRIKAKULAM,Palasa,TEKKALI PATNAM,45,35,420,500,28,24,294,346,319,2824,2210,18972,24006,14483,19,14,64,97
9807,SRIKAKULAM,Pathapatnam,A S KAVITI,110,196,125,431,76,102,42,220,217,2850,2507,973,6330,4653,0,2,0,2
9808,SRIKAKULAM,Pathapatnam,BADDUMARRI,87,399,237,723,47,215,107,369,361,3015,10075,5949,19039,11585,6,11,11,28
9809,SRIKAKULAM,Pathapatnam,BOORAGAM,7,0,328,335,1,0,209,210,202,3,0,12496,12499,11531,0,0,6,6
9810,SRIKAKULAM,Pathapatnam,BORUBHADRA,26,1,248,275,16,1,162,179,138,1086,67,9783,10936,6893,2,0,21,23
9811,SRIKAKULAM,Pathapatnam,CHAKIPALLI,3,61,119,183,1,17,74,92,85,49,344,3334,3727,3011,0,0,3,3
9812,SRIKAKULAM,Pathapatnam,CHANGUDI,17,2,119,138,11,1,99,111,103,608,48,4556,5212,4132,2,0,3,5
9813,SRIKAKULAM,Pathapatnam,CHINAMALLIPURAM,66,106,162,334,50,78,95,223,198,3472,5613,5966,15051,8900,13,22,15,50
9814,SRIKAKULAM,Pathapatnam,DASARDHAPURAM,55,0,45,100,47,0,26,73,77,3432,0,834,4266,2895,8,0,0,8
9815,SRIKAKULAM,Pathapatnam,GANGUVADA,38,369,312,719,16,250,143,409,391,1107,10689,5407,17203,11420,6,20,5,31
9816,SRIKAKULAM,Pathapatnam,GURANDI,67,129,121,317,46,96,58,200,182,3717,7207,4317,15241,8059,16,28,17,61
9817,SRIKAKULAM,Pathapatnam,KAGUVADA,10,0,402,412,1,0,260,261,230,20,0,19376,19396,15557,0,0,76,76
9818,SRIKAKULAM,Pathapatnam,KODURU,70,133,62,265,47,109,23,179,160,2431,7436,293,10160,6502,5,24,0,29
9819,SRIKAKULAM,Pathapatnam,KORSAVADA,46,0,481,527,24,0,360,384,355,899,0,19994,20893,17829,1,0,57,58
9820,SRIKAKULAM,Pathapatnam,PATHAPATNAM,248,32,1165,1445,126,3,398,527,510,6857,48,18780,25685,21200,13,0,23,36
9821,SRIKAKULAM,Pathapatnam,PEDALAXMIPURAM,48,1,211,260,36,1,155,192,175,2634,89,11379,14102,8993,13,0,44,57
9822,SRIKAKULAM,Pathapatnam,PEDAMALLIPURAM,2,13,146,161,0,11,74,85,75,0,416,4224,4640,3339,0,0,6,6
9823,SRIKAKULAM,Pathapatnam,PEDDALOGIDI,24,70,407,501,8,39,248,295,256,311,1695,14012,16018,12394,0,2,22,24
9824,SRIKAKULAM,Pathapatnam,PEDDASARIAPALLI,26,0,197,223,16,0,120,136,126,1123,0,7048,8171,5723,4,0,14,18
9825,SRIKAKULAM,Pathapatnam,PEDDASUNNAPURAM,5,110,2,117,2,78,0,80,80,212,5431,0,5643,3813,2,28,0,30
9826,SRIKAKULAM,Pathapatnam,PHASIGANGAPETA,85,39,158,282,66,26,84,176,156,5346,959,6431,12736,8331,32,0,28,60
9827,SRIKAKULAM,Pathapatnam,RANKINI,87,224,48,359,43,149,29,221,200,2092,7504,1261,10857,6746,1,18,2,21
9828,SRIKAKULAM,Pathapatnam,ROMADALA,0,1,198,199,0,1,129,130,111,0,111,9107,9218,6327,0,1,33,34
9829,SRIKAKULAM,Pathapatnam,ROMPIVALASA,105,0,236,341,31,0,123,154,145,2196,0,7706,9902,6961,7,0,29,36
9830,SRIKAKULAM,Pathapatnam,ROUTUPURAM,84,52,317,453,58,14,172,244,229,2757,610,7674,11041,7395,4,0,9,13
9831,SRIKAKULAM,Pathapatnam,SARALI,37,0,110,147,32,0,80,112,81,2208,0,5091,7299,5503,12,0,21,33
9832,SRIKAKULAM,Pathapatnam,SAVARASIDDHAMANUGU,1,173,13,187,0,13,0,13,11,0,322,0,322,152,0,0,0,0
9833,SRIKAKULAM,Pathapatnam,SEEDI,38,2,421,461,9,1,242,252,220,565,4,18549,19118,13836,1,0,86,87
9834,SRIKAKULAM,Pathapatnam,SEETHARAMPALLY,13,0,244,257,11,0,185,196,177,764,0,14047,14811,12249,3,0,69,72
9835,SRIKAKULAM,Pathapatnam,SINGUPURAM,76,217,320,613,51,153,217,421,363,3741,9178,12607,25526,14166,15,27,27,69
9836,SRIKAKULAM,Pathapatnam,SOBA,6,328,170,504,4,120,83,207,196,301,8564,5853,14718,9515,1,41,19,61
9837,SRIKAKULAM,Pathapatnam,THAMARA,33,0,144,177,26,0,116,142,132,1572,0,7744,9316,7056,5,0,34,39
9838,SRIKAKULAM,Pathapatnam,THEEMARA,62,0,108,170,50,0,71,121,98,2342,0,2223,4565,2910,3,0,0,3
9839,SRIKAKULAM,Pathapatnam,THEMBURU,70,106,264,440,14,79,157,250,226,120,2792,5156,8068,5572,0,7,5,12
9840,SRIKAKULAM,Pathapatnam,TIDDIMI,58,36,320,414,44,32,212,288,249,4087,2311,14771,21169,12245,23,10,45,78
9841,SRIKAKULAM,Polaki,AMPALAM,42,2,693,737,33,2,503,538,522,3307,130,33727,37164,22137,24,0,139,163
9842,SRIKAKULAM,Polaki,BALAMARAPOLAVALASA,7,5,645,657,5,4,515,524,523,476,329,37704,38509,20539,3,1,101,105
9843,SRIKAKULAM,Polaki,BODDAM,1,0,562,563,1,0,477,478,473,61,0,28897,28958,15406,0,0,36,36
9844,SRIKAKULAM,Polaki,CHALLAYAVALASA,7,2,649,658,7,2,533,542,512,344,81,29915,30340,18001,0,0,38,38
9845,SRIKAKULAM,Polaki,CHEEDIVALASA,74,0,906,980,43,0,598,641,629,2366,0,34979,37345,21466,6,0,39,45
9846,SRIKAKULAM,Polaki,DANDALAKSHMIPURAM,30,0,461,491,24,0,376,400,387,1643,0,23277,24920,15803,3,0,41,44
9847,SRIKAKULAM,Polaki,DEERGHASI,24,0,729,753,15,0,511,526,482,747,0,22927,23674,17263,0,0,12,12
9848,SRIKAKULAM,Polaki,DOLA,26,1,391,418,21,1,338,360,339,1783,39,21410,23232,14823,9,0,52,61
9849,SRIKAKULAM,Polaki,EDDULAVALASA,20,2,523,545,15,0,360,375,374,901,0,22134,23035,18637,1,0,37,38
9850,SRIKAKULAM,Polaki,GANGIVALASA,5,1,363,369,5,0,228,233,245,229,0,13449,13678,8551,1,0,17,18
9851,SRIKAKULAM,Polaki,GATHALAVALASA,49,0,741,790,44,0,549,593,552,2531,0,30088,32619,19382,8,0,47,55
9852,SRIKAKULAM,Polaki,GOLLALAVALASA,42,0,460,502,35,0,355,390,368,2022,0,24440,26462,18520,2,0,58,60
9853,SRIKAKULAM,Polaki,GUPPIDIPETA,11,2,651,664,10,2,520,532,530,469,194,29247,29910,18762,0,1,8,9
9854,SRIKAKULAM,Polaki,JADURU,26,1,372,399,20,1,285,306,279,1496,39,19372,20907,13953,3,0,62,65
9855,SRIKAKULAM,Polaki,KODURU,5,2,404,411,4,2,300,306,283,254,175,20908,21337,13780,0,0,45,45
9856,SRIKAKULAM,Polaki,KOTTAREVU,7,5,696,708,5,4,579,588,613,363,371,36703,37437,23023,2,1,99,102
9857,SRIKAKULAM,Polaki,KUSUMPOLAVALASA,6,0,364,370,5,0,324,329,328,448,0,31653,32101,18848,2,0,198,200
9858,SRIKAKULAM,Polaki,MAGATAPADU,1,0,471,472,0,0,329,329,305,0,0,12881,12881,8581,0,0,0,0
9859,SRIKAKULAM,Polaki,MOBAGAM,70,7,774,851,54,4,456,514,460,2080,122,14533,16735,9829,4,0,6,10
9860,SRIKAKULAM,Polaki,PALLIPETA,16,0,398,414,13,0,332,345,339,533,0,16905,17438,10490,0,0,35,35
9861,SRIKAKULAM,Polaki,PIRUVADA,35,0,422,457,29,0,336,365,334,1826,0,20765,22591,13419,5,0,34,39
9862,SRIKAKULAM,Polaki,POLAKI,70,4,1084,1158,56,3,756,815,793,3107,38,23026,26171,17134,9,0,6,15
9863,SRIKAKULAM,Polaki,PRIYAGRAHARAM,11,1,834,846,9,0,649,658,623,531,0,45287,45818,25783,1,0,103,104
9864,SRIKAKULAM,Polaki,RAHIMANPURAM,68,0,591,659,63,0,445,508,465,5070,0,24774,29844,16960,27,0,45,72
9865,SRIKAKULAM,Polaki,RAJAPURAM,0,0,286,286,0,0,246,246,260,0,0,21065,21065,12670,0,0,99,99
9866,SRIKAKULAM,Polaki,RALLAPADU,1,12,328,341,0,10,246,256,226,0,625,13790,14415,9473,0,2,28,30
9867,SRIKAKULAM,Polaki,S.L.PURAM,0,0,222,222,0,0,165,165,147,0,0,12820,12820,8384,0,0,46,46
9868,SRIKAKULAM,Polaki,SUSARAM,1,0,432,433,1,0,366,367,316,54,0,22718,22772,13445,0,0,35,35
9869,SRIKAKULAM,Polaki,TALASAMUDRAM,40,0,580,620,33,0,399,432,314,2052,0,16906,18958,10535,3,0,27,30
9870,SRIKAKULAM,Polaki,URJAM,60,0,362,422,58,0,294,352,319,3687,0,19006,22693,14243,9,0,30,39
9871,SRIKAKULAM,Polaki,VANITHA MANDALAM,16,0,433,449,8,0,338,346,330,122,0,8587,8709,5054,0,0,0,0
9872,SRIKAKULAM,Ponduru,ATCHIPOLAVALASA,59,0,424,483,45,0,247,292,276,2145,0,6695,8840,5157,1,0,0,1
9873,SRIKAKULAM,Ponduru,BANAM,179,6,480,665,134,4,279,417,428,7423,270,10253,17946,10244,15,1,26,42
9874,SRIKAKULAM,Ponduru,BODDIPALLE,15,0,242,257,13,0,191,204,205,881,0,11516,12397,7213,4,0,16,20
9875,SRIKAKULAM,Ponduru,BURIDIKANCHARAM,75,1,911,987,68,1,712,781,804,3727,26,37165,40918,22316,5,0,18,23
9876,SRIKAKULAM,Ponduru,DALLAVALASA,61,0,579,640,36,0,361,397,390,1136,0,13516,14652,9030,1,0,2,3
9877,SRIKAKULAM,Ponduru,DALLIPETA,17,0,571,588,11,0,365,376,395,450,0,14867,15317,11731,0,0,4,4
9878,SRIKAKULAM,Ponduru,DHARMAPURAM,52,0,506,558,44,0,330,374,354,667,0,5942,6609,3598,0,0,0,0
9879,SRIKAKULAM,Ponduru,GOKARNAPALLE,15,0,394,409,0,0,1,1,1,0,0,20,20,10,0,0,0,0
9880,SRIKAKULAM,Ponduru,GORINTA,16,0,260,276,11,0,164,175,169,187,0,3105,3292,1689,0,0,0,0
9881,SRIKAKULAM,Ponduru,KANIMETTA,75,0,784,859,33,0,504,537,504,788,0,12019,12807,8018,0,0,0,0
9882,SRIKAKULAM,Ponduru,KESAVADASUPURAM,134,0,168,302,99,0,131,230,223,8225,0,9526,17751,11858,34,0,47,81
9883,SRIKAKULAM,Ponduru,KINTHALI,29,0,940,969,20,0,599,619,569,465,0,17117,17582,11426,0,0,1,1
9884,SRIKAKULAM,Ponduru,KONCHADA,150,1,522,673,91,1,300,392,351,5950,67,14373,20390,14466,14,0,14,28
9885,SRIKAKULAM,Ponduru,KOTIPALLE,22,0,518,540,18,0,423,441,407,1230,0,23924,25154,13878,1,0,16,17
9886,SRIKAKULAM,Ponduru,KRISHNAPURAM,21,0,483,504,17,0,296,313,333,719,0,17205,17924,11943,1,0,27,28
9887,SRIKAKULAM,Ponduru,LAIDAM,81,0,502,583,46,0,221,267,266,323,0,2661,2984,1681,0,0,0,0
9888,SRIKAKULAM,Ponduru,LOLUGU,81,0,1077,1158,47,0,555,602,521,3080,0,27234,30314,21720,8,0,25,33
9889,SRIKAKULAM,Ponduru,MALAKAM,56,1,374,431,45,0,268,313,312,3280,0,21288,24568,14660,13,0,122,135
9890,SRIKAKULAM,Ponduru,MODDALAVALASA,19,0,291,310,17,0,223,240,213,279,0,3672,3951,2284,0,0,0,0
9891,SRIKAKULAM,Ponduru,NANDIVADA,100,0,853,953,57,0,364,421,389,3181,0,20328,23509,14507,7,0,47,54
9892,SRIKAKULAM,Ponduru,PENUBARTHI,43,1,367,411,25,1,254,280,249,351,21,4717,5089,3130,0,0,0,0
9893,SRIKAKULAM,Ponduru,PILLALAVALASA,2,0,354,356,2,0,265,267,252,71,0,9093,9164,4446,0,0,1,1
9894,SRIKAKULAM,Ponduru,PONDURU,151,37,1441,1629,110,0,772,882,798,6150,0,31812,37962,24369,3,0,7,10
9895,SRIKAKULAM,Ponduru,RAPAKA,164,1,1430,1595,75,0,601,676,619,4027,0,13406,17433,12199,5,0,0,5
9896,SRIKAKULAM,Ponduru,TADIVALASA,42,2,789,833,31,1,402,434,359,485,9,4644,5138,3073,0,0,0,0
9897,SRIKAKULAM,Ponduru,THANDYAM,89,28,692,809,58,27,458,543,535,2715,1541,19564,23820,13823,3,4,7,14
9898,SRIKAKULAM,Ponduru,THOLAPI,38,0,761,799,31,0,466,497,447,718,0,11574,12292,7757,0,0,0,0
9899,SRIKAKULAM,Ponduru,TUNGAPETA,2,0,224,226,0,0,133,133,113,0,0,1222,1222,620,0,0,0,0
9900,SRIKAKULAM,Ponduru,V.R.GUDEM,14,0,437,451,0,0,2,2,2,0,0,28,28,12,0,0,0,0
9901,SRIKAKULAM,Rajam,AGURU,82,1,587,670,69,1,448,518,510,5339,54,28372,33765,21242,26,0,96,122
9902,SRIKAKULAM,Rajam,ANTHAKAPALLI,68,12,675,755,48,9,440,497,493,3389,646,21347,25382,20364,10,1,16,27
9903,SRIKAKULAM,Rajam,BODDAM,112,27,696,835,58,16,487,561,558,5026,1048,34827,40901,32364,27,0,144,171
9904,SRIKAKULAM,Rajam,BOMMINAIDU VALASA,42,2,423,467,38,2,324,364,368,3072,207,23951,27230,18931,19,1,86,106
9905,SRIKAKULAM,Rajam,D.R.N.VALASA,113,4,566,683,94,1,367,462,479,9199,116,28294,37609,32082,64,1,41,106
9906,SRIKAKULAM,Rajam,G.CHEEPURUPALLI,65,0,475,540,55,0,363,418,424,5118,0,26898,32016,25714,37,0,114,151
9907,SRIKAKULAM,Rajam,GUDDIMUDIDAM,107,0,698,805,77,0,378,455,396,3442,0,17586,21028,13483,3,0,9,12
9908,SRIKAKULAM,Rajam,GURAVAM,210,6,504,720,122,1,253,376,361,6684,109,14010,20803,18067,11,1,19,31
9909,SRIKAKULAM,Rajam,KANCHARAM,174,4,1105,1283,103,0,579,682,665,5970,0,33775,39745,27708,17,0,87,104
9910,SRIKAKULAM,Rajam,KOTARIPURAM,0,0,352,352,0,0,280,280,290,0,0,19462,19462,15524,0,0,59,59
9911,SRIKAKULAM,Rajam,MAREDUBAKA,99,35,297,431,72,28,215,315,280,4367,2525,14850,21742,13737,11,17,44,72
9912,SRIKAKULAM,Rajam,MUDDADAJOGI VALASA,35,0,462,497,25,0,290,315,285,2335,0,17153,19488,13128,18,0,44,62
9913,SRIKAKULAM,Rajam,NANDABALAGA,38,4,432,474,19,3,260,282,270,1533,176,14019,15728,10936,6,0,27,33
9914,SRIKAKULAM,Rajam,OMMI,66,0,626,692,45,0,410,455,422,3477,0,20589,24066,16731,13,0,27,40
9915,SRIKAKULAM,Rajam,PENUBAKA,115,14,629,758,86,5,270,361,320,6420,291,20750,27461,19953,33,0,80,113
9916,SRIKAKULAM,Rajam,POGIRI,120,1,1655,1776,82,0,931,1013,1047,5104,0,34400,39504,23923,14,0,13,27
9917,SRIKAKULAM,Rajam,RAJAYYAPETA,17,23,649,689,10,17,347,374,406,572,1161,20697,22430,16210,1,2,21,24
9918,SRIKAKULAM,Rajam,SOPERU,214,0,127,341,172,0,91,263,244,11942,0,5937,17879,12144,33,0,20,53
9919,SRIKAKULAM,Rajam,SYAMPURAM,111,0,536,647,90,0,348,438,434,6207,0,23221,29428,21513,18,0,54,72
9920,SRIKAKULAM,Rajam,V.R.AGRAHARAM,63,0,229,292,47,0,154,201,192,3687,0,10178,13865,10519,15,0,29,44
9921,SRIKAKULAM,Ranastalam,ALLIVALASA,0,0,540,540,0,0,116,116,110,0,0,939,939,893,0,0,0,0
9922,SRIKAKULAM,Ranastalam,ARJUNAVALASA,68,2,500,570,59,1,392,452,467,4571,85,30050,34706,22560,12,0,99,111
9923,SRIKAKULAM,Ranastalam,BANTUPALLE,232,4,381,617,149,0,216,365,325,9623,0,12028,21651,16579,17,0,13,30
9924,SRIKAKULAM,Ranastalam,CH.RAJAM,31,3,773,807,23,1,469,493,480,648,62,21972,22682,11906,0,0,6,6
9925,SRIKAKULAM,Ranastalam,DERASAM,64,2,480,546,48,0,333,381,355,4168,0,17480,21648,15104,16,0,3,19
9926,SRIKAKULAM,Ranastalam,J.R.PURAM,71,1,566,638,41,1,351,393,357,1945,55,13908,15908,11067,2,0,3,5
9927,SRIKAKULAM,Ranastalam,JEERUPELEM,0,0,616,616,0,0,165,165,169,0,0,2757,2757,2618,0,0,0,0
9928,SRIKAKULAM,Ranastalam,KAMMASIGADAM,177,3,224,404,142,0,168,310,273,11074,0,13842,24916,13865,48,0,65,113
9929,SRIKAKULAM,Ranastalam,KONDAMULAGAM,142,5,706,853,98,3,523,624,579,4331,79,20018,24428,16212,2,0,1,3
9930,SRIKAKULAM,Ranastalam,KOSTA,91,10,461,562,64,2,372,438,418,4417,126,19568,24111,18432,13,0,22,35
9931,SRIKAKULAM,Ranastalam,KOTAPALEM,66,2,570,638,54,2,382,438,407,3290,222,22898,26410,17765,6,1,44,51
9932,SRIKAKULAM,Ranastalam,KOTCHERLA,19,0,899,918,15,0,508,523,523,759,0,26477,27236,19454,2,0,39,41
9933,SRIKAKULAM,Ranastalam,KOVVADAMATCHILASAM,0,0,824,824,0,0,480,480,484,0,0,13633,13633,11623,0,0,0,0
9934,SRIKAKULAM,Ranastalam,KRISHNAPURAM,89,0,656,745,86,0,560,646,627,7947,0,54797,62744,34576,47,0,279,326
9935,SRIKAKULAM,Ranastalam,MAHANTHIPALEM,22,0,271,293,21,0,250,271,287,1663,0,21618,23281,12021,10,0,90,100
9936,SRIKAKULAM,Ranastalam,MARUVADA,135,0,253,388,92,0,185,277,229,5482,0,10218,15700,8012,5,0,1,6
9937,SRIKAKULAM,Ranastalam,N.G.R.PURAM,1,0,522,523,0,0,348,348,329,0,0,22037,22037,18067,0,0,41,41
9938,SRIKAKULAM,Ranastalam,NARUVA,172,1,958,1131,91,1,605,697,654,6753,10,43680,50443,33123,22,0,122,144
9939,SRIKAKULAM,Ranastalam,PATHARLAPALLE,178,0,1132,1310,137,0,821,958,947,10299,0,50106,60405,36105,39,0,61,100
9940,SRIKAKULAM,Ranastalam,PISHINI,77,0,1022,1099,69,0,808,877,856,4194,0,39570,43764,29412,9,0,42,51
9941,SRIKAKULAM,Ranastalam,PYDIBHIMAVARAM,324,7,1015,1346,256,1,674,931,850,12918,12,33455,46385,30803,17,0,42,59
9942,SRIKAKULAM,Ranastalam,RANASTALAM,255,2,1299,1556,177,1,903,1081,1037,9553,17,37946,47516,29076,16,0,16,32
9943,SRIKAKULAM,Ranastalam,RAVADA,147,1,751,899,113,0,590,703,685,2777,0,26921,29698,18788,0,0,22,22
9944,SRIKAKULAM,Ranastalam,SANCHAM,82,0,855,937,59,0,654,713,672,2712,0,26002,28714,18610,0,0,10,10
9945,SRIKAKULAM,Ranastalam,THEPPALAVALASA,379,4,726,1109,249,3,506,758,703,18225,139,33499,51863,32646,69,0,112,181
9946,SRIKAKULAM,Ranastalam,TIRUPATIPALEM,63,0,288,351,32,0,201,233,188,2558,0,15894,18452,10638,6,0,53,59
9947,SRIKAKULAM,Ranastalam,V.N.PURAM,4,0,590,594,1,0,450,451,409,64,0,33677,33741,19157,0,0,110,110
9948,SRIKAKULAM,Ranastalam,VALLADHARAOPETA,44,2,440,486,33,1,365,399,394,2815,57,25713,28585,19617,14,0,76,90
9949,SRIKAKULAM,Ranastalam,VELPURAI,57,2,744,803,42,2,583,627,573,3808,72,40168,44048,27642,26,0,142,168
9950,SRIKAKULAM,Ranastalam,YERRAVARAM,292,0,255,547,266,0,212,478,434,19962,0,16521,36483,18703,60,0,61,121
9951,SRIKAKULAM,Regidiamadalavalasa,ADAVARAM,31,0,192,223,26,0,113,139,120,1357,0,6247,7604,3857,0,0,2,2
9952,SRIKAKULAM,Regidiamadalavalasa,AMADALAVALASA,94,12,362,468,65,10,224,299,288,3284,501,8938,12723,9561,4,0,6,10
9953,SRIKAKULAM,Regidiamadalavalasa,AMBADA,74,4,494,572,61,3,356,420,433,3373,246,20063,23682,17129,10,1,60,71
9954,SRIKAKULAM,Regidiamadalavalasa,AMBAKHANDI,43,0,663,706,38,0,555,593,637,2250,0,25230,27480,16989,3,0,10,13
9955,SRIKAKULAM,Regidiamadalavalasa,APPAPURAM,37,0,272,309,22,0,148,170,173,1893,0,9585,11478,9001,10,0,26,36
9956,SRIKAKULAM,Regidiamadalavalasa,BURADA,55,5,421,481,43,4,272,319,282,2052,120,13834,16006,9401,4,0,19,23
9957,SRIKAKULAM,Regidiamadalavalasa,CHATAYYAVALASA,19,1,251,271,18,1,212,231,213,1504,43,17436,18983,12625,5,0,73,78
9958,SRIKAKULAM,Regidiamadalavalasa,CHELI GANI VALASA,17,0,66,83,5,0,9,14,11,45,0,85,130,61,0,0,0,0
9959,SRIKAKULAM,Regidiamadalavalasa,CHINA SIRLAM,78,2,343,423,53,2,218,273,258,728,25,3831,4584,2856,0,0,0,0
9960,SRIKAKULAM,Regidiamadalavalasa,DEVUDALA,96,2,386,484,74,0,220,294,255,4382,0,6203,10585,6296,7,0,5,12
9961,SRIKAKULAM,Regidiamadalavalasa,GULLA PADU,84,3,313,400,52,3,237,292,293,4602,158,12370,17130,10357,23,0,17,40
9962,SRIKAKULAM,Regidiamadalavalasa,KANDISA,76,0,461,537,60,0,333,393,386,2710,0,18771,21481,13313,1,0,27,28
9963,SRIKAKULAM,Regidiamadalavalasa,KHANDYAM,94,14,449,557,79,11,123,213,200,6271,1065,4164,11500,5955,28,7,0,35
9964,SRIKAKULAM,Regidiamadalavalasa,KODISA,83,8,386,477,76,3,254,333,331,6001,52,16138,22191,16146,16,0,33,49
9965,SRIKAKULAM,Regidiamadalavalasa,KOMERA,78,0,365,443,58,0,240,298,287,4959,0,7933,12892,6895,17,0,11,28
9966,SRIKAKULAM,Regidiamadalavalasa,KONDA VALASA,25,3,315,343,19,0,254,273,264,1647,0,19269,20916,14831,8,0,75,83
9967,SRIKAKULAM,Regidiamadalavalasa,KORRALLA VALASA,23,1,302,326,19,1,234,254,239,1601,79,19113,20793,13684,8,0,88,96
9968,SRIKAKULAM,Regidiamadalavalasa,LATCHARAYAPURAM,18,0,396,414,16,0,281,297,270,1376,0,19799,21175,14214,9,0,71,80
9969,SRIKAKULAM,Regidiamadalavalasa,LAXMIPURAM,66,5,484,555,57,1,349,407,409,3748,10,18184,21942,13687,11,0,60,71
9970,SRIKAKULAM,Regidiamadalavalasa,LINGALA VALASA,19,4,476,499,17,2,387,406,379,1481,177,33248,34906,20417,7,0,129,136
9971,SRIKAKULAM,Regidiamadalavalasa,MUNAKALAVALASA,31,0,542,573,19,0,380,399,367,1964,0,15626,17590,10008,13,0,1,14
9972,SRIKAKULAM,Regidiamadalavalasa,NAYURALAVALASA,252,12,419,683,179,10,246,435,440,8406,314,10680,19400,13424,8,0,8,16
9973,SRIKAKULAM,Regidiamadalavalasa,PANASALA VALASA,6,0,215,221,1,0,15,16,17,24,0,260,284,190,0,0,0,0
9974,SRIKAKULAM,Regidiamadalavalasa,PARAMPETA,36,2,396,434,11,0,116,127,121,543,0,6282,6825,4532,1,0,10,11
9975,SRIKAKULAM,Regidiamadalavalasa,PEDA SIRLAM,44,1,427,472,40,1,316,357,388,2850,95,22320,25265,18608,10,0,70,80
9976,SRIKAKULAM,Regidiamadalavalasa,PURLI,47,3,331,381,27,3,246,276,116,601,111,6414,7126,1618,0,0,0,0
9977,SRIKAKULAM,Regidiamadalavalasa,REGADI,56,27,305,388,48,1,74,123,104,901,2,2119,3022,1549,0,0,0,0
9978,SRIKAKULAM,Regidiamadalavalasa,SANKILI,87,5,298,390,8,4,105,117,109,165,276,2429,2870,2088,0,0,1,1
9979,SRIKAKULAM,Regidiamadalavalasa,SARASANA PALLE,86,25,283,394,52,15,197,264,251,3605,945,10967,15517,11286,18,5,39,62
9980,SRIKAKULAM,Regidiamadalavalasa,SOMARAJUPETA,32,0,231,263,23,0,184,207,205,1528,0,13022,14550,10049,4,0,39,43
9981,SRIKAKULAM,Regidiamadalavalasa,THATIPADU,16,0,301,317,11,0,207,218,224,363,0,8792,9155,6066,0,0,4,4
9982,SRIKAKULAM,Regidiamadalavalasa,THOKALAVALASA,66,1,311,378,57,1,238,296,324,3192,38,12916,16146,9733,2,0,8,10
9983,SRIKAKULAM,Regidiamadalavalasa,TUNIVADA,70,17,443,530,54,15,298,367,318,4586,778,20946,26310,16008,30,1,81,112
9984,SRIKAKULAM,Regidiamadalavalasa,UNGARADA,55,0,330,385,42,0,173,215,222,3346,0,9119,12465,8043,20,0,21,41
9985,SRIKAKULAM,Regidiamadalavalasa,UNUKURU,96,23,471,590,64,9,292,365,348,4765,693,22554,28012,21530,19,2,104,125
9986,SRIKAKULAM,Regidiamadalavalasa,VANNALI,50,0,213,263,47,0,168,215,194,4271,0,13741,18012,10037,26,0,63,89
9987,SRIKAKULAM,Regidiamadalavalasa,VAVILA VALASA,25,0,339,364,23,0,236,259,273,1214,0,13737,14951,10621,1,0,33,34
9988,SRIKAKULAM,Regidiamadalavalasa,VENKAMPETA,118,1,380,499,90,0,304,394,398,4610,0,18576,23186,16496,6,0,62,68
9989,SRIKAKULAM,Regidiamadalavalasa,VOPPANGI,68,0,242,310,58,0,210,268,286,4879,0,14374,19253,11617,23,0,47,70
9990,SRIKAKULAM,Santhabommali,AKASALAKKAVARAM,5,0,644,649,1,0,265,266,244,6,0,1225,1231,814,0,0,0,0
9991,SRIKAKULAM,Santhabommali,ARIKIVALASA,27,0,163,190,25,0,156,181,178,2326,0,13498,15824,8205,16,0,75,91
9992,SRIKAKULAM,Santhabommali,BHAVANAPADU(MADYAPETA),1,0,760,761,0,0,630,630,722,0,0,35279,35279,27113,0,0,67,67
9993,SRIKAKULAM,Santhabommali,BORUBHADRA,127,0,742,869,70,0,383,453,453,4664,0,22645,27309,16842,5,0,14,19
9994,SRIKAKULAM,Santhabommali,CHETLATANDRA,2,2,335,339,0,2,250,252,229,0,89,7881,7970,4746,0,0,4,4
9995,SRIKAKULAM,Santhabommali,CHINATUNGAM,56,0,331,387,43,0,223,266,250,2937,0,11077,14014,8953,10,0,8,18
9996,SRIKAKULAM,Santhabommali,DANDUGOPALAPURAM,55,0,351,406,39,0,254,293,233,2979,0,19417,22396,13244,12,0,71,83
9997,SRIKAKULAM,Santhabommali,GOVINDAPURAM,40,1,718,759,38,1,541,580,474,4115,102,40203,44420,26118,28,1,138,167
9998,SRIKAKULAM,Santhabommali,HANUMANTHUNAIDUPETA,2,0,440,442,2,0,351,353,351,147,0,30335,30482,18515,0,0,151,151
9999,SRIKAKULAM,Santhabommali,IJJAVARAM,51,0,195,246,35,0,110,145,114,1203,0,1125,2328,1283,0,0,0,0
10000,SRIKAKULAM,Santhabommali,JAGANNADHAPURAM,0,0,390,390,0,0,311,311,276,0,0,26969,26969,15320,0,0,129,129
10001,SRIKAKULAM,Santhabommali,KAKARAPALLE,35,2,156,193,33,2,126,161,154,1655,89,6365,8109,5189,1,0,2,3
10002,SRIKAKULAM,Santhabommali,KAPUGODEYAVALASA,1,0,273,274,0,0,143,143,118,0,0,5104,5104,3384,0,0,1,1
10003,SRIKAKULAM,Santhabommali,KASPANAUPADA,7,2,966,975,3,0,525,528,530,265,0,33894,34159,19535,1,0,64,65
10004,SRIKAKULAM,Santhabommali,KOLLIPADU,8,0,553,561,7,0,449,456,504,208,0,27422,27630,15116,0,0,98,98
10005,SRIKAKULAM,Santhabommali,KOTAPADU,89,1,567,657,63,1,385,449,408,2878,50,19374,22302,14075,1,0,16,17
10006,SRIKAKULAM,Santhabommali,LAKKIVALASA,0,0,576,576,0,0,17,17,17,0,0,88,88,87,0,0,0,0
10007,SRIKAKULAM,Santhabommali,LINGUDU,6,0,413,419,6,0,258,264,302,316,0,9974,10290,5962,0,0,6,6
10008,SRIKAKULAM,Santhabommali,MALAGAM,0,0,755,755,0,0,633,633,684,0,0,28299,28299,16665,0,0,17,17
10009,SRIKAKULAM,Santhabommali,MARRIPADU,31,0,792,823,31,0,406,437,464,2569,0,29211,31780,18363,11,0,87,98
10010,SRIKAKULAM,Santhabommali,MARUVADA,14,2,509,525,13,2,395,410,395,1103,164,28184,29451,17755,7,0,97,104
10011,SRIKAKULAM,Santhabommali,MEGHAVARAM,1,0,681,682,0,0,417,417,407,0,0,17200,17200,10415,0,0,5,5
10012,SRIKAKULAM,Santhabommali,MULAPETA,1,0,565,566,0,0,3,3,1,0,0,5,5,1,0,0,0,0
10013,SRIKAKULAM,Santhabommali,NARASAPURAM,59,0,512,571,42,0,415,457,400,1784,0,25607,27391,14245,0,0,74,74
10014,SRIKAKULAM,Santhabommali,PALATHALAGAM,51,1,672,724,39,0,400,439,392,2009,0,17447,19456,11825,2,0,20,22
10015,SRIKAKULAM,Santhabommali,R.H.PURAM,27,0,421,448,14,0,307,321,296,1007,0,14394,15401,9846,3,0,8,11
10016,SRIKAKULAM,Santhabommali,S.B.KOTTURU,2,0,240,242,2,0,198,200,184,88,0,10636,10724,6255,0,0,26,26
10017,SRIKAKULAM,Santhabommali,SANTHABOMMALI,128,0,2236,2364,60,0,1464,1524,1535,4218,0,88836,93054,53234,10,0,219,229
10018,SRIKAKULAM,Santhabommali,TALLAVALASA,80,0,344,424,62,0,245,307,201,1816,0,4514,6330,3294,0,0,0,0
10019,SRIKAKULAM,Santhabommali,THOTADA,18,2,113,133,14,2,93,109,74,1368,186,6519,8073,3385,9,1,16,26
10020,SRIKAKULAM,Santhabommali,UMILADA,76,0,657,733,59,0,453,512,546,4924,0,24996,29920,18929,24,0,23,47
10021,SRIKAKULAM,Santhabommali,VADDITANDRA,29,1,712,742,14,1,452,467,377,710,39,19907,20656,12614,1,0,15,16
10022,SRIKAKULAM,Santhabommali,VADDIVADA,15,0,352,367,14,0,244,258,222,851,0,12090,12941,7835,1,0,1,2
10023,SRIKAKULAM,Santhabommali,YAMALAPETA,17,1,228,246,17,0,185,202,202,964,0,9001,9965,5635,0,0,9,9
10024,SRIKAKULAM,Santhakaviti,APPALAAGRAHARAM,2,0,362,364,2,0,315,317,301,91,0,19560,19651,12851,0,0,38,38
10025,SRIKAKULAM,Santhakaviti,BILLANI,9,0,178,187,4,0,145,149,138,249,0,10452,10701,5997,0,0,44,44
10026,SRIKAKULAM,Santhakaviti,BODDURU,142,2,440,584,114,0,247,361,378,6070,0,13101,19171,13885,5,0,19,24
10027,SRIKAKULAM,Santhakaviti,CHEENAIAHPETA,44,0,189,233,32,0,153,185,166,1787,0,4177,5964,4029,2,0,0,2
10028,SRIKAKULAM,Santhakaviti,CHITTARIPURAM,63,0,544,607,47,0,340,387,353,2502,0,14988,17490,9197,2,0,5,7
10029,SRIKAKULAM,Santhakaviti,G.N.PURAM,11,0,392,403,8,0,307,315,286,562,0,23013,23575,16164,3,0,73,76
10030,SRIKAKULAM,Santhakaviti,GARIKIPADU,56,0,606,662,30,0,291,321,304,2380,0,18737,21117,13256,9,0,36,45
10031,SRIKAKULAM,Santhakaviti,GOLLAVALASA,62,0,495,557,27,0,286,313,333,1377,0,12182,13559,7739,6,0,20,26
10032,SRIKAKULAM,Santhakaviti,GOVINDAPURAM,52,10,328,390,42,10,290,342,380,1629,279,12345,14253,8041,2,0,4,6
10033,SRIKAKULAM,Santhakaviti,GULLASITHARAMAPURAM,63,0,212,275,50,0,133,183,182,2953,0,6992,9945,7442,1,0,5,6
10034,SRIKAKULAM,Santhakaviti,HONJARAM,73,0,569,642,38,0,439,477,507,932,0,11946,12878,6521,0,0,0,0
10035,SRIKAKULAM,Santhakaviti,JAVAM,125,0,374,499,87,0,234,321,253,2888,0,6776,9664,4440,0,0,0,0
10036,SRIKAKULAM,Santhakaviti,K.R.PURAM,47,2,160,209,35,2,119,156,142,1324,107,3471,4902,2904,0,0,1,1
10037,SRIKAKULAM,Santhakaviti,KAKARAPALLI,69,0,662,731,40,0,467,507,479,903,0,5483,6386,3763,0,0,0,0
10038,SRIKAKULAM,Santhakaviti,KAVALI,30,1,202,233,19,1,143,163,132,1195,20,8853,10068,6522,5,0,12,17
10039,SRIKAKULAM,Santhakaviti,KONDAGUDEM,70,11,339,420,51,1,154,206,201,1612,38,4605,6255,3879,0,0,0,0
10040,SRIKAKULAM,Santhakaviti,KRISHNAMVALASA,16,0,435,451,15,0,375,390,398,625,0,23657,24282,13635,3,0,46,49
10041,SRIKAKULAM,Santhakaviti,MAMIDIPALLI,91,2,686,779,69,1,567,637,663,4681,50,34565,39296,23483,17,0,86,103
10042,SRIKAKULAM,Santhakaviti,MANDARADA,54,1,304,359,39,0,189,228,247,1974,0,7111,9085,6264,4,0,1,5
10043,SRIKAKULAM,Santhakaviti,MANDAVAKURITI,173,3,1046,1222,112,1,746,859,727,9130,83,35874,45087,23539,43,0,46,89
10044,SRIKAKULAM,Santhakaviti,MANTHINA,59,0,460,519,52,0,356,408,388,3676,0,22944,26620,15459,16,0,57,73
10045,SRIKAKULAM,Santhakaviti,MIRTHIVALASA,6,0,386,392,2,0,263,265,224,41,0,7516,7557,3866,0,0,1,1
10046,SRIKAKULAM,Santhakaviti,MODUGULAPETA,34,4,415,453,24,0,347,371,393,1842,0,13920,15762,8594,5,0,13,18
10047,SRIKAKULAM,Santhakaviti,PULLITA,95,0,157,252,64,0,126,190,168,1983,0,5582,7565,4790,1,0,6,7
10048,SRIKAKULAM,Santhakaviti,RAMARAYAPURAM,107,13,287,407,84,7,167,258,217,3999,123,4502,8624,5395,3,0,1,4
10049,SRIKAKULAM,Santhakaviti,S.RANGARAYAPURAM,57,3,139,199,52,2,116,170,181,3569,103,9185,12857,7398,10,0,39,49
10050,SRIKAKULAM,Santhakaviti,SANTHAKAVITI,87,0,214,301,67,0,128,195,190,3974,0,6756,10730,7792,10,0,9,19
10051,SRIKAKULAM,Santhakaviti,SIRIPURAM,123,1,1216,1340,50,1,674,725,687,1644,6,36501,38151,26261,0,0,63,63
10052,SRIKAKULAM,Santhakaviti,SURAVARAM,79,1,214,294,59,0,132,191,163,4882,0,7910,12792,7398,24,0,22,46
10053,SRIKAKULAM,Santhakaviti,TALATAMPARA,23,1,197,221,16,1,147,164,158,1082,49,9416,10547,6835,2,0,25,27
10054,SRIKAKULAM,Santhakaviti,THALADA,115,2,364,481,57,1,230,288,258,1344,9,6340,7693,5028,1,0,1,2
10055,SRIKAKULAM,Santhakaviti,THAMARAM,41,0,396,437,32,0,258,290,261,1673,0,9532,11205,7115,0,0,2,2
10056,SRIKAKULAM,Santhakaviti,VASUDEVAPATNAM,111,0,497,608,78,0,288,366,322,2766,0,10032,12798,7139,1,0,2,3
10057,SRIKAKULAM,Santhakaviti,WALTAIR,29,0,439,468,24,0,277,301,305,1441,0,7177,8618,5513,3,0,1,4
10058,SRIKAKULAM,Saravakota,ALUDU,157,11,580,748,32,8,330,370,341,1074,158,11132,12364,10030,0,0,1,1
10059,SRIKAKULAM,Saravakota,ANGURU,30,0,266,296,18,0,169,187,175,1053,0,8039,9092,6497,0,0,6,6
10060,SRIKAKULAM,Saravakota,ANNUPURAM,0,26,161,187,0,22,87,109,94,0,937,4210,5147,2849,0,0,9,9
10061,SRIKAKULAM,Saravakota,AVALANGI,38,0,187,225,24,0,112,136,126,1616,0,5984,7600,5584,3,0,9,12
10062,SRIKAKULAM,Saravakota,BAIDALAPURAM,0,58,61,119,0,47,34,81,79,0,3614,2895,6509,4294,0,13,17,30
10063,SRIKAKULAM,Saravakota,BHADRI,81,10,236,327,63,0,163,226,203,3140,0,10012,13152,9341,7,0,23,30
10064,SRIKAKULAM,Saravakota,BUDITHI,46,11,446,503,24,9,231,264,246,1797,766,13073,15636,11937,10,3,17,30
10065,SRIKAKULAM,Saravakota,CHEEDIPUDI,23,5,317,345,9,4,215,228,223,513,281,13986,14780,12152,2,0,28,30
10066,SRIKAKULAM,Saravakota,CHINAGUJJUVADA,53,96,101,250,37,78,54,169,157,2311,4907,2672,9890,6066,5,16,2,23
10067,SRIKAKULAM,Saravakota,CHINAKITTALAPADU,7,194,226,427,4,137,121,262,235,411,6275,6548,13234,8205,2,16,9,27
10068,SRIKAKULAM,Saravakota,D.L.PURAM,6,136,171,313,1,67,85,153,143,6,1303,2069,3378,2093,0,0,0,0
10069,SRIKAKULAM,Saravakota,GORRIBANDA,20,195,179,394,16,113,95,224,213,1141,5374,4287,10802,6037,4,21,6,31
10070,SRIKAKULAM,Saravakota,GOVARDHANAPURAM,25,7,227,259,20,5,137,162,145,1215,436,8793,10444,5583,5,4,38,47
10071,SRIKAKULAM,Saravakota,GUMMAPADU,29,41,349,419,17,28,225,270,238,966,2039,14494,17499,12280,3,10,44,57
10072,SRIKAKULAM,Saravakota,JAMACHAKRAM,18,10,204,232,14,10,134,158,148,1242,841,9659,11742,6832,8,4,41,53
10073,SRIKAKULAM,Saravakota,KARADASINGI,9,51,81,141,9,44,61,114,102,405,3400,2255,6060,3743,1,17,2,20
10074,SRIKAKULAM,Saravakota,KELAVALASA,48,28,418,494,34,14,274,322,323,2215,1225,17431,20871,13777,6,7,36,49
10075,SRIKAKULAM,Saravakota,KIDDIMI,72,12,227,311,64,13,197,274,210,6362,1302,15290,22954,11542,37,7,76,120
10076,SRIKAKULAM,Saravakota,KINNERAVADA,23,1,355,379,13,1,181,195,158,348,87,8665,9100,6304,0,0,2,2
10077,SRIKAKULAM,Saravakota,KODADDAPANASA,63,0,233,296,51,0,164,215,176,3043,0,7860,10903,6265,9,0,7,16
10078,SRIKAKULAM,Saravakota,KOMMUSARIAPALLI,27,0,226,253,25,0,163,188,168,2412,0,11639,14051,8568,15,0,59,74
10079,SRIKAKULAM,Saravakota,KUMMARIGUNTA,134,79,444,657,98,68,264,430,417,7549,5528,14172,27249,16936,35,29,32,96
10080,SRIKAKULAM,Saravakota,KURMANADHAPURAM,5,95,193,293,3,60,112,175,153,101,2117,6279,8497,5381,0,0,13,13
10081,SRIKAKULAM,Saravakota,LAXMIPURAM,16,0,216,232,9,0,159,168,141,218,0,6819,7037,4230,0,0,3,3
10082,SRIKAKULAM,Saravakota,MADANAPURAM,29,61,124,214,25,38,80,143,137,1886,1115,5533,8534,5772,7,0,22,29
10083,SRIKAKULAM,Saravakota,MAHASINGI,1,112,259,372,0,87,150,237,210,0,3080,6427,9507,6180,0,2,17,19
10084,SRIKAKULAM,Saravakota,MALUVA,11,145,199,355,2,85,57,144,139,84,3707,1697,5488,3630,0,2,3,5
10085,SRIKAKULAM,Saravakota,NOWTHALA,19,78,113,210,9,55,57,121,111,256,2426,3213,5895,3982,0,4,12,16
10086,SRIKAKULAM,Saravakota,PEDDALAMBA,103,74,444,621,56,50,234,340,290,3547,2770,14656,20973,11683,11,10,44,65
10087,SRIKAKULAM,Saravakota,RAMAKRISHNAPURAM,44,56,188,288,34,37,129,200,174,2150,2547,7437,12134,8449,4,7,18,29
10088,SRIKAKULAM,Saravakota,SARAVAKOTA,192,1,324,517,101,0,164,265,253,8241,0,11805,20046,14211,49,0,38,87
10089,SRIKAKULAM,Saravakota,THOGIRI,21,117,206,344,18,103,125,246,255,1100,8360,6338,15798,11221,7,39,14,60
10090,SRIKAKULAM,Saravakota,VANDRAYI,44,94,353,491,30,68,209,307,274,1949,3774,11532,17255,9587,8,10,19,37
10091,SRIKAKULAM,Saravakota,VENKATAPURAM,58,70,215,343,42,51,145,238,216,2221,3001,9252,14474,10419,5,3,13,21
10092,SRIKAKULAM,Sarubujjili,BOPPADAM,16,0,199,215,11,0,164,175,143,781,0,13462,14243,8549,3,0,65,68
10093,SRIKAKULAM,Sarubujjili,CHIGURUVALASA,159,93,266,518,113,48,209,370,330,5993,816,9028,15837,9601,24,0,0,24
10094,SRIKAKULAM,Sarubujjili,CHINAKAGITAPALLE,31,3,363,397,26,2,303,331,277,2177,86,22202,24465,14707,9,0,65,74
10095,SRIKAKULAM,Sarubujjili,DAKARAVALASA,5,1,188,194,3,1,148,152,139,79,33,3857,3969,2287,0,0,0,0
10096,SRIKAKULAM,Sarubujjili,GONEPADU,1,1,280,282,0,1,216,217,213,0,41,13977,14018,9000,0,0,31,31
10097,SRIKAKULAM,Sarubujjili,ISAKALAPALEM,33,0,333,366,24,0,231,255,211,1516,0,11443,12959,7505,3,0,7,10
10098,SRIKAKULAM,Sarubujjili,KONDAVALASA,46,5,227,278,33,4,192,229,197,2502,330,13711,16543,10536,11,0,45,56
10099,SRIKAKULAM,Sarubujjili,KOTHAKOTA,48,0,356,404,35,0,241,276,225,1530,0,9623,11153,7605,0,0,7,7
10100,SRIKAKULAM,Sarubujjili,MATALABPETA,21,0,324,345,16,0,264,280,246,640,0,16965,17605,11100,0,0,31,31
10101,SRIKAKULAM,Sarubujjili,MULASOWLAPURAM,65,0,293,358,47,0,226,273,262,2341,0,19224,21565,12370,6,0,98,104
10102,SRIKAKULAM,Sarubujjili,PALAVALASA,25,0,318,343,19,0,160,179,166,928,0,10220,11148,7096,1,0,21,22
10103,SRIKAKULAM,Sarubujjili,PEDDAPALEM,29,2,171,202,21,2,102,125,100,1697,78,6716,8491,6036,9,0,20,29
10104,SRIKAKULAM,Sarubujjili,PURUSHOTTAPURAM,155,1,919,1075,99,0,448,547,461,1932,0,9158,11090,6373,0,0,0,0
10105,SRIKAKULAM,Sarubujjili,RAVIVALASA,14,0,182,196,14,0,141,155,154,741,0,7860,8601,5895,1,0,6,7
10106,SRIKAKULAM,Sarubujjili,ROTTAVALASA,26,2,361,389,19,1,241,261,246,614,12,6062,6688,4818,0,0,0,0
10107,SRIKAKULAM,Sarubujjili,SARUBUJJILI,84,1,306,391,60,1,213,274,230,1507,12,5284,6803,4692,0,0,0,0
10108,SRIKAKULAM,Sarubujjili,SHALANTRI,113,4,403,520,67,1,296,364,316,2391,7,13312,15710,9073,3,0,19,22
10109,SRIKAKULAM,Sarubujjili,SINDUVADA,41,0,267,308,35,0,213,248,207,3495,0,20004,23499,13247,21,0,115,136
10110,SRIKAKULAM,Sarubujjili,TELIKIPENTA,17,1,367,385,6,1,238,245,208,84,23,4361,4468,2663,0,0,1,1
10111,SRIKAKULAM,Sarubujjili,VIJAYARAMAPURAM,16,2,325,343,11,2,279,292,263,431,42,11704,12177,7547,0,0,1,1
10112,SRIKAKULAM,Sarubujjili,YERAGRAM,67,0,280,347,45,0,184,229,197,2434,0,10563,12997,7810,5,0,17,22
10113,SRIKAKULAM,Seethampeta,CHINABAGGA,31,459,26,516,26,397,16,439,551,1626,34218,905,36749,19521,3,161,3,167
10114,SRIKAKULAM,Seethampeta,DARAPADU,42,679,1,722,30,551,0,581,628,2674,46273,0,48947,25876,19,242,0,261
10115,SRIKAKULAM,Seethampeta,DONUBAI,50,509,26,585,36,387,12,435,514,3155,29305,623,33083,18474,15,139,1,155
10116,SRIKAKULAM,Seethampeta,GOIDI,3,665,9,677,3,496,5,504,639,166,42674,500,43340,23842,1,217,4,222
10117,SRIKAKULAM,Seethampeta,HADDABHANGI,43,504,36,583,32,435,4,471,500,545,33830,92,34467,17992,0,149,0,149
10118,SRIKAKULAM,Seethampeta,KADAGANDI,3,681,10,694,2,467,9,478,525,111,25925,451,26487,13839,0,98,0,98
10119,SRIKAKULAM,Seethampeta,KEESARAIJODU,1,320,0,321,0,256,0,256,274,0,23233,0,23233,11812,0,130,0,130
10120,SRIKAKULAM,Seethampeta,KILLADA,9,657,4,670,7,521,3,531,552,706,46237,243,47186,25839,4,263,2,269
10121,SRIKAKULAM,Seethampeta,KODISA,12,761,0,773,7,592,0,599,685,791,37980,0,38771,19242,6,148,0,154
10122,SRIKAKULAM,Seethampeta,KONDADA,0,457,1,458,0,394,1,395,495,0,30165,104,30269,14967,0,108,1,109
10123,SRIKAKULAM,Seethampeta,KUDDA PALLE,7,980,1,988,1,765,0,766,940,112,56328,0,56440,30907,1,249,0,250
10124,SRIKAKULAM,Seethampeta,KUSIMI,8,907,14,929,6,560,2,568,648,238,40219,86,40543,21182,0,187,0,187
10125,SRIKAKULAM,Seethampeta,MANDA,1,498,0,499,0,441,0,441,522,0,46654,0,46654,24650,0,295,0,295
10126,SRIKAKULAM,Seethampeta,MARRIPADU,49,377,10,436,40,315,6,361,417,2985,25603,400,28988,15801,6,141,1,148
10127,SRIKAKULAM,Seethampeta,PEDARAMA,21,1295,103,1419,9,868,5,882,1044,463,59241,491,60195,31567,1,237,2,240
10128,SRIKAKULAM,Seethampeta,POLLA,1,587,6,594,1,501,5,507,615,48,43281,346,43675,24313,0,215,2,217
10129,SRIKAKULAM,Seethampeta,PUBBADA,15,526,4,545,10,436,1,447,478,573,31100,57,31730,16444,1,81,0,82
10130,SRIKAKULAM,Seethampeta,PULIPUTTI,63,408,3,474,46,332,2,380,424,4311,31090,97,35498,19431,26,206,0,232
10131,SRIKAKULAM,Seethampeta,PUTHIKAVALASA,7,582,3,592,2,504,1,507,499,156,41565,37,41758,19830,1,243,0,244
10132,SRIKAKULAM,Seethampeta,SAMARILLI,4,505,1,510,3,432,1,436,508,223,31746,93,32062,17795,0,132,0,132
10133,SRIKAKULAM,Seethampeta,SAMBHAM,0,796,0,796,0,634,0,634,750,0,40836,0,40836,22113,0,155,0,155
10134,SRIKAKULAM,Seethampeta,SEETHAMPETA,153,581,287,1021,61,422,138,621,639,3282,29929,10523,43734,25844,12,117,54,183
10135,SRIKAKULAM,Seethampeta,SOMAGANDI,154,554,0,708,123,471,0,594,706,12846,40743,0,53589,28993,88,231,0,319
10136,SRIKAKULAM,Seethampeta,TITUKAPAI,1,423,1,425,1,390,0,391,491,34,33612,0,33646,17599,0,152,0,152
10137,SRIKAKULAM,Sompeta,BARUVA,51,5,1064,1120,7,0,403,410,411,101,0,11105,11206,11030,0,0,1,1
10138,SRIKAKULAM,Sompeta,BENKILI,24,0,228,252,0,0,157,157,163,0,0,11697,11697,9612,0,0,35,35
10139,SRIKAKULAM,Sompeta,BESIRAMACHANDRA PURAM,112,5,383,500,41,2,213,256,245,2061,65,8487,10613,8519,2,0,9,11
10140,SRIKAKULAM,Sompeta,BHUSABHADRA,1,1,170,172,0,0,126,126,142,0,0,7248,7248,5506,0,0,7,7
10141,SRIKAKULAM,Sompeta,GOLLAGANDI,8,1,505,514,7,1,354,362,388,141,8,6894,7043,6542,0,0,0,0
10142,SRIKAKULAM,Sompeta,GOLLAVOORU,1,0,330,331,0,0,245,245,217,0,0,12087,12087,8021,0,0,9,9
10143,SRIKAKULAM,Sompeta,ISAKALAPALEM,3,0,435,438,3,0,332,335,353,95,0,10143,10238,9386,0,0,0,0
10144,SRIKAKULAM,Sompeta,KARTHALIPALEM,30,1,508,539,9,0,344,353,396,129,0,11438,11567,10194,0,0,7,7
10145,SRIKAKULAM,Sompeta,KORLAM,22,3,520,545,19,1,374,394,403,1076,59,16469,17604,16705,1,0,9,10
10146,SRIKAKULAM,Sompeta,MAKKANNAPURAM,27,2,465,494,10,1,341,352,393,236,49,10631,10916,8727,0,0,0,0
10147,SRIKAKULAM,Sompeta,MALAGOVINDAPURAM,61,171,144,376,47,119,99,265,275,2887,6626,6673,16186,10905,6,14,18,38
10148,SRIKAKULAM,Sompeta,MAMIDIPALLI,16,3,647,666,1,3,395,399,380,51,105,11714,11870,9771,0,0,6,6
10149,SRIKAKULAM,Sompeta,PALASAPURAM,35,0,483,518,17,0,357,374,383,769,0,15439,16208,13476,1,0,9,10
10150,SRIKAKULAM,Sompeta,PALAVALASA,24,7,517,548,10,7,304,321,339,190,100,11750,12040,10942,0,0,13,13
10151,SRIKAKULAM,Sompeta,POTRAKONDA,68,1,352,421,39,0,251,290,295,2051,0,16315,18366,14411,3,0,44,47
10152,SRIKAKULAM,Sompeta,RUSHIKUDDA,3,1,202,206,0,0,2,2,2,0,0,10,10,10,0,0,0,0
10153,SRIKAKULAM,Sompeta,SIRIMAMIDI,9,0,298,307,7,0,240,247,225,187,0,7832,8019,6531,0,0,0,0
10154,SRIKAKULAM,Sompeta,SOMPETA,54,0,679,733,0,0,316,316,330,0,0,17088,17088,16578,0,0,26,26
10155,SRIKAKULAM,Sompeta,SUNKIDI,44,38,533,615,29,32,394,455,515,1350,2709,26074,30133,21950,1,13,84,98
10156,SRIKAKULAM,Sompeta,TALLABHADRA,19,0,499,518,8,0,169,177,172,137,0,1987,2124,1723,0,0,0,0
10157,SRIKAKULAM,Sompeta,TURAKASASANAM,33,0,247,280,14,0,177,191,176,290,0,5187,5477,4271,0,0,0,0
10158,SRIKAKULAM,Sompeta,UPPALAM,6,0,623,629,6,0,402,408,400,156,0,5767,5923,5418,0,0,0,0
10159,SRIKAKULAM,Sompeta,ZINKIBHADRA,7,2,420,429,1,1,251,253,257,75,80,17318,17473,16334,0,0,32,32
10160,SRIKAKULAM,Srikakulam,ALIKAM,29,4,459,492,23,1,337,361,326,1379,108,21445,22932,15671,1,1,46,48
10161,SRIKAKULAM,Srikakulam,BALIVADA,3,0,161,164,2,0,117,119,114,50,0,3872,3922,3213,0,0,0,0
10162,SRIKAKULAM,Srikakulam,BATTERU,14,0,103,117,9,0,64,73,79,762,0,4475,5237,3287,1,0,16,17
10163,SRIKAKULAM,Srikakulam,BHYRI,20,0,382,402,15,0,296,311,323,191,0,5064,5255,3779,0,0,0,0
10164,SRIKAKULAM,Srikakulam,BYRIVANIPETA,17,1,310,328,15,1,250,266,254,1405,63,23873,25341,20359,9,0,169,178
10165,SRIKAKULAM,Srikakulam,CHAPURAM,61,0,195,256,41,0,129,170,156,3207,0,10406,13613,11158,10,0,50,60
10166,SRIKAKULAM,Srikakulam,GUDEM,29,3,721,753,22,2,566,590,563,1203,179,42350,43732,32662,1,0,121,122
10167,SRIKAKULAM,Srikakulam,IPPILI,23,0,431,454,21,0,290,311,283,1562,0,6004,7566,5670,9,0,2,11
10168,SRIKAKULAM,Srikakulam,KALLEPALLE,49,2,916,967,30,0,558,588,621,1459,0,15392,16851,14450,4,0,5,9
10169,SRIKAKULAM,Srikakulam,KANUGULAVANIPETA,15,0,471,486,3,0,120,123,106,14,0,1499,1513,894,0,0,0,0
10170,SRIKAKULAM,Srikakulam,KARAJADA,2,0,353,355,2,0,257,259,232,26,0,1723,1749,1026,0,0,0,0
10171,SRIKAKULAM,Srikakulam,KHAJIPETA,42,0,285,327,24,0,138,162,168,1567,0,4657,6224,5441,8,0,7,15
10172,SRIKAKULAM,Srikakulam,KIISTAPPAPETA,17,3,297,317,15,1,239,255,247,953,63,9512,10528,7769,2,0,1,3
10173,SRIKAKULAM,Srikakulam,KILLIPALAM,64,0,498,562,32,0,290,322,323,839,0,3692,4531,4063,0,0,3,3
10174,SRIKAKULAM,Srikakulam,KUNDUVANI PETA,1,0,802,803,0,0,54,54,47,0,0,1854,1854,1602,0,0,0,0
10175,SRIKAKULAM,Srikakulam,LANKAM,52,0,408,460,42,0,316,358,336,2866,0,19820,22686,17294,10,0,33,43
10176,SRIKAKULAM,Srikakulam,NAIRA,41,0,363,404,38,0,296,334,320,3107,0,20345,23452,14537,8,0,63,71
10177,SRIKAKULAM,Srikakulam,PATRUVANIVALASA,106,1,308,415,77,1,266,344,301,6346,98,24717,31161,23425,35,0,127,162
10178,SRIKAKULAM,Srikakulam,PEDDAGANAGALLAPETA,1,0,711,712,0,0,67,67,65,0,0,1260,1260,1104,0,0,0,0
10179,SRIKAKULAM,Srikakulam,PEDDAPADU,3,0,1423,1426,0,0,518,518,508,0,0,7662,7662,6928,0,0,0,0
10180,SRIKAKULAM,Srikakulam,PONNAM,27,0,754,781,25,0,561,586,566,1672,0,23182,24854,18128,1,0,18,19
10181,SRIKAKULAM,Srikakulam,RAGOLU,60,2,877,939,31,0,413,444,414,1568,0,22276,23844,19076,1,0,41,42
10182,SRIKAKULAM,Srikakulam,SANIVADA,21,1,454,476,16,1,327,344,330,1455,63,22774,24292,18931,7,0,42,49
10183,SRIKAKULAM,Srikakulam,SILAGAMSINGIVALASA,6,8,892,906,5,2,698,705,654,228,132,39347,39707,28094,0,0,39,39
10184,SRIKAKULAM,Srikakulam,SINGUPURAM,67,2,1848,1917,38,0,975,1013,973,1408,0,29547,30955,22684,3,0,7,10
10185,SRIKAKULAM,Srikakulam,THANDEMVALASA,38,0,567,605,29,0,463,492,459,1311,0,15640,16951,11869,0,0,4,4
10186,SRIKAKULAM,Srikakulam,VAKALAVALASA,0,0,366,366,0,0,227,227,212,0,0,15433,15433,13355,0,0,23,23
10187,SRIKAKULAM,Srikakulam,VOPPANGI,86,2,854,942,54,0,433,487,513,637,0,5658,6295,4654,0,0,4,4
10188,SRIKAKULAM,Tekkali,AKKAVARAM,66,0,199,265,48,0,167,215,202,1693,0,4805,6498,4938,0,0,0,0
10189,SRIKAKULAM,Tekkali,AYODHYAPURAM,42,0,466,508,34,0,371,405,395,1396,0,22054,23450,15109,2,0,64,66
10190,SRIKAKULAM,Tekkali,BANNUVADA,62,3,324,389,39,0,205,244,211,1532,0,7094,8626,5029,0,0,0,0
10191,SRIKAKULAM,Tekkali,BHAGAVANPURAM,70,1,367,438,52,0,239,291,237,1063,0,5764,6827,4721,0,0,0,0
10192,SRIKAKULAM,Tekkali,BOORAGAM,133,1,585,719,105,1,492,598,550,8664,106,34985,43755,27017,31,1,112,144
10193,SRIKAKULAM,Tekkali,BOPPAIPURAM,73,11,413,497,42,6,246,294,269,1209,93,7677,8979,6131,0,0,0,0
10194,SRIKAKULAM,Tekkali,CHAKIPALLE,42,0,228,270,33,0,183,216,191,1195,0,6979,8174,5847,0,0,0,0
10195,SRIKAKULAM,Tekkali,GUDEM,55,47,405,507,41,42,322,405,417,1994,2414,17785,22193,14300,5,12,33,50
10196,SRIKAKULAM,Tekkali,K. KOTTURU,9,0,246,255,8,0,142,150,136,308,0,3527,3835,3042,0,0,0,0
10197,SRIKAKULAM,Tekkali,LINGALAVALASA,75,128,632,835,44,102,455,601,569,1319,3632,16377,21328,12567,1,1,14,16
10198,SRIKAKULAM,Tekkali,MEGHAVARAM,87,334,462,883,55,264,304,623,638,3253,16629,13921,33803,23109,5,39,11,55
10199,SRIKAKULAM,Tekkali,MUKHALINGAPURAM,1,236,29,266,1,209,23,233,229,108,14912,1573,16593,9874,1,71,6,78
10200,SRIKAKULAM,Tekkali,NARASINGAPALLE,62,71,554,687,41,57,377,475,411,2260,3903,23307,29470,18105,3,8,54,65
10201,SRIKAKULAM,Tekkali,PARASURAMPURAM,70,0,107,177,49,0,81,130,137,2951,0,5722,8673,6214,5,0,14,19
10202,SRIKAKULAM,Tekkali,PATHANOUPADA,20,3,508,531,14,0,292,306,292,733,0,16878,17611,13315,0,0,43,43
10203,SRIKAKULAM,Tekkali,PEDDAROKALLAPALLE,15,0,321,336,9,0,238,247,242,432,0,15608,16040,10166,1,0,53,54
10204,SRIKAKULAM,Tekkali,PEDDASANA,24,57,326,407,16,42,210,268,252,782,2629,5100,8511,5716,0,2,0,2
10205,SRIKAKULAM,Tekkali,POLAVARAM,21,1,345,367,14,1,265,280,259,325,5,6451,6781,4874,0,0,0,0
10206,SRIKAKULAM,Tekkali,RADHAVALLABHAPURAM,20,0,70,90,14,0,49,63,43,587,0,2128,2715,1452,0,0,2,2
10207,SRIKAKULAM,Tekkali,RAVIVALASA,78,0,633,711,43,0,372,415,411,1588,0,14042,15630,10816,1,0,3,4
10208,SRIKAKULAM,Tekkali,SASANAN,4,3,456,463,0,1,314,315,305,0,32,16610,16642,11395,0,0,12,12
10209,SRIKAKULAM,Tekkali,SEETHAPURAM,87,0,281,368,52,0,127,179,164,1766,0,5229,6995,5426,1,0,2,3
10210,SRIKAKULAM,Tekkali,TALAGAM,31,0,296,327,19,0,203,222,170,1100,0,12026,13126,7078,1,0,33,34
10211,SRIKAKULAM,Tekkali,TEKKALI,465,63,1598,2126,157,35,348,540,509,5294,2462,11593,19349,17565,0,7,4,11
10212,SRIKAKULAM,Tekkali,TELINEELAPURAM,41,1,186,228,21,0,104,125,113,1082,0,3875,4957,3430,0,0,5,5
10213,SRIKAKULAM,Tekkali,TIRLANGI,87,0,556,643,42,0,316,358,319,950,0,9841,10791,7652,0,0,3,3
10214,SRIKAKULAM,Tekkali,TOLUSURUPALLE,63,2,393,458,29,0,87,116,113,1215,0,2377,3592,2438,0,0,0,0
10215,SRIKAKULAM,Vajrapukothuru,AKKUPALLI,1,0,132,133,0,0,8,8,7,0,0,27,27,21,0,0,0,0
10216,SRIKAKULAM,Vajrapukothuru,AMALAPADU,10,0,312,322,2,0,172,174,166,84,0,8468,8552,7426,0,0,3,3
10217,SRIKAKULAM,Vajrapukothuru,ANANTHAGIRI,10,6,403,419,0,0,188,188,186,0,0,10218,10218,8803,0,0,15,15
10218,SRIKAKULAM,Vajrapukothuru,BATHUPURAM,0,0,31,31,0,0,4,4,3,0,0,54,54,46,0,0,0,0
10219,SRIKAKULAM,Vajrapukothuru,BENDI,10,0,721,731,8,0,471,479,490,289,0,20336,20625,13877,0,0,15,15
10220,SRIKAKULAM,Vajrapukothuru,BYPALLI,0,0,37,37,0,0,0,0,0,0,0,0,0,0,0,0,0,0
10221,SRIKAKULAM,Vajrapukothuru,CHEEPURUPALLI,0,0,263,263,0,0,22,22,14,0,0,319,319,220,0,0,0,0
10222,SRIKAKULAM,Vajrapukothuru,CHINAVANKA,0,0,356,356,0,0,119,119,103,0,0,8912,8912,5413,0,0,33,33
10223,SRIKAKULAM,Vajrapukothuru,DEVUNALTADA,6,1,721,728,5,1,464,470,490,117,24,17918,18059,15955,0,0,14,14
10224,SRIKAKULAM,Vajrapukothuru,DOKULAPADU,1,0,358,359,1,0,264,265,221,26,0,17286,17312,11495,0,0,68,68
10225,SRIKAKULAM,Vajrapukothuru,G. BATHUPURAM,4,0,247,251,2,0,100,102,89,143,0,5821,5964,3717,1,0,20,21
10226,SRIKAKULAM,Vajrapukothuru,GARUDABADRA,8,0,348,356,3,0,153,156,150,111,0,7651,7762,5064,0,0,28,28
10227,SRIKAKULAM,Vajrapukothuru,GOVINDAPURAM,0,0,114,114,0,0,56,56,54,0,0,3448,3448,2341,0,0,8,8
10228,SRIKAKULAM,Vajrapukothuru,GUNUPALLI,0,0,127,127,0,0,21,21,13,0,0,330,330,208,0,0,0,0
10229,SRIKAKULAM,Vajrapukothuru,K.GOVINDAPURAM,4,12,293,309,1,9,167,177,168,27,292,9625,9944,7475,0,1,29,30
10230,SRIKAKULAM,Vajrapukothuru,KAMBALARAYUDUPETA,1,0,218,219,0,0,16,16,15,0,0,240,240,194,0,0,0,0
10231,SRIKAKULAM,Vajrapukothuru,KIDISINGI,0,0,238,238,0,0,185,185,176,0,0,14882,14882,9238,0,0,60,60
10232,SRIKAKULAM,Vajrapukothuru,KOMARLATADA,1,1,233,235,0,1,158,159,165,0,106,11802,11908,10750,0,1,37,38
10233,SRIKAKULAM,Vajrapukothuru,KONDAVOORU,0,1,337,338,0,0,233,233,251,0,0,15526,15526,11145,0,0,48,48
10234,SRIKAKULAM,Vajrapukothuru,KOTTAPETA,2,1,405,408,0,1,238,239,241,0,17,4724,4741,4208,0,0,0,0
10235,SRIKAKULAM,Vajrapukothuru,LAXMIDEVIPETA,0,0,442,442,0,0,3,3,1,0,0,29,29,5,0,0,0,0
10236,SRIKAKULAM,Vajrapukothuru,METTURU,9,0,113,122,0,0,1,1,1,0,0,5,5,5,0,0,0,0
10237,SRIKAKULAM,Vajrapukothuru,MUTCHINEELAPETA,0,0,607,607,0,0,400,400,424,0,0,27890,27890,26606,0,0,23,23
10238,SRIKAKULAM,Vajrapukothuru,NAGARAMPALLE,10,0,465,475,7,0,346,353,323,249,0,16812,17061,10940,0,0,25,25
10239,SRIKAKULAM,Vajrapukothuru,P.J.PURAM,0,0,319,319,0,0,137,137,138,0,0,8331,8331,7107,0,0,23,23
10240,SRIKAKULAM,Vajrapukothuru,PALLISARADHI,11,1,447,459,5,0,244,249,229,339,0,13380,13719,11511,0,0,27,27
10241,SRIKAKULAM,Vajrapukothuru,PALLIVURU,4,1,733,738,4,0,281,285,268,137,0,5533,5670,4780,0,0,0,0
10242,SRIKAKULAM,Vajrapukothuru,PATHATEKKALI,68,0,297,365,34,0,184,218,225,1333,0,5953,7286,6026,0,0,4,4
10243,SRIKAKULAM,Vajrapukothuru,PEDABODDIPADU,41,0,450,491,30,0,284,314,297,1987,0,20160,22147,16881,5,0,53,58
10244,SRIKAKULAM,Vajrapukothuru,PEDAMURAHARIPURAM,4,0,736,740,1,0,522,523,553,33,0,21867,21900,19696,0,0,6,6
10245,SRIKAKULAM,Vajrapukothuru,PEDDABADAM,5,0,141,146,0,0,0,0,0,0,0,0,0,0,0,0,0,0
10246,SRIKAKULAM,Vajrapukothuru,RAJAM,2,0,289,291,1,0,180,181,177,44,0,12344,12388,11029,0,0,67,67
10247,SRIKAKULAM,Vajrapukothuru,REYYIPADU,3,0,276,279,0,0,50,50,55,0,0,3156,3156,2727,0,0,7,7
10248,SRIKAKULAM,Vajrapukothuru,S.J.PURAM,0,0,326,326,0,0,204,204,203,0,0,12132,12132,10960,0,0,9,9
10249,SRIKAKULAM,Vajrapukothuru,SYNOORU,37,0,296,333,26,0,131,157,147,2104,0,8562,10666,7311,10,0,34,44
10250,SRIKAKULAM,Vajrapukothuru,U.G.PURAM,0,0,280,280,0,0,167,167,152,0,0,11707,11707,10685,0,0,1,1
10251,SRIKAKULAM,Vajrapukothuru,U.R.K.PURAM,0,0,253,253,0,0,16,16,14,0,0,306,306,174,0,0,0,0
10252,SRIKAKULAM,Vajrapukothuru,UNDRUKUDIA,25,0,57,82,19,0,28,47,41,1133,0,1445,2578,1571,3,0,2,5
10253,SRIKAKULAM,Vajrapukothuru,VAJRAPUKOTTURU,19,2,337,358,5,2,173,180,171,281,96,7514,7891,7096,0,0,3,3
10254,SRIKAKULAM,Vangara,ARASADA,64,6,571,641,31,4,393,428,403,1613,234,12183,14030,9522,2,0,3,5
10255,SRIKAKULAM,Vangara,BHAGEMPETA,74,12,257,343,65,12,227,304,304,3456,749,10102,14307,7632,1,0,0,1
10256,SRIKAKULAM,Vangara,DEVAKIWADA,2,0,338,340,0,0,116,116,122,0,0,2283,2283,1191,0,0,0,0
10257,SRIKAKULAM,Vangara,GEETANAPALLI,11,51,144,206,7,45,99,151,136,173,1010,1427,2610,1398,0,0,0,0
10258,SRIKAKULAM,Vangara,K.CH.PALLI,79,49,339,467,56,39,263,358,386,4929,3542,19343,27814,13432,26,20,40,86
10259,SRIKAKULAM,Vangara,KINJANGI,178,0,257,435,115,0,126,241,202,2663,0,2754,5417,2748,0,0,0,0
10260,SRIKAKULAM,Vangara,KONANGIPADU,54,25,543,622,5,20,347,372,444,60,296,9032,9388,5313,0,0,16,16
10261,SRIKAKULAM,Vangara,KOPPARA,101,0,549,650,49,0,103,152,80,2298,0,1126,3424,1309,6,0,0,6
10262,SRIKAKULAM,Vangara,KOPPARAVALASA,99,3,375,477,76,3,245,324,307,4457,43,5550,10050,5128,15,0,0,15
10263,SRIKAKULAM,Vangara,KOTTISA,85,10,91,186,53,7,44,104,85,606,165,493,1264,644,0,0,0,0
10264,SRIKAKULAM,Vangara,LAKSHMIPETA,86,0,175,261,59,0,1,60,56,1613,0,17,1630,866,0,0,0,0
10265,SRIKAKULAM,Vangara,M.S.R.PURAM,40,13,503,556,6,6,234,246,209,76,82,6744,6902,3725,0,0,1,1
10266,SRIKAKULAM,Vangara,MADDIVALASA,86,3,203,292,48,1,121,170,155,1628,19,4275,5922,3696,0,0,2,2
10267,SRIKAKULAM,Vangara,MADDUVALASA,9,0,299,308,5,0,252,257,245,212,0,15837,16049,8912,0,0,48,48
10268,SRIKAKULAM,Vangara,MAGGURU,37,10,361,408,0,0,2,2,2,0,0,32,32,20,0,0,0,0
10269,SRIKAKULAM,Vangara,MARUVADA,101,2,458,561,83,2,355,440,439,6884,18,16792,23694,14009,39,0,18,57
10270,SRIKAKULAM,Vangara,NEELAYYAVALASA,75,5,263,343,55,2,197,254,271,4279,77,6466,10822,6470,22,0,0,22
10271,SRIKAKULAM,Vangara,PATUVARDHANAM,39,35,280,354,28,27,182,237,220,2307,2036,10759,15102,8242,16,12,24,52
10272,SRIKAKULAM,Vangara,RAJULAGUMADA,116,15,368,499,82,14,271,367,328,2920,446,9490,12856,6906,1,0,4,5
10273,SRIKAKULAM,Vangara,RUSHINGI,30,27,334,391,18,23,237,278,238,1084,1671,14611,17366,8861,3,6,48,57
10274,SRIKAKULAM,Vangara,SANGAM,50,39,331,420,14,26,108,148,146,103,362,1059,1524,1113,0,0,0,0
10275,SRIKAKULAM,Vangara,SIVVAM,87,0,385,472,57,0,55,112,103,805,0,824,1629,899,0,0,0,0
10276,SRIKAKULAM,Vangara,SRIHARIPURAM,58,32,197,287,49,28,158,235,245,4693,2590,14200,21483,10987,33,18,100,151
10277,SRIKAKULAM,Vangara,TALAGAM,161,5,305,471,135,5,181,321,320,10873,54,2378,13305,7639,57,0,0,57
10278,SRIKAKULAM,Vangara,V.V.R.PETA,269,9,330,608,131,6,212,349,314,5210,203,6447,11860,6341,13,1,1,15
10279,SRIKAKULAM,Vangara,VANGARA,59,0,344,403,53,0,312,365,367,1844,0,10490,12334,5885,0,0,2,2
10280,SRIKAKULAM,Vangara,VONI AGRAHARAM,24,20,153,197,18,18,133,169,168,1880,1691,9283,12854,7829,14,10,32,56
10281,SRIKAKULAM,Veeraghattam,ADARU,13,9,382,404,8,8,309,325,332,471,594,19066,20131,11498,1,2,71,74
10282,SRIKAKULAM,Veeraghattam,BITIWADA,94,45,446,585,81,24,309,414,352,4769,1188,12776,18733,10475,10,1,4,15
10283,SRIKAKULAM,Veeraghattam,CHALIVENDRI,230,120,686,1036,88,96,425,609,589,3581,3397,21799,28777,16421,4,6,28,38
10284,SRIKAKULAM,Veeraghattam,CHIDIM,123,8,576,707,90,2,355,447,420,3403,48,10435,13886,7969,0,0,0,0
10285,SRIKAKULAM,Veeraghattam,CHITTIPUDIVALASA,149,0,142,291,111,0,103,214,196,7817,0,7598,15415,9675,36,0,31,67
10286,SRIKAKULAM,Veeraghattam,DASUMANTHA PURAM,43,58,253,354,25,45,189,259,239,1394,1981,14140,17515,9305,3,2,59,64
10287,SRIKAKULAM,Veeraghattam,GADAGAMMA,170,0,176,346,122,0,134,256,258,7342,0,8882,16224,8792,15,0,17,32
10288,SRIKAKULAM,Veeraghattam,HUSSAIN PURAM,168,197,322,687,81,162,188,431,434,3993,12263,5207,21463,11374,5,71,3,79
10289,SRIKAKULAM,Veeraghattam,KAMBARA,180,113,366,659,82,71,124,277,217,844,1364,1855,4063,1857,0,0,0,0
10290,SRIKAKULAM,Veeraghattam,KATHULAKAVITI,134,214,455,803,111,154,314,579,552,3752,6407,11757,21916,11635,3,21,9,33
10291,SRIKAKULAM,Veeraghattam,KIMMI,52,7,221,280,1,3,148,152,155,22,154,6104,6280,3356,0,0,1,1
10292,SRIKAKULAM,Veeraghattam,KOTHUGUMADA,90,0,242,332,72,0,156,228,210,4955,0,4133,9088,4885,20,0,0,20
10293,SRIKAKULAM,Veeraghattam,KUMMARIGUNTA,49,4,232,285,31,4,127,162,150,1459,60,4235,5754,4168,1,0,8,9
10294,SRIKAKULAM,Veeraghattam,NADIMIKELLA,60,22,671,753,15,11,439,465,433,617,488,15778,16883,11503,0,1,2,3
10295,SRIKAKULAM,Veeraghattam,NADUKURU,154,3,734,891,101,1,472,574,576,5691,17,24818,30526,17715,14,0,46,60
10296,SRIKAKULAM,Veeraghattam,NARSIPURAM,79,388,389,856,22,311,268,601,593,372,22139,10374,32885,17351,1,90,4,95
10297,SRIKAKULAM,Veeraghattam,NEELANAGARAM,96,3,322,421,67,3,186,256,253,3300,22,5181,8503,5065,8,0,1,9
10298,SRIKAKULAM,Veeraghattam,P.V.R.PURAM,34,7,280,321,27,1,235,263,252,725,92,14481,15298,8560,0,0,32,32
10299,SRIKAKULAM,Veeraghattam,PANASANANDIVADA,187,8,143,338,122,4,78,204,171,6263,343,3295,9901,6956,11,1,12,24
10300,SRIKAKULAM,Veeraghattam,REGULAPADU,180,5,282,467,132,5,218,355,365,6197,424,10615,17236,8948,5,1,15,21
10301,SRIKAKULAM,Veeraghattam,TALAVARAM,70,1,648,719,42,1,352,395,396,973,36,16076,17085,12976,0,0,21,21
10302,SRIKAKULAM,Veeraghattam,TETTANGI,87,24,298,409,7,9,144,160,170,212,214,3095,3521,2542,0,0,0,0
10303,SRIKAKULAM,Veeraghattam,TUDI,134,17,299,450,77,10,153,240,198,3098,277,4075,7450,4673,3,0,0,3
10304,SRIKAKULAM,Veeraghattam,VANDUVA,96,27,340,463,79,23,263,365,351,3193,578,11115,14886,9059,0,0,6,6
10305,SRIKAKULAM,Veeraghattam,VEERAGHATTAM,435,153,1338,1926,4,15,466,485,409,233,160,17409,17802,11605,1,0,19,20
10306,SRIKAKULAM,Veeraghattam,VIKRAMPURAM,11,2,226,239,8,2,158,168,140,627,75,10237,10939,6465,3,0,28,31
10307,VISAKHAPATANAM,Anakapalli,Akkireddipalem,2,0,353,355,0,0,133,133,123,0,0,10646,10646,8479,0,0,25,25
10308,VISAKHAPATANAM,Anakapalli,Bhatlapudi,15,3,207,225,10,1,143,154,142,896,96,11736,12728,11383,5,0,54,59
10309,VISAKHAPATANAM,Anakapalli,Bowluvada,46,4,562,612,0,0,57,57,43,0,0,602,602,398,0,0,0,0
10310,VISAKHAPATANAM,Anakapalli,Ch.N. Agraharam,19,4,386,409,7,0,140,147,143,374,0,8562,8936,6563,1,0,17,18
10311,VISAKHAPATANAM,Anakapalli,Dibbapalem,1,1,364,366,1,1,212,214,179,44,53,7994,8091,6076,0,0,5,5
10312,VISAKHAPATANAM,Anakapalli,Golagam,16,0,326,342,0,0,156,156,138,0,0,14813,14813,10967,0,0,86,86
10313,VISAKHAPATANAM,Anakapalli,Gopalapuram,1,1,269,271,0,0,145,145,141,0,0,10865,10865,10285,0,0,34,34
10314,VISAKHAPATANAM,Anakapalli,Koduru,52,0,459,511,3,0,300,303,286,220,0,29412,29632,23472,2,0,182,184
10315,VISAKHAPATANAM,Anakapalli,Kondupalem,6,0,310,316,4,0,269,273,235,357,0,27254,27611,17180,3,0,173,176
10316,VISAKHAPATANAM,Anakapalli,Koppaka,8,0,106,114,0,0,0,0,0,0,0,0,0,0,0,0,0,0
10317,VISAKHAPATANAM,Anakapalli,Kothuru,6,16,188,210,0,0,0,0,0,0,0,0,0,0,0,0,0,0
10318,VISAKHAPATANAM,Anakapalli,Kunchangi,87,8,376,471,7,0,128,135,113,202,0,6697,6899,5356,1,0,13,14
10319,VISAKHAPATANAM,Anakapalli,Kundram,38,0,668,706,23,0,429,452,401,1529,0,28593,30122,20935,7,0,85,92
10320,VISAKHAPATANAM,Anakapalli,Makavaram,27,0,194,221,14,0,147,161,145,754,0,11389,12143,8314,3,0,42,45
10321,VISAKHAPATANAM,Anakapalli,Mamidipalem,49,18,394,461,4,6,193,203,191,137,256,9288,9681,6818,0,0,6,6
10322,VISAKHAPATANAM,Anakapalli,Maredupudi,25,1,150,176,0,0,0,0,0,0,0,0,0,0,0,0,0,0
10323,VISAKHAPATANAM,Anakapalli,Marturu,15,0,289,304,4,0,167,171,168,194,0,11997,12191,10521,0,0,36,36
10324,VISAKHAPATANAM,Anakapalli,Mettapalem,26,2,257,285,23,0,204,227,179,1587,0,13390,14977,8523,4,0,27,31
10325,VISAKHAPATANAM,Anakapalli,P.S. Palem,27,0,228,255,12,0,180,192,179,1070,0,18146,19216,12201,6,0,130,136
10326,VISAKHAPATANAM,Anakapalli,Papayyapalem,10,0,100,110,10,0,90,100,83,765,0,7772,8537,5117,4,0,38,42
10327,VISAKHAPATANAM,Anakapalli,Pisinikada,53,0,192,245,0,0,124,124,114,0,0,9361,9361,7863,0,0,41,41
10328,VISAKHAPATANAM,Anakapalli,R.V.palem,12,0,226,238,5,0,144,149,137,147,0,8490,8637,6082,0,0,29,29
10329,VISAKHAPATANAM,Anakapalli,Rajupalem,13,0,119,132,7,0,80,87,80,317,0,5257,5574,4632,0,0,5,5
10330,VISAKHAPATANAM,Anakapalli,Rebaka,11,1,213,225,0,0,128,128,98,0,0,9443,9443,7128,0,0,26,26
10331,VISAKHAPATANAM,Anakapalli,Sampathipuram,41,1,396,438,5,1,38,44,17,41,10,267,318,126,0,0,0,0
10332,VISAKHAPATANAM,Anakapalli,Sankaram,47,0,140,187,1,0,101,102,97,20,0,9811,9831,9140,0,0,82,82
10333,VISAKHAPATANAM,Anakapalli,Satyanarayanapuram,24,25,429,478,3,0,176,179,145,237,0,15311,15548,11931,2,0,98,100
10334,VISAKHAPATANAM,Anakapalli,Seethanagaram,93,0,224,317,43,0,69,112,92,706,0,753,1459,962,0,0,0,0
10335,VISAKHAPATANAM,Anakapalli,Sundarayyapeta,1,0,208,209,0,0,118,118,104,0,0,8900,8900,6140,0,0,56,56
10336,VISAKHAPATANAM,Anakapalli,Tagarampudi,57,14,401,472,33,8,181,222,201,1917,315,11286,13518,9830,6,0,31,37
10337,VISAKHAPATANAM,Anakapalli,Thummapala,49,0,393,442,3,0,126,129,100,30,0,8443,8473,6311,0,0,16,16
10338,VISAKHAPATANAM,Anakapalli,V.J. Palem,53,0,219,272,11,0,113,124,112,595,0,8111,8706,6162,3,0,35,38
10339,VISAKHAPATANAM,Anakapalli,Valluru,32,1,276,309,22,0,223,245,239,625,0,6697,7322,6003,0,0,0,0
10340,VISAKHAPATANAM,Anakapalli,Venkupalem,20,0,220,240,18,0,151,169,135,1207,0,9442,10649,6735,6,0,27,33
10341,VISAKHAPATANAM,Anakapalli,Vooderu,13,0,199,212,7,0,154,161,130,211,0,9962,10173,7195,0,0,21,21
10342,VISAKHAPATANAM,Anandapuram,Anandapuram,51,0,415,466,21,0,324,345,333,1034,0,24599,25633,16220,2,0,97,99
10343,VISAKHAPATANAM,Anandapuram,Bantupallikallalu,0,1,269,270,0,0,168,168,125,0,0,15212,15212,7191,0,0,101,101
10344,VISAKHAPATANAM,Anandapuram,Bheemandorapalem,32,16,193,241,21,10,122,153,150,1520,441,6051,8012,5803,7,0,10,17
10345,VISAKHAPATANAM,Anandapuram,Boni,21,0,282,303,22,0,247,269,237,1480,0,15163,16643,10907,3,0,60,63
10346,VISAKHAPATANAM,Anandapuram,Chandaka,1,1,412,414,0,1,344,345,306,0,28,21975,22003,14473,0,0,66,66
10347,VISAKHAPATANAM,Anandapuram,GAMBHEERAM,5,4,302,311,0,0,120,120,98,0,0,7854,7854,5364,0,0,30,30
10348,VISAKHAPATANAM,Anandapuram,Gandigundam,93,4,309,406,39,1,197,237,233,2145,47,14009,16201,13940,5,0,33,38
10349,VISAKHAPATANAM,Anandapuram,Gidijala,24,1,775,800,4,1,393,398,359,144,112,26996,27252,15229,0,1,89,90
10350,VISAKHAPATANAM,Anandapuram,Gottipalle,80,0,522,602,57,0,137,194,209,4864,0,6859,11723,7718,20,0,12,32
10351,VISAKHAPATANAM,Anandapuram,K. VELLANKI,1,0,8,9,0,0,0,0,0,0,0,0,0,0,0,0,0,0
10352,VISAKHAPATANAM,Anandapuram,Kanamam,34,0,321,355,28,0,258,286,293,2129,0,22303,24432,15863,9,0,102,111
10353,VISAKHAPATANAM,Anandapuram,Kasuluvada,46,60,520,626,17,47,236,300,252,1056,3767,17122,21945,13271,2,14,58,74
10354,VISAKHAPATANAM,Anandapuram,Kolavanipalem,15,1,213,229,11,1,171,183,174,870,97,13728,14695,11190,4,0,72,76
10355,VISAKHAPATANAM,Anandapuram,Lodagalavanipalem,33,1,393,427,11,1,124,136,96,130,2,6264,6396,4047,0,0,21,21
10356,VISAKHAPATANAM,Anandapuram,Mamidilova,62,54,541,657,24,40,263,327,308,596,1830,20023,22449,13626,1,1,74,76
10357,VISAKHAPATANAM,Anandapuram,Mukundapuram,4,0,199,203,0,0,153,153,146,0,0,11399,11399,8710,0,0,35,35
10358,VISAKHAPATANAM,Anandapuram,Mutcherla,10,27,367,404,6,25,277,308,303,456,2323,19115,21894,12003,0,15,64,79
10359,VISAKHAPATANAM,Anandapuram,Palavalasa,11,0,343,354,5,0,288,293,274,244,0,18574,18818,12882,1,0,47,48
10360,VISAKHAPATANAM,Anandapuram,Pandalapaka,37,0,266,303,25,0,217,242,220,2107,0,16607,18714,9729,12,0,77,89
10361,VISAKHAPATANAM,Anandapuram,Peddipalem,58,1,241,300,50,1,188,239,220,2822,118,11354,14294,8760,9,1,27,37
10362,VISAKHAPATANAM,Anandapuram,Pekeru,42,0,196,238,34,0,142,176,161,2243,0,11175,13418,9621,7,0,50,57
10363,VISAKHAPATANAM,Anandapuram,Ramavaram,20,6,270,296,5,6,205,216,199,310,410,16540,17260,14893,0,1,82,83
10364,VISAKHAPATANAM,Anandapuram,Sirlapalem,5,0,223,228,4,0,171,175,159,291,0,8533,8824,5749,1,0,7,8
10365,VISAKHAPATANAM,Anandapuram,Sontyam,11,0,897,908,2,0,545,547,572,91,0,28393,28484,18889,0,0,38,38
10366,VISAKHAPATANAM,Anandapuram,Tarluvada,96,1,226,323,69,1,133,203,145,4098,20,12097,16215,7737,13,0,71,84
10367,VISAKHAPATANAM,Anandapuram,VELLANKI,0,0,0,0,0,0,0,0,0,0,0,0,0,0,0,0,0,0
10368,VISAKHAPATANAM,Anandapuram,Vemulavalasa,64,1,107,172,0,0,0,0,0,0,0,0,0,0,0,0,0,0
10369,VISAKHAPATANAM,Ananthagiri,Ananthagiri,3,500,2,505,0,409,0,409,453,0,35076,0,35076,18028,0,196,0,196
10370,VISAKHAPATANAM,Ananthagiri,BHEEMAPOLU,1,603,7,611,0,448,3,451,459,0,27094,21,27115,13397,0,94,0,94
10371,VISAKHAPATANAM,Ananthagiri,Borra,23,431,4,458,1,283,1,285,282,88,19475,20,19583,9414,0,84,0,84
10372,VISAKHAPATANAM,Ananthagiri,Chilakalagedda,3,600,13,616,1,356,9,366,322,18,17520,164,17702,8513,0,36,0,36
10373,VISAKHAPATANAM,Ananthagiri,Garugubilli,45,362,6,413,41,235,6,282,299,3514,13316,669,17499,9601,20,41,5,66
10374,VISAKHAPATANAM,Ananthagiri,Gumma,1,452,0,453,1,350,0,351,376,18,28157,0,28175,13172,0,138,0,138
10375,VISAKHAPATANAM,Ananthagiri,Gummakota,27,650,6,683,24,404,3,431,442,1223,13546,132,14901,7507,5,12,0,17
10376,VISAKHAPATANAM,Ananthagiri,Jeenabadu,5,445,81,531,5,330,76,411,381,552,19155,6044,25751,12965,4,54,25,83
10377,VISAKHAPATANAM,Ananthagiri,Kasipatnam,19,533,11,563,18,355,8,381,397,901,27897,317,29115,15958,2,140,0,142
10378,VISAKHAPATANAM,Ananthagiri,KIVARLA,0,634,0,634,0,519,0,519,522,0,33960,0,33960,16284,0,101,0,101
10379,VISAKHAPATANAM,Ananthagiri,Kondiba,3,541,0,544,0,447,0,447,576,0,40209,0,40209,20994,0,210,0,210
10380,VISAKHAPATANAM,Ananthagiri,Kotturu,0,554,0,554,0,285,0,285,267,0,20031,0,20031,9474,0,95,0,95
10381,VISAKHAPATANAM,Ananthagiri,Kunapuram,0,447,0,447,0,367,0,367,422,0,32584,0,32584,16159,0,167,0,167
10382,VISAKHAPATANAM,Ananthagiri,Lungaparti,2,674,0,676,0,572,0,572,607,0,37052,0,37052,17805,0,100,0,100
10383,VISAKHAPATANAM,Ananthagiri,Narasimharajupuram,0,535,6,541,0,358,1,359,413,0,21025,23,21048,11200,0,74,0,74
10384,VISAKHAPATANAM,Ananthagiri,Pedabidda,0,565,0,565,0,448,0,448,505,0,27982,0,27982,13603,0,75,0,75
10385,VISAKHAPATANAM,Ananthagiri,Pedakota,0,721,0,721,0,608,0,608,599,0,33509,0,33509,16075,0,78,0,78
10386,VISAKHAPATANAM,Ananthagiri,Pinakota,1,738,1,740,0,561,1,562,591,0,26183,7,26190,12865,0,52,0,52
10387,VISAKHAPATANAM,Ananthagiri,Pynampadu,0,452,0,452,0,385,0,385,473,0,29070,0,29070,14600,0,119,0,119
10388,VISAKHAPATANAM,Ananthagiri,Rampalle,0,511,2,513,0,401,2,403,438,0,15994,65,16059,8063,0,11,0,11
10389,VISAKHAPATANAM,Ananthagiri,Tokuru,1,488,4,493,0,381,0,381,459,0,32427,0,32427,16338,0,161,0,161
10390,VISAKHAPATANAM,Ananthagiri,Valasi,1,401,0,402,1,387,0,388,478,112,34825,0,34937,18358,1,180,0,181
10391,VISAKHAPATANAM,Ananthagiri,Vengada,5,504,0,509,0,390,0,390,490,0,34237,0,34237,17203,0,183,0,183
10392,VISAKHAPATANAM,Ananthagiri,Yeguvasoba,1,493,3,497,0,378,1,379,437,0,32383,113,32496,16698,0,174,1,175
10393,VISAKHAPATANAM,Araku Valley,Baski,2,1494,1,1497,2,1166,1,1169,1359,74,83103,54,83231,42509,0,281,0,281
10394,VISAKHAPATANAM,Araku Valley,Bondem,2,735,2,739,2,560,0,562,612,153,41856,0,42009,21366,1,182,0,183
10395,VISAKHAPATANAM,Araku Valley,Chinalabudu,0,1330,0,1330,0,1023,0,1023,1057,0,69207,0,69207,36447,0,241,0,241
10396,VISAKHAPATANAM,Araku Valley,Chompi,8,623,2,633,1,435,0,436,448,30,27346,0,27376,15337,0,52,0,52
10397,VISAKHAPATANAM,Araku Valley,GANNELA,13,1139,0,1152,2,757,0,759,912,48,45859,0,45907,23605,0,126,0,126
10398,VISAKHAPATANAM,Araku Valley,Iragai,2,576,0,578,1,447,0,448,541,52,26057,0,26109,13466,0,62,0,62
10399,VISAKHAPATANAM,Araku Valley,Kothabhalluguda,8,943,0,951,4,760,0,764,858,302,61070,0,61372,34915,1,281,0,282
10400,VISAKHAPATANAM,Araku Valley,Lotheru,2,1232,0,1234,1,796,0,797,916,36,45326,0,45362,23252,0,55,0,55
10401,VISAKHAPATANAM,Araku Valley,Madagada,4,1914,16,1934,2,1406,16,1424,1652,94,84235,658,84987,45078,0,186,1,187
10402,VISAKHAPATANAM,Araku Valley,Madala,8,1003,0,1011,4,788,0,792,809,228,50882,0,51110,25639,0,68,0,68
10403,VISAKHAPATANAM,Araku Valley,Padmapuram,8,1102,46,1156,2,754,23,779,852,184,40533,1752,42469,23319,1,85,6,92
10404,VISAKHAPATANAM,Araku Valley,Peda labudu,14,1440,25,1479,8,1101,12,1121,1270,359,71110,617,72086,39861,0,149,0,149
10405,VISAKHAPATANAM,Araku Valley,Siragam,3,826,1,830,3,724,0,727,739,41,41190,0,41231,21094,0,78,0,78
10406,VISAKHAPATANAM,Araku Valley,Sunkarametta,0,979,1,980,0,816,1,817,833,0,54613,132,54745,28510,0,162,1,163
10407,VISAKHAPATANAM,Atchutapuram,Atchutha puram,0,1,1,2,0,0,0,0,0,0,0,0,0,0,0,0,0,0
10408,VISAKHAPATANAM,Atchutapuram,Avasomavaram,16,0,146,162,0,0,0,0,0,0,0,0,0,0,0,0,0,0
10409,VISAKHAPATANAM,Atchutapuram,Bhogapuram,1,0,0,1,0,0,0,0,0,0,0,0,0,0,0,0,0,0
10410,VISAKHAPATANAM,Atchutapuram,Cheemalapalli,4,0,45,49,0,0,0,0,0,0,0,0,0,0,0,0,0,0
10411,VISAKHAPATANAM,Atchutapuram,Chippada,2,0,178,180,0,0,0,0,0,0,0,0,0,0,0,0,0,0
10412,VISAKHAPATANAM,Atchutapuram,Chodapalli,50,1,427,478,0,0,4,4,1,0,0,71,71,17,0,0,0,0
10413,VISAKHAPATANAM,Atchutapuram,Dibbapalem,0,0,0,0,0,0,0,0,0,0,0,0,0,0,0,0,0,0
10414,VISAKHAPATANAM,Atchutapuram,Dopperla,18,0,320,338,0,0,5,5,1,0,0,28,28,5,0,0,0,0
10415,VISAKHAPATANAM,Atchutapuram,Dosuru,66,0,443,509,0,0,5,5,5,0,0,45,45,39,0,0,0,0
10416,VISAKHAPATANAM,Atchutapuram,Duppituru,4,0,40,44,0,0,6,6,5,0,0,102,102,90,0,0,0,0
10417,VISAKHAPATANAM,Atchutapuram,Haripalem,102,3,515,620,18,0,92,110,105,1068,0,5280,6348,5925,2,0,12,14
10418,VISAKHAPATANAM,Atchutapuram,Iruvada,0,0,1,1,0,0,0,0,0,0,0,0,0,0,0,0,0,0
10419,VISAKHAPATANAM,Atchutapuram,Jaggannapeta,42,0,302,344,27,0,190,217,200,1679,0,9803,11482,8198,5,0,16,21
10420,VISAKHAPATANAM,Atchutapuram,Janguluru,0,0,0,0,0,0,0,0,0,0,0,0,0,0,0,0,0,0
10421,VISAKHAPATANAM,Atchutapuram,Khajipalem,41,1,377,419,18,1,210,229,204,575,66,8353,8994,5581,0,0,1,1
10422,VISAKHAPATANAM,Atchutapuram,Kondakarla,106,1,556,663,0,0,56,56,42,0,0,531,531,303,0,0,0,0
10423,VISAKHAPATANAM,Atchutapuram,M.JAGANADHAPURAM,62,1,508,571,39,0,160,199,183,2902,0,6754,9656,5570,13,0,11,24
10424,VISAKHAPATANAM,Atchutapuram,Maduthuru,120,0,296,416,0,0,0,0,0,0,0,0,0,0,0,0,0,0
10425,VISAKHAPATANAM,Atchutapuram,Maruturu,67,0,344,411,1,0,8,9,9,24,0,138,162,96,0,0,0,0
10426,VISAKHAPATANAM,Atchutapuram,Nunaparthi,0,0,0,0,0,0,0,0,0,0,0,0,0,0,0,0,0,0
10427,VISAKHAPATANAM,Atchutapuram,Pedapadu,78,0,565,643,40,0,309,349,324,1768,0,12449,14217,8991,0,0,8,8
10428,VISAKHAPATANAM,Atchutapuram,Pudimadaka,62,0,597,659,0,0,34,34,24,0,0,495,495,264,0,0,0,0
10429,VISAKHAPATANAM,Atchutapuram,Tantadi,2,28,430,460,0,0,116,116,108,0,0,7427,7427,5656,0,0,19,19
10430,VISAKHAPATANAM,Atchutapuram,Thimmarajupeta,36,0,426,462,2,0,64,66,56,40,0,3735,3775,2587,0,0,7,7
10431,VISAKHAPATANAM,Atchutapuram,Uppavaram,47,2,637,686,5,0,58,63,49,113,0,1085,1198,734,0,0,0,0
10432,VISAKHAPATANAM,Atchutapuram,Veduruvada,42,0,402,444,0,0,209,209,173,0,0,11814,11814,8100,0,0,27,27
10433,VISAKHAPATANAM,Atchutapuram,Yerravaram,4,0,71,75,0,0,5,5,5,0,0,66,66,46,0,0,0,0
10434,VISAKHAPATANAM,Bheemunipatnam,Amanam,20,0,544,564,16,0,355,371,361,266,0,11673,11939,7213,0,0,19,19
10435,VISAKHAPATANAM,Bheemunipatnam,Annavaram,17,0,228,245,13,0,138,151,171,1146,0,13075,14221,13674,3,0,65,68
10436,VISAKHAPATANAM,Bheemunipatnam,Bodamettapalem,0,0,99,99,0,0,69,69,67,0,0,3348,3348,2285,0,0,10,10
10437,VISAKHAPATANAM,Bheemunipatnam,Chepaluppada,55,0,223,278,34,0,75,109,83,1984,0,4100,6084,4250,3,0,20,23
10438,VISAKHAPATANAM,Bheemunipatnam,Chippada,26,0,96,122,0,0,46,46,43,0,0,3747,3747,2515,0,0,22,22
10439,VISAKHAPATANAM,Bheemunipatnam,Dakamarri,14,0,441,455,11,0,262,273,214,626,0,13228,13854,5868,1,0,5,6
10440,VISAKHAPATANAM,Bheemunipatnam,J.V. Agaraharam,8,0,393,401,0,0,124,124,92,0,0,9489,9489,5960,0,0,55,55
10441,VISAKHAPATANAM,Bheemunipatnam,K. Nagarapalem,1,0,386,387,0,0,64,64,59,0,0,5593,5593,4312,0,0,30,30
10442,VISAKHAPATANAM,Bheemunipatnam,Kapuluppada,39,1,266,306,30,0,167,197,173,3362,0,19615,22977,11229,22,0,133,155
10443,VISAKHAPATANAM,Bheemunipatnam,Laxmipuram,2,1,312,315,0,0,202,202,182,0,0,5948,5948,4378,0,0,2,2
10444,VISAKHAPATANAM,Bheemunipatnam,Majjipeta,8,0,295,303,6,0,260,266,247,252,0,15089,15341,9462,0,0,21,21
10445,VISAKHAPATANAM,Bheemunipatnam,Majjivalasa,45,0,236,281,37,0,89,126,120,2969,0,7242,10211,8171,12,0,17,29
10446,VISAKHAPATANAM,Bheemunipatnam,Mulakuddu,43,0,206,249,10,0,149,159,131,643,0,9077,9720,6788,1,0,14,15
10447,VISAKHAPATANAM,Bheemunipatnam,Narayanarajupeta,15,0,106,121,14,0,106,120,103,1528,0,10728,12256,7533,14,0,90,104
10448,VISAKHAPATANAM,Bheemunipatnam,Nidigattu,49,1,142,192,37,0,91,128,114,2262,0,7838,10100,5815,10,0,47,57
10449,VISAKHAPATANAM,Bheemunipatnam,PEDANAGAMAYYAPALEM,2,0,375,377,1,0,112,113,108,2,0,6507,6509,5191,0,0,20,20
10450,VISAKHAPATANAM,Bheemunipatnam,Rekhavanipalem,45,0,162,207,29,0,57,86,82,1721,0,3627,5348,4922,5,0,18,23
10451,VISAKHAPATANAM,Bheemunipatnam,Singanabanda,21,0,442,463,19,0,219,238,206,1839,0,15591,17430,9368,10,0,52,62
10452,VISAKHAPATANAM,Bheemunipatnam,T.NAGARAPALEM,16,0,219,235,0,0,111,111,92,0,0,7795,7795,6682,0,0,43,43
10453,VISAKHAPATANAM,Bheemunipatnam,Tallavalasa,6,0,244,250,4,0,54,58,36,32,0,660,692,453,0,0,0,0
10454,VISAKHAPATANAM,Bheemunipatnam,Tatituru,17,1,352,370,8,0,219,227,203,312,0,17238,17550,12008,0,0,81,81
10455,VISAKHAPATANAM,Butchayyapeta,Butchayyapeta,86,0,1497,1583,54,0,1028,1082,1070,3392,0,61535,64927,33293,11,0,123,134
10456,VISAKHAPATANAM,Butchayyapeta,Chinappannapalem,47,1,330,378,26,0,211,237,185,1366,0,9962,11328,6231,4,0,23,27
10457,VISAKHAPATANAM,Butchayyapeta,Chintapaka,49,10,553,612,23,1,256,280,234,1243,24,15062,16329,9205,4,0,49,53
10458,VISAKHAPATANAM,Butchayyapeta,CHITTIYYAPALEM,49,0,469,518,17,0,308,325,309,606,0,19564,20170,11673,1,0,52,53
10459,VISAKHAPATANAM,Butchayyapeta,Dibbidi,17,0,452,469,8,0,403,411,406,272,0,26339,26611,15730,0,0,90,90
10460,VISAKHAPATANAM,Butchayyapeta,Gantikorlam,37,20,245,302,26,12,157,195,191,1543,885,10430,12858,8303,6,3,25,34
10461,VISAKHAPATANAM,Butchayyapeta,Gunnempudi,30,0,580,610,8,0,512,520,576,282,0,25837,26119,16026,0,0,47,47
10462,VISAKHAPATANAM,Butchayyapeta,K.P. Agrahram,3,3,340,346,0,3,299,302,308,0,139,22875,23014,13258,0,1,104,105
10463,VISAKHAPATANAM,Butchayyapeta,Kandipudi,3,0,324,327,3,0,282,285,268,86,0,14294,14380,9393,0,0,22,22
10464,VISAKHAPATANAM,Butchayyapeta,Karaka,29,0,224,253,20,0,188,208,219,1542,0,15819,17361,11155,4,0,77,81
10465,VISAKHAPATANAM,Butchayyapeta,Komallapudi,14,0,391,405,8,0,311,319,298,429,0,22063,22492,12070,0,0,77,77
10466,VISAKHAPATANAM,Butchayyapeta,Kondalalem,26,0,306,332,14,0,184,198,188,760,0,12281,13041,6615,2,0,39,41
10467,VISAKHAPATANAM,Butchayyapeta,Kondempudi,9,0,240,249,1,0,165,166,85,49,0,10958,11007,3309,0,0,50,50
10468,VISAKHAPATANAM,Butchayyapeta,L. B. P. Agrahram,47,0,376,423,13,0,251,264,227,424,0,20014,20438,12273,0,0,92,92
10469,VISAKHAPATANAM,Butchayyapeta,L. Singavaram,33,0,189,222,14,0,154,168,158,1261,0,14647,15908,9174,9,0,100,109
10470,VISAKHAPATANAM,Butchayyapeta,LOPUDI,203,0,396,599,118,0,231,349,300,9166,0,17504,26670,13281,29,0,66,95
10471,VISAKHAPATANAM,Butchayyapeta,Mallam,14,0,548,562,2,0,323,325,314,74,0,16756,16830,12570,0,0,38,38
10472,VISAKHAPATANAM,Butchayyapeta,Mangalapuram,38,0,299,337,0,0,107,107,101,0,0,3113,3113,2072,0,0,1,1
10473,VISAKHAPATANAM,Butchayyapeta,Neelakantapuram,5,0,238,243,4,0,184,188,173,93,0,6364,6457,3992,0,0,2,2
10474,VISAKHAPATANAM,Butchayyapeta,P. Bheemavaram,17,0,368,385,13,0,217,230,208,314,0,6567,6881,3431,0,0,2,2
10475,VISAKHAPATANAM,Butchayyapeta,Peda madina,97,0,531,628,52,0,370,422,400,2624,0,21775,24399,12848,5,0,41,46
10476,VISAKHAPATANAM,Butchayyapeta,Pedapudi,42,0,709,751,19,0,413,432,398,904,0,22191,23095,13568,0,0,46,46
10477,VISAKHAPATANAM,Butchayyapeta,Pedapudi Agraharam,2,0,548,550,1,0,329,330,341,43,0,19097,19140,9898,0,0,42,42
10478,VISAKHAPATANAM,Butchayyapeta,Polepalle,2,1,390,393,2,1,277,280,269,118,75,21658,21851,12957,0,0,85,85
10479,VISAKHAPATANAM,Butchayyapeta,Pottidorapalem,28,0,454,482,18,0,389,407,408,905,0,24111,25016,13696,2,0,44,46
10480,VISAKHAPATANAM,Butchayyapeta,R. Bheemavaram,37,3,589,629,10,0,321,331,320,514,0,14883,15397,8726,0,0,26,26
10481,VISAKHAPATANAM,Butchayyapeta,R.Sivaramapuram,2,0,372,374,0,0,234,234,246,0,0,11075,11075,6652,0,0,17,17
10482,VISAKHAPATANAM,Butchayyapeta,Rajam,87,3,876,966,26,2,416,444,375,490,66,16332,16888,10297,0,0,14,14
10483,VISAKHAPATANAM,Butchayyapeta,Turakalapudi,85,3,394,482,60,1,302,363,333,4571,95,21754,26420,16702,23,0,77,100
10484,VISAKHAPATANAM,Butchayyapeta,TYPURAM,3,0,219,222,2,0,156,158,156,120,0,10082,10202,6625,0,0,34,34
10485,VISAKHAPATANAM,Butchayyapeta,Vaddadi,324,0,673,997,142,0,217,359,306,7653,0,10873,18526,11851,18,0,26,44
10486,VISAKHAPATANAM,Butchayyapeta,Vijayaramarajupeta,93,0,545,638,29,0,200,229,114,989,0,9683,10672,4809,2,0,15,17
10487,VISAKHAPATANAM,Cheedikada,Adavi Agraharam,1,1,222,224,0,1,184,185,180,0,8,9417,9425,6127,0,0,19,19
10488,VISAKHAPATANAM,Cheedikada,Appalarajupuram,34,1,244,279,30,0,183,213,159,2590,0,15918,18508,10185,15,0,72,87
10489,VISAKHAPATANAM,Cheedikada,Arjunagiri,32,2,601,635,27,0,514,541,502,1862,0,43028,44890,26022,8,0,217,225
10490,VISAKHAPATANAM,Cheedikada,B. Singavaram,7,0,170,177,4,0,130,134,103,197,0,9628,9825,4484,1,0,43,44
10491,VISAKHAPATANAM,Cheedikada,Bylapudi,13,0,398,411,8,0,277,285,301,611,0,23207,23818,14474,4,0,111,115
10492,VISAKHAPATANAM,Cheedikada,Cheedikada,68,39,957,1064,53,6,658,717,559,4790,425,58376,63591,31801,36,1,374,411
10493,VISAKHAPATANAM,Cheedikada,Cheedipalle,30,0,367,397,14,0,282,296,275,914,0,22335,23249,12626,2,0,89,91
10494,VISAKHAPATANAM,Cheedikada,Chettupalle,21,1,199,221,14,0,151,165,148,1375,0,14783,16158,10100,8,0,99,107
10495,VISAKHAPATANAM,Cheedikada,Chukkapalle,12,1,610,623,11,1,533,545,528,661,121,38860,39642,24276,2,1,152,155
10496,VISAKHAPATANAM,Cheedikada,Dandisuravaram,23,0,364,387,18,0,271,289,202,1231,0,17815,19046,9142,4,0,65,69
10497,VISAKHAPATANAM,Cheedikada,Dibbapalem,17,0,615,632,0,0,265,265,222,0,0,11769,11769,6172,0,0,33,33
10498,VISAKHAPATANAM,Cheedikada,G. Kothapalle,41,0,506,547,28,0,374,402,300,1750,0,28719,30469,13888,4,0,108,112
10499,VISAKHAPATANAM,Cheedikada,J.B. Puram,15,0,452,467,12,0,323,335,328,671,0,22119,22790,14248,2,0,78,80
10500,VISAKHAPATANAM,Cheedikada,Jaithavaram,20,0,297,317,13,0,237,250,180,992,0,19321,20313,10205,4,0,106,110
10501,VISAKHAPATANAM,Cheedikada,Khandivara,48,2,657,707,26,1,407,434,320,2341,78,31628,34047,18974,14,0,130,144
10502,VISAKHAPATANAM,Cheedikada,Konam,70,546,126,742,45,255,68,368,294,3091,13215,4169,20475,10075,10,36,3,49
10503,VISAKHAPATANAM,Cheedikada,L.B. Patnam,25,6,250,281,16,5,199,220,135,961,229,7496,8686,3669,3,0,9,12
10504,VISAKHAPATANAM,Cheedikada,Manchala,20,93,296,409,15,53,188,256,190,1338,3282,15535,20155,10286,6,5,63,74
10505,VISAKHAPATANAM,Cheedikada,Pedagogada,8,0,251,259,7,0,201,208,167,620,0,19021,19641,9810,4,0,130,134
10506,VISAKHAPATANAM,Cheedikada,Sirijam,44,52,444,540,25,40,240,305,252,2105,2113,15700,19918,10806,8,5,58,71
10507,VISAKHAPATANAM,Cheedikada,Tunivalasa,11,0,302,313,10,0,262,272,237,308,0,16790,17098,9766,0,0,46,46
10508,VISAKHAPATANAM,Cheedikada,Turuvolu,88,0,970,1058,47,0,670,717,593,3222,0,53652,56874,29307,16,0,262,278
10509,VISAKHAPATANAM,Cheedikada,Veerabhadrapeta,46,98,132,276,38,57,82,177,148,3070,3550,6468,13088,7135,15,3,32,50
10510,VISAKHAPATANAM,Chintapalle,Annavaram,4,662,19,685,1,501,6,508,647,20,28258,57,28335,14999,0,88,0,88
10511,VISAKHAPATANAM,Chintapalle,BALAPAM,2,1198,0,1200,1,745,0,746,873,12,46465,0,46477,23828,0,178,0,178
10512,VISAKHAPATANAM,Chintapalle,Bennavaram,1,760,0,761,0,649,0,649,678,0,37949,0,37949,18744,0,73,0,73
10513,VISAKHAPATANAM,Chintapalle,Chinthapalli,12,1327,55,1394,0,453,3,456,412,0,20734,52,20786,10467,0,38,0,38
10514,VISAKHAPATANAM,Chintapalle,Chowdupalli,11,1529,0,1540,11,885,0,896,864,848,51219,0,52067,24626,5,125,0,130
10515,VISAKHAPATANAM,Chintapalle,Gondipakalu,1,778,0,779,1,474,0,475,516,6,26829,0,26835,13100,0,76,0,76
10516,VISAKHAPATANAM,Chintapalle,Kitumula,0,799,1,800,0,572,0,572,583,0,33692,0,33692,16847,0,116,0,116
10517,VISAKHAPATANAM,Chintapalle,Kommangi,1,799,0,800,1,625,0,626,664,12,34715,0,34727,17820,0,92,0,92
10518,VISAKHAPATANAM,Chintapalle,Kothapalem,2,1237,6,1245,2,991,5,998,1117,113,56391,310,56814,28219,0,111,0,111
10519,VISAKHAPATANAM,Chintapalle,KUDUMUSARI,1,834,0,835,0,542,0,542,587,0,34547,0,34547,16768,0,76,0,76
10520,VISAKHAPATANAM,Chintapalle,LAMMASINGI,1,706,16,723,0,527,1,528,478,0,22941,20,22961,10988,0,52,0,52
10521,VISAKHAPATANAM,Chintapalle,Lothugedda,9,1237,40,1286,2,869,5,876,937,62,55920,282,56264,28208,0,128,0,128
10522,VISAKHAPATANAM,Chintapalle,Pedaberada,7,1177,47,1231,2,916,19,937,1085,96,57858,542,58496,30286,0,161,1,162
10523,VISAKHAPATANAM,Chintapalle,Senivaram,6,827,0,833,6,588,0,594,627,324,29084,0,29408,14583,0,45,0,45
10524,VISAKHAPATANAM,Chintapalle,Tajangi,4,1386,3,1393,1,818,0,819,770,126,34511,0,34637,16902,1,45,0,46
10525,VISAKHAPATANAM,Chintapalle,TAMMINGULA,1,767,0,768,0,466,0,466,480,0,25451,0,25451,12096,0,61,0,61
10526,VISAKHAPATANAM,Chintapalle,Yerrabommalu,7,976,1,984,2,754,1,757,730,57,39306,12,39375,18297,0,91,0,91
10527,VISAKHAPATANAM,Chodavaram,Adduru,35,1,467,503,2,1,210,213,193,10,87,10163,10260,5941,0,0,19,19
10528,VISAKHAPATANAM,Chodavaram,Amberupuram,58,0,486,544,4,0,228,232,192,112,0,9848,9960,6056,0,0,8,8
10529,VISAKHAPATANAM,Chodavaram,Ankupalem,42,0,292,334,5,0,97,102,66,56,0,2199,2255,878,0,0,0,0
10530,VISAKHAPATANAM,Chodavaram,Bennavolu,24,0,431,455,10,0,245,255,227,736,0,5260,5996,2980,3,0,0,3
10531,VISAKHAPATANAM,Chodavaram,Bhogapuram,32,3,373,408,4,1,35,40,25,158,4,707,869,585,0,0,0,0
10532,VISAKHAPATANAM,Chodavaram,Chakipalle,49,0,452,501,34,0,345,379,307,702,0,16164,16866,9530,0,0,22,22
10533,VISAKHAPATANAM,Chodavaram,Chodavaram,143,6,894,1043,33,0,386,419,296,1241,0,18421,19662,10538,3,0,40,43
10534,VISAKHAPATANAM,Chodavaram,Damunapalle,7,0,143,150,1,0,79,80,69,37,0,3047,3084,2108,0,0,1,1
10535,VISAKHAPATANAM,Chodavaram,Duddupalem,18,7,549,574,4,0,184,188,170,141,0,7230,7371,5620,0,0,2,2
10536,VISAKHAPATANAM,Chodavaram,G.Jagannadhapuram,20,0,308,328,0,0,48,48,19,0,0,1409,1409,479,0,0,0,0
10537,VISAKHAPATANAM,Chodavaram,Gajapathinagaram,27,0,192,219,4,0,24,28,10,8,0,221,229,84,0,0,0,0
10538,VISAKHAPATANAM,Chodavaram,Gandhavaram,9,0,285,294,1,0,111,112,101,40,0,7498,7538,4730,0,0,26,26
10539,VISAKHAPATANAM,Chodavaram,Gandhigram,163,7,250,420,3,0,7,10,5,19,0,76,95,27,0,0,0,0
10540,VISAKHAPATANAM,Chodavaram,Gavaravaram,38,0,303,341,27,0,111,138,106,2210,0,7333,9543,5238,14,0,24,38
10541,VISAKHAPATANAM,Chodavaram,Govada,32,2,288,322,1,0,5,6,3,12,0,40,52,28,0,0,0,0
10542,VISAKHAPATANAM,Chodavaram,Gowripatnam,102,0,612,714,46,0,252,298,235,2046,0,10379,12425,6370,2,0,2,4
10543,VISAKHAPATANAM,Chodavaram,Jannavaram,13,0,368,381,8,0,178,186,151,665,0,11674,12339,7746,2,0,40,42
10544,VISAKHAPATANAM,Chodavaram,Juttada,37,0,272,309,0,0,24,24,12,0,0,713,713,328,0,0,2,2
10545,VISAKHAPATANAM,Chodavaram,Kannampalem,12,0,309,321,11,0,276,287,268,952,0,26354,27306,14573,5,0,158,163
10546,VISAKHAPATANAM,Chodavaram,Khandipalle,47,0,472,519,23,0,300,323,295,766,0,20884,21650,13062,2,0,95,97
10547,VISAKHAPATANAM,Chodavaram,Lakkavaram,111,6,966,1083,66,4,357,427,215,4822,415,14677,19914,7745,22,2,14,38
10548,VISAKHAPATANAM,Chodavaram,Laxmipuram,46,1,529,576,8,0,186,194,157,328,0,10578,10906,6262,1,0,20,21
10549,VISAKHAPATANAM,Chodavaram,Muddurthi,27,0,315,342,1,0,165,166,146,29,0,9392,9421,6551,0,0,17,17
10550,VISAKHAPATANAM,Chodavaram,Mycherlapalem,13,0,221,234,11,0,199,210,208,871,0,18276,19147,11109,4,0,101,105
10551,VISAKHAPATANAM,Chodavaram,Narasayyapeta,7,0,217,224,0,0,12,12,9,0,0,410,410,200,0,0,0,0
10552,VISAKHAPATANAM,Chodavaram,Narsapuram,1,0,262,263,1,0,173,174,117,8,0,8765,8773,4472,0,0,21,21
10553,VISAKHAPATANAM,Chodavaram,Rayapurajupeta,27,1,128,156,20,0,88,108,94,1351,0,4505,5856,4189,6,0,14,20
10554,VISAKHAPATANAM,Chodavaram,Seemunapalle,30,0,141,171,17,0,130,147,118,841,0,8006,8847,4722,3,0,28,31
10555,VISAKHAPATANAM,Chodavaram,Siimhadripuram,16,0,183,199,0,0,19,19,1,0,0,354,354,12,0,0,0,0
10556,VISAKHAPATANAM,Chodavaram,Sreerampatnam,12,0,189,201,9,0,111,120,116,493,0,3949,4442,2325,1,0,2,3
10557,VISAKHAPATANAM,Chodavaram,Thimmannapalem,11,0,155,166,10,0,122,132,113,919,0,9688,10607,6134,4,0,34,38
10558,VISAKHAPATANAM,Chodavaram,Venkannapalem,6,3,375,384,2,0,253,255,266,40,0,13096,13136,9787,0,0,21,21
10559,VISAKHAPATANAM,Devarapalle,ALAMANDA,0,0,0,0,0,0,0,0,0,0,0,0,0,0,0,0,0,0
10560,VISAKHAPATANAM,Devarapalle,Alamanda Kothapalle,13,1,624,638,7,0,349,356,330,77,0,17300,17377,11083,0,0,24,24
10561,VISAKHAPATANAM,Devarapalle,Boila kintada,25,6,389,420,17,0,205,222,220,1025,0,11033,12058,7017,1,0,19,20
10562,VISAKHAPATANAM,Devarapalle,Chinanandipalle,15,0,284,299,5,0,137,142,99,209,0,5833,6042,3176,1,0,10,11
10563,VISAKHAPATANAM,Devarapalle,Chintalapudi,5,418,11,434,1,273,1,275,249,57,14276,58,14391,6904,0,51,0,51
10564,VISAKHAPATANAM,Devarapalle,Devarapalle,113,20,666,799,73,0,213,286,261,3667,0,5943,9610,7501,0,0,0,0
10565,VISAKHAPATANAM,Devarapalle,Garisingi,53,237,391,681,37,95,250,382,350,1872,3463,13901,19236,9871,5,3,19,27
10566,VISAKHAPATANAM,Devarapalle,K.M.PALEM,6,0,299,305,2,0,129,131,105,167,0,8887,9054,4674,1,0,25,26
10567,VISAKHAPATANAM,Devarapalle,Kaligotla,23,0,318,341,17,0,216,233,129,646,0,5050,5696,1553,0,0,2,2
10568,VISAKHAPATANAM,Devarapalle,Kasipuram,36,5,304,345,23,0,176,199,134,1339,0,8806,10145,5472,2,0,8,10
10569,VISAKHAPATANAM,Devarapalle,Kothapenta,24,8,424,456,1,0,166,167,110,2,0,4174,4176,1785,0,0,0,0
10570,VISAKHAPATANAM,Devarapalle,M. Alamanda,36,0,203,239,22,0,126,148,62,1236,0,2468,3704,1228,1,0,1,2
10571,VISAKHAPATANAM,Devarapalle,Mamidipalli,35,1,309,345,0,0,53,53,37,0,0,1013,1013,462,0,0,0,0
10572,VISAKHAPATANAM,Devarapalle,Marepalli,7,0,340,347,4,0,261,265,198,302,0,14258,14560,8958,0,0,42,42
10573,VISAKHAPATANAM,Devarapalle,Mulakala palle,26,0,250,276,13,0,216,229,169,335,0,6768,7103,3676,0,0,2,2
10574,VISAKHAPATANAM,Devarapalle,Mushidi palle,38,0,448,486,13,0,221,234,203,884,0,16920,17804,10998,2,0,72,74
10575,VISAKHAPATANAM,Devarapalle,N. Gajapathi Nagara,26,0,196,222,2,0,24,26,20,13,0,102,115,72,0,0,0,0
10576,VISAKHAPATANAM,Devarapalle,Nagayyapeta,27,0,334,361,18,0,230,248,173,1023,0,13564,14587,8689,2,0,15,17
10577,VISAKHAPATANAM,Devarapalle,Pedanandipalli,31,0,513,544,18,0,362,380,283,905,0,21745,22650,12648,0,0,71,71
10578,VISAKHAPATANAM,Devarapalle,Rai wada,15,73,604,692,1,42,228,271,264,68,3688,10508,14264,7560,0,19,12,31
10579,VISAKHAPATANAM,Devarapalle,Tamarabba,12,270,12,294,1,61,3,65,55,3,2043,23,2069,1105,0,0,0,0
10580,VISAKHAPATANAM,Devarapalle,Taruva,27,0,284,311,18,0,167,185,131,627,0,8836,9463,2859,0,0,13,13
10581,VISAKHAPATANAM,Devarapalle,Tenugupudi,40,2,379,421,33,1,348,382,385,2922,39,27948,30909,18679,16,0,114,130
10582,VISAKHAPATANAM,Devarapalle,Timarim,6,0,328,334,4,0,180,184,161,98,0,5928,6026,3994,0,0,5,5
10583,VISAKHAPATANAM,Devarapalle,Vakapalli,17,1,416,434,9,0,219,228,193,634,0,11534,12168,7393,2,0,23,25
10584,VISAKHAPATANAM,Devarapalle,Valabu,8,437,18,463,0,166,9,175,137,0,9097,182,9279,4046,0,30,0,30
10585,VISAKHAPATANAM,Devarapalle,Vechalam,29,0,357,386,11,0,34,45,1,37,0,389,426,14,0,0,0,0
10586,VISAKHAPATANAM,Devarapalle,Venkatarjupuram,11,11,320,342,5,2,256,263,221,368,31,14732,15131,8802,1,0,24,25
10587,VISAKHAPATANAM,Dumbriguda,Araku,3,469,44,516,1,321,29,351,376,14,19457,2048,21519,13079,0,52,8,60
10588,VISAKHAPATANAM,Dumbriguda,Arma,1,1006,4,1011,0,713,4,717,764,0,46446,279,46725,23620,0,162,1,163
10589,VISAKHAPATANAM,Dumbriguda,Gasaba,0,815,0,815,0,675,0,675,625,0,57410,0,57410,26567,0,255,0,255
10590,VISAKHAPATANAM,Dumbriguda,GUNTAGENNELA,3,840,0,843,0,715,0,715,764,0,53539,0,53539,27161,0,229,0,229
10591,VISAKHAPATANAM,Dumbriguda,Guntaseema,0,408,0,408,0,354,0,354,352,0,21702,0,21702,10731,0,73,0,73
10592,VISAKHAPATANAM,Dumbriguda,Kandrum,0,961,0,961,0,753,0,753,803,0,46479,0,46479,23535,0,136,0,136
10593,VISAKHAPATANAM,Dumbriguda,Kinchumanda,10,489,2,501,1,348,0,349,423,117,21539,0,21656,11029,1,89,0,90
10594,VISAKHAPATANAM,Dumbriguda,Kittalalangi,6,1129,2,1137,1,917,2,920,1097,44,74740,82,74866,40579,0,334,0,334
10595,VISAKHAPATANAM,Dumbriguda,Kollaputtu,0,552,1,553,0,501,1,502,588,0,43924,90,44014,23460,0,237,0,237
10596,VISAKHAPATANAM,Dumbriguda,KORRA,2,573,0,575,1,435,0,436,532,63,26120,0,26183,13991,0,70,0,70
10597,VISAKHAPATANAM,Dumbriguda,Korrai,1,959,0,960,0,765,0,765,858,0,48670,0,48670,23980,0,164,0,164
10598,VISAKHAPATANAM,Dumbriguda,Kuridi,1,864,1,866,0,672,0,672,845,0,48953,0,48953,26047,0,158,0,158
10599,VISAKHAPATANAM,Dumbriguda,Lygonda,0,209,0,209,0,194,0,194,226,0,16473,0,16473,9028,0,84,0,84
10600,VISAKHAPATANAM,Dumbriguda,Pottangi,5,1223,4,1232,2,957,1,960,1163,56,58982,12,59050,31648,0,150,0,150
10601,VISAKHAPATANAM,Dumbriguda,Rangilisingi,0,457,0,457,0,353,0,353,442,0,36007,0,36007,19486,0,240,0,240
10602,VISAKHAPATANAM,Dumbriguda,Sagara,1,762,0,763,0,540,0,540,638,0,35662,0,35662,19197,0,106,0,106
10603,VISAKHAPATANAM,Dumbriguda,Sovva,0,761,3,764,0,610,3,613,703,0,28868,209,29077,14378,0,55,1,56
10604,VISAKHAPATANAM,Dumbriguda,THUTANGI,2,620,0,622,2,485,0,487,453,134,44326,0,44460,21589,0,264,0,264
10605,VISAKHAPATANAM,Gangaraju Madugula,Bheeram,0,573,3,576,0,450,2,452,513,0,21821,66,21887,11544,0,31,0,31
10606,VISAKHAPATANAM,Gangaraju Madugula,Boithala,0,858,2,860,0,429,2,431,478,0,14141,54,14195,7221,0,5,0,5
10607,VISAKHAPATANAM,Gangaraju Madugula,G.Madugula,7,1014,18,1039,1,605,0,606,624,35,31249,0,31284,15411,0,76,0,76
10608,VISAKHAPATANAM,Gangaraju Madugula,Gaduthuru,1,1326,1,1328,0,781,0,781,975,0,36668,0,36668,19570,0,56,0,56
10609,VISAKHAPATANAM,Gangaraju Madugula,Gemmeli,1,1399,2,1402,1,1074,2,1077,1148,45,54080,72,54197,27113,0,140,0,140
10610,VISAKHAPATANAM,Gangaraju Madugula,K.Kodapalli,3,594,96,693,3,560,66,629,766,38,39100,4064,43202,23547,0,142,5,147
10611,VISAKHAPATANAM,Gangaraju Madugula,Killamkota,0,514,0,514,0,422,0,422,449,0,17830,0,17830,9084,0,33,0,33
10612,VISAKHAPATANAM,Gangaraju Madugula,Korapalli,1,668,1,670,1,583,1,585,715,11,29785,99,29895,15319,0,55,0,55
10613,VISAKHAPATANAM,Gangaraju Madugula,KUMBIDISINGI,0,430,1,431,0,383,0,383,423,0,18916,0,18916,9266,0,39,0,39
10614,VISAKHAPATANAM,Gangaraju Madugula,Nurmathi,1,690,4,695,0,504,0,504,557,0,21759,0,21759,11301,0,25,0,25
10615,VISAKHAPATANAM,Gangaraju Madugula,Palamamidi,0,689,0,689,0,559,0,559,553,0,30375,0,30375,15170,0,62,0,62
10616,VISAKHAPATANAM,Gangaraju Madugula,Pedalochili,1,577,0,578,0,491,0,491,560,0,29661,0,29661,15110,0,108,0,108
10617,VISAKHAPATANAM,Gangaraju Madugula,Pedaluvvasingi,2,808,0,810,0,392,0,392,460,0,16825,0,16825,8630,0,33,0,33
10618,VISAKHAPATANAM,Gangaraju Madugula,Singarbha,0,692,3,695,0,560,1,561,670,0,27008,6,27014,14938,0,56,0,56
10619,VISAKHAPATANAM,Gangaraju Madugula,SOLABHAM,3,1470,1,1474,1,1007,0,1008,1234,28,47822,0,47850,24176,0,121,0,121
10620,VISAKHAPATANAM,Gangaraju Madugula,Vanjari,4,1675,3,1682,2,1182,3,1187,1377,32,54508,102,54642,29052,0,90,0,90
10621,VISAKHAPATANAM,Gangaraju Madugula,VANTALA,2,767,0,769,0,506,0,506,569,0,27817,0,27817,14438,0,94,0,94
10622,VISAKHAPATANAM,Golugonda,Agency Laxmipuram,214,26,723,963,160,18,574,752,674,7259,505,22729,30493,21702,17,0,20,37
10623,VISAKHAPATANAM,Golugonda,Ammapeta,60,1,147,208,57,1,135,193,177,5251,76,8400,13727,7716,32,0,25,57
10624,VISAKHAPATANAM,Golugonda,Cheedigummala,18,32,786,836,14,28,731,773,737,606,1879,42920,45405,29037,1,7,119,127
10625,VISAKHAPATANAM,Golugonda,Cheedikada,109,7,309,425,94,5,268,367,354,6114,294,18409,24817,14184,27,1,77,105
10626,VISAKHAPATANAM,Golugonda,CHODYAM,40,57,274,371,34,50,251,335,347,2452,3457,21090,26999,19777,7,11,88,106
10627,VISAKHAPATANAM,Golugonda,Gadampalem,76,21,150,247,53,17,100,170,152,4230,1242,8343,13815,8247,20,5,33,58
10628,VISAKHAPATANAM,Golugonda,Golugonda,363,7,348,718,224,4,177,405,363,13576,227,10421,24224,14128,43,1,31,75
10629,VISAKHAPATANAM,Golugonda,Gundupala,60,0,625,685,51,0,562,613,540,2116,0,28826,30942,17749,5,0,91,96
10630,VISAKHAPATANAM,Golugonda,JOGAMPETA,112,0,297,409,92,0,210,302,262,5813,0,10747,16560,9306,24,0,12,36
10631,VISAKHAPATANAM,Golugonda,K.D. Peta,80,9,255,344,69,7,197,273,271,4506,288,12538,17332,11788,13,0,25,38
10632,VISAKHAPATANAM,Golugonda,Kasimi,8,261,22,291,5,221,23,249,233,304,12862,1715,14881,8649,1,35,8,44
10633,VISAKHAPATANAM,Golugonda,Komira,1,27,170,198,1,25,156,182,178,65,2567,11885,14517,8163,0,20,43,63
10634,VISAKHAPATANAM,Golugonda,Konkasingi,42,11,396,449,28,5,312,345,321,1524,215,20442,22181,14035,4,0,64,68
10635,VISAKHAPATANAM,Golugonda,Kotha yellavaram,66,158,641,865,50,96,482,628,601,2861,4150,26208,33219,19779,5,3,53,61
10636,VISAKHAPATANAM,Golugonda,Kothamallempeta,80,43,441,564,65,35,354,454,398,4504,2057,24097,30658,17389,19,6,89,114
10637,VISAKHAPATANAM,Golugonda,Lingamdorapalem,108,57,85,250,99,57,66,222,215,5424,5113,5665,16202,8871,18,37,18,73
10638,VISAKHAPATANAM,Golugonda,LINGAMPETA,13,0,311,324,12,0,267,279,242,767,0,14068,14835,8033,0,0,19,19
10639,VISAKHAPATANAM,Golugonda,Pakalapadu,40,5,855,900,22,2,680,704,582,1546,202,38168,39916,23720,10,2,57,69
10640,VISAKHAPATANAM,Golugonda,Pappusettipalem,103,110,271,484,87,101,237,425,406,4870,8032,16068,28970,15823,6,41,47,94
10641,VISAKHAPATANAM,Golugonda,Patha mallempeta,49,203,178,430,44,178,150,372,359,1911,13280,10370,25561,14109,2,60,41,103
10642,VISAKHAPATANAM,Golugonda,Puttadigowrampeta,18,109,254,381,15,103,249,367,317,690,7100,17644,25434,14365,2,31,85,118
10643,VISAKHAPATANAM,Golugonda,RAVANAPALLI,4,0,253,257,3,0,231,234,239,178,0,15121,15299,11610,1,0,30,31
10644,VISAKHAPATANAM,Golugonda,Salika Mallavaram,10,64,125,199,2,58,103,163,149,36,4447,9003,13486,7184,0,19,54,73
10645,VISAKHAPATANAM,Golugonda,YETIGAIRAMPETA,1,137,225,363,1,129,205,335,325,59,7963,10731,18753,12676,0,25,20,45
10646,VISAKHAPATANAM,Gudem Kothaveedhi,A.Darakonda,0,260,0,260,0,213,0,213,275,0,14510,0,14510,7989,0,56,0,56
10647,VISAKHAPATANAM,Gudem Kothaveedhi,Damanapalli,2,1207,6,1215,0,833,3,836,917,0,30953,62,31015,15977,0,43,0,43
10648,VISAKHAPATANAM,Gudem Kothaveedhi,Darakonda,20,1390,70,1480,1,700,8,709,800,48,23580,74,23702,12659,0,20,0,20
10649,VISAKHAPATANAM,Gudem Kothaveedhi,Devarapalli,3,961,2,966,2,446,1,449,526,54,20122,42,20218,10250,0,28,0,28
10650,VISAKHAPATANAM,Gudem Kothaveedhi,Duppalavada,2,1075,2,1079,2,786,0,788,818,26,37042,0,37068,18815,0,84,0,84
10651,VISAKHAPATANAM,Gudem Kothaveedhi,G.K.VEEDHI,7,1010,31,1048,0,469,1,470,549,0,19098,20,19118,10216,0,34,0,34
10652,VISAKHAPATANAM,Gudem Kothaveedhi,G.K.VEEDHI(I),5,744,11,760,1,417,0,418,467,24,19375,0,19399,9887,0,17,0,17
10653,VISAKHAPATANAM,Gudem Kothaveedhi,Galikonda,0,629,0,629,0,352,0,352,347,0,19129,0,19129,9351,0,59,0,59
10654,VISAKHAPATANAM,Gudem Kothaveedhi,Gummerevulu,1,611,0,612,0,219,0,219,265,0,4992,0,4992,2771,0,0,0,0
10655,VISAKHAPATANAM,Gudem Kothaveedhi,Jerrela,7,869,2,878,0,615,1,616,685,0,34933,30,34963,17360,0,85,0,85
10656,VISAKHAPATANAM,Gudem Kothaveedhi,Lakkavarapupeta,2,1007,2,1011,0,641,0,641,758,0,28501,0,28501,15338,0,27,0,27
10657,VISAKHAPATANAM,Gudem Kothaveedhi,Mondigedda,1,772,2,775,0,418,0,418,469,0,12655,0,12655,6627,0,8,0,8
10658,VISAKHAPATANAM,Gudem Kothaveedhi,Pedavalasa,9,891,25,925,1,558,3,562,705,21,26137,76,26234,14746,0,53,0,53
10659,VISAKHAPATANAM,Gudem Kothaveedhi,Rinthada,9,1716,52,1777,0,891,21,912,1030,0,40102,1272,41374,22079,0,64,4,68
10660,VISAKHAPATANAM,Gudem Kothaveedhi,Sankada,3,869,28,900,1,542,1,544,642,38,22757,1,22796,11655,0,20,0,20
10661,VISAKHAPATANAM,Gudem Kothaveedhi,sileru,16,211,117,344,2,24,11,37,34,10,842,79,931,463,0,0,0,0
10662,VISAKHAPATANAM,Gudem Kothaveedhi,Vanchula,4,992,7,1003,2,668,0,670,782,37,28956,0,28993,15018,0,59,0,59
10663,VISAKHAPATANAM,Hukumpeta,Addumanda,0,366,0,366,0,253,0,253,262,0,12990,0,12990,7846,0,26,0,26
10664,VISAKHAPATANAM,Hukumpeta,ANDIBHA,0,245,0,245,0,200,0,200,224,0,14288,0,14288,7684,0,33,0,33
10665,VISAKHAPATANAM,Hukumpeta,bakkuru,1,426,5,432,0,317,3,320,307,0,13999,45,14044,7151,0,22,0,22
10666,VISAKHAPATANAM,Hukumpeta,Baramasi,0,339,0,339,0,247,0,247,272,0,14371,0,14371,7338,0,31,0,31
10667,VISAKHAPATANAM,Hukumpeta,Bheemavaram,10,394,1,405,10,362,1,373,429,568,30493,126,31187,16163,0,129,1,130
10668,VISAKHAPATANAM,Hukumpeta,Boddaputtu,1,392,0,393,1,353,0,354,384,55,26202,0,26257,14198,0,109,0,109
10669,VISAKHAPATANAM,Hukumpeta,Burja,2,589,2,593,0,510,2,512,661,0,39279,150,39429,20143,0,135,0,135
10670,VISAKHAPATANAM,Hukumpeta,Cheekumaddula,0,358,0,358,0,320,0,320,328,0,20850,0,20850,9995,0,32,0,32
10671,VISAKHAPATANAM,Hukumpeta,Durgam,0,710,4,714,0,604,4,608,663,0,35357,303,35660,18621,0,69,1,70
10672,VISAKHAPATANAM,Hukumpeta,G.K. Manda,0,282,3,285,0,238,3,241,278,0,14981,221,15202,8585,0,33,1,34
10673,VISAKHAPATANAM,Hukumpeta,GANNERUPUTTU,0,349,0,349,0,294,0,294,301,0,20803,0,20803,10532,0,77,0,77
10674,VISAKHAPATANAM,Hukumpeta,Gattum,0,765,0,765,0,664,0,664,642,0,46265,0,46265,22786,0,118,0,118
10675,VISAKHAPATANAM,Hukumpeta,GUDA,1,467,0,468,1,279,0,280,325,24,14092,0,14116,7029,0,28,0,28
10676,VISAKHAPATANAM,Hukumpeta,Hukumpeta,11,584,14,609,0,366,3,369,395,0,22760,138,22898,12528,0,89,1,90
10677,VISAKHAPATANAM,Hukumpeta,Jarrakonda,1,295,0,296,1,237,0,238,262,22,17229,0,17251,8566,0,60,0,60
10678,VISAKHAPATANAM,Hukumpeta,Konthili,0,325,3,328,0,196,1,197,224,0,7667,4,7671,4760,0,6,0,6
10679,VISAKHAPATANAM,Hukumpeta,Kotnapalli,1,727,0,728,0,479,0,479,514,0,29419,0,29419,15368,0,67,0,67
10680,VISAKHAPATANAM,Hukumpeta,Mattam,3,312,129,444,1,273,118,392,428,125,17881,6674,24680,13327,1,60,9,70
10681,VISAKHAPATANAM,Hukumpeta,Matyapuram,1,505,1,507,1,385,1,387,435,31,21523,120,21674,10941,0,38,1,39
10682,VISAKHAPATANAM,Hukumpeta,Merakachintha,0,231,0,231,0,156,0,156,156,0,11421,0,11421,5987,0,48,0,48
10683,VISAKHAPATANAM,Hukumpeta,Mettujoru,1,478,1,480,0,428,1,429,443,0,34708,81,34789,17309,0,147,0,147
10684,VISAKHAPATANAM,Hukumpeta,Muliaputtu,2,406,0,408,2,243,0,245,266,36,10155,0,10191,5158,0,29,0,29
10685,VISAKHAPATANAM,Hukumpeta,Olda,3,567,0,570,1,451,0,452,505,84,25584,0,25668,13806,0,38,0,38
10686,VISAKHAPATANAM,Hukumpeta,Pathakota,5,778,0,783,2,653,0,655,702,54,42050,0,42104,21297,0,108,0,108
10687,VISAKHAPATANAM,Hukumpeta,Pattam,1,527,0,528,0,457,0,457,471,0,26201,0,26201,12649,0,48,0,48
10688,VISAKHAPATANAM,Hukumpeta,Rangaseela,3,734,2,739,1,522,1,524,589,64,31593,86,31743,16879,0,84,0,84
10689,VISAKHAPATANAM,Hukumpeta,Rapa,0,602,1,603,0,523,1,524,596,0,36488,90,36578,17741,0,107,0,107
10690,VISAKHAPATANAM,Hukumpeta,Santharai,5,630,1,636,0,512,0,512,577,0,40348,0,40348,20601,0,178,0,178
10691,VISAKHAPATANAM,Hukumpeta,Sobhakota,1,504,0,505,1,396,0,397,428,102,25645,0,25747,13140,1,55,0,56
10692,VISAKHAPATANAM,Hukumpeta,Sukuru,1,562,47,610,0,469,37,506,563,0,24622,2430,27052,14310,0,12,2,14
10693,VISAKHAPATANAM,Hukumpeta,Teegalavalasa,9,1057,1,1067,3,820,1,824,963,50,47530,24,47604,25415,0,102,0,102
10694,VISAKHAPATANAM,Hukumpeta,Thadigiri,7,692,0,699,2,560,0,562,590,166,33565,0,33731,16840,0,50,0,50
10695,VISAKHAPATANAM,Hukumpeta,Thadiputtu,1,434,2,437,0,383,1,384,412,0,26868,70,26938,14651,0,103,0,103
10696,VISAKHAPATANAM,K Kotapadu,A. Bheemavaram,2,1,230,233,0,1,56,57,4,0,6,327,333,24,0,0,0,0
10697,VISAKHAPATANAM,K Kotapadu,A. Koduru,33,0,438,471,15,0,285,300,253,427,0,11938,12365,8089,1,0,18,19
10698,VISAKHAPATANAM,K Kotapadu,Anandapuram,18,1,139,158,0,0,0,0,0,0,0,0,0,0,0,0,0,0
10699,VISAKHAPATANAM,K Kotapadu,Arle,9,0,255,264,9,0,193,202,154,325,0,11645,11970,5855,1,0,31,32
10700,VISAKHAPATANAM,K Kotapadu,Chowduvada,13,5,1044,1062,1,0,499,500,421,9,0,29783,29792,19393,0,0,103,103
10701,VISAKHAPATANAM,K Kotapadu,Dali valasa,14,0,392,406,8,0,347,355,318,487,0,24850,25337,14968,1,0,105,106
10702,VISAKHAPATANAM,K Kotapadu,Deekshitula Agraharam,3,0,130,133,3,0,118,121,108,318,0,11760,12078,8827,2,0,83,85
10703,VISAKHAPATANAM,K Kotapadu,Gavarapalem,1,0,311,312,0,0,199,199,192,0,0,11626,11626,8936,0,0,39,39
10704,VISAKHAPATANAM,K Kotapadu,Gondupalem,6,2,459,467,1,1,356,358,298,99,6,21573,21678,15425,0,0,55,55
10705,VISAKHAPATANAM,K Kotapadu,Gotlam,7,0,206,213,7,0,161,168,157,668,0,16561,17229,12607,3,0,114,117
10706,VISAKHAPATANAM,K Kotapadu,Gullepalle,27,0,649,676,10,0,505,515,455,558,0,33208,33766,20553,1,0,95,96
10707,VISAKHAPATANAM,K Kotapadu,K. SANTHAPALEM,26,1,495,522,10,0,347,357,318,612,0,28291,28903,20687,0,0,118,118
10708,VISAKHAPATANAM,K Kotapadu,K.J. puram,17,0,266,283,13,0,184,197,174,327,0,11367,11694,8926,0,0,14,14
10709,VISAKHAPATANAM,K Kotapadu,Kintada,43,1,437,481,10,0,211,221,162,619,0,17258,17877,10864,3,0,72,75
10710,VISAKHAPATANAM,K Kotapadu,Kintada Kotapadu,20,1,225,246,5,1,157,163,134,19,95,11155,11269,7450,0,0,50,50
10711,VISAKHAPATANAM,K Kotapadu,Koruvada,14,0,271,285,8,0,199,207,183,332,0,13441,13773,8848,1,0,57,58
10712,VISAKHAPATANAM,K Kotapadu,Lankavanipalem,8,0,222,230,0,0,0,0,0,0,0,0,0,0,0,0,0,0
10713,VISAKHAPATANAM,K Kotapadu,Marri valasa,41,0,257,298,37,0,218,255,231,2235,0,14246,16481,10663,7,0,31,38
10714,VISAKHAPATANAM,K Kotapadu,Medicherla,25,1,207,233,18,0,132,150,128,1268,0,5829,7097,4219,5,0,9,14
10715,VISAKHAPATANAM,K Kotapadu,Paidampeta,9,0,202,211,8,0,174,182,128,655,0,8093,8748,4573,3,0,12,15
10716,VISAKHAPATANAM,K Kotapadu,Pathavalasa,19,0,245,264,11,0,176,187,184,1184,0,18657,19841,13336,9,0,140,149
10717,VISAKHAPATANAM,K Kotapadu,Pindrangi,25,0,575,600,14,0,432,446,401,624,0,30523,31147,21874,3,0,157,160
10718,VISAKHAPATANAM,K Kotapadu,Pothanavalasa,3,4,145,152,2,3,102,107,85,138,29,7747,7914,4294,0,0,35,35
10719,VISAKHAPATANAM,K Kotapadu,R.Y. Agraharam,21,1,415,437,1,0,241,242,228,80,0,18620,18700,11002,0,0,94,94
10720,VISAKHAPATANAM,K Kotapadu,Rongalinaidupalem,38,0,303,341,34,0,200,234,147,2633,0,11939,14572,7983,11,0,27,38
10721,VISAKHAPATANAM,K Kotapadu,Singanddorapalem,9,0,490,499,8,0,382,390,340,697,0,29501,30198,20519,5,0,149,154
10722,VISAKHAPATANAM,K Kotapadu,Srungavaram,1,0,213,214,1,0,173,174,171,100,0,13990,14090,9827,1,0,57,58
10723,VISAKHAPATANAM,K Kotapadu,Sudivalasa,8,1,356,365,4,0,237,241,222,348,0,14890,15238,12474,2,0,41,43
10724,VISAKHAPATANAM,K Kotapadu,Sureddipalem,8,0,197,205,7,0,169,176,153,478,0,9425,9903,6179,2,0,27,29
10725,VISAKHAPATANAM,K Kotapadu,V.Santhapalem,38,1,283,322,28,0,179,207,154,2139,0,16139,18278,9658,8,0,103,111
10726,VISAKHAPATANAM,K Kotapadu,Varada,50,0,511,561,29,0,325,354,314,2385,0,23096,25481,15820,7,0,47,54
10727,VISAKHAPATANAM,Kasimkota,Addam,9,0,123,132,8,0,98,106,58,506,0,6810,7316,3131,1,0,13,14
10728,VISAKHAPATANAM,Kasimkota,Ammensahebpeta,23,0,426,449,3,0,250,253,171,189,0,10335,10524,5170,1,0,19,20
10729,VISAKHAPATANAM,Kasimkota,Atcherla,82,1,765,848,46,0,278,324,288,2236,0,15531,17767,11125,2,0,34,36
10730,VISAKHAPATANAM,Kasimkota,Bayyavaram,73,0,399,472,28,0,215,243,225,2383,0,17819,20202,17680,8,0,86,94
10731,VISAKHAPATANAM,Kasimkota,Butchaiah peta,9,0,399,408,0,0,187,187,123,0,0,8629,8629,4134,0,0,29,29
10732,VISAKHAPATANAM,Kasimkota,Charakam,16,0,244,260,8,0,182,190,154,673,0,13724,14397,7645,4,0,34,38
10733,VISAKHAPATANAM,Kasimkota,Chintalapalem,62,0,238,300,61,0,224,285,245,4053,0,12658,16711,9656,16,0,22,38
10734,VISAKHAPATANAM,Kasimkota,E.Chowduvada,66,19,504,589,9,0,266,275,222,594,0,13142,13736,8654,3,0,26,29
10735,VISAKHAPATANAM,Kasimkota,G.Bheemavaram,8,0,652,660,7,0,582,589,495,359,0,47261,47620,27545,0,0,201,201
10736,VISAKHAPATANAM,Kasimkota,Gobburu,5,0,158,163,2,0,100,102,85,140,0,5333,5473,3857,0,0,13,13
10737,VISAKHAPATANAM,Kasimkota,Jamadulla palem,4,0,369,373,1,0,287,288,274,80,0,21797,21877,18699,0,0,38,38
10738,VISAKHAPATANAM,Kasimkota,Kasimkota,132,0,1225,1357,0,0,252,252,246,0,0,10280,10280,8860,0,0,12,12
10739,VISAKHAPATANAM,Kasimkota,Kothapalle,24,0,395,419,0,0,174,174,150,0,0,8331,8331,5638,0,0,18,18
10740,VISAKHAPATANAM,Kasimkota,Notalaguntapalem,34,1,610,645,14,0,380,394,327,829,0,16619,17448,11618,0,0,26,26
10741,VISAKHAPATANAM,Kasimkota,Paravada palem,2,0,336,338,1,0,128,129,113,20,0,8652,8672,7147,0,0,46,46
10742,VISAKHAPATANAM,Kasimkota,Perantalapalem,25,2,360,387,16,0,300,316,208,288,0,20757,21045,8885,0,0,52,52
10743,VISAKHAPATANAM,Kasimkota,Somavaram,20,0,298,318,19,0,221,240,229,1093,0,13641,14734,12860,3,0,37,40
10744,VISAKHAPATANAM,Kasimkota,Sundarayyapeta,23,2,298,323,13,2,265,280,229,871,127,21657,22655,14375,3,1,108,112
10745,VISAKHAPATANAM,Kasimkota,Tallapalem,28,11,329,368,23,1,166,190,130,537,76,12812,13425,8994,2,0,60,62
10746,VISAKHAPATANAM,Kasimkota,Tegada,35,0,373,408,4,0,211,215,212,194,0,12281,12475,11740,0,0,29,29
10747,VISAKHAPATANAM,Kasimkota,THEEDA,55,2,520,577,36,1,414,451,381,1850,29,30184,32063,17373,3,0,144,147
10748,VISAKHAPATANAM,Kasimkota,Ugginapalem,46,4,289,339,19,4,136,159,136,1095,162,6290,7547,5605,3,1,5,9
10749,VISAKHAPATANAM,Kasimkota,Veduruparthi,78,2,460,540,56,2,347,405,362,3506,60,18985,22551,13156,10,0,36,46
10750,VISAKHAPATANAM,Kasimkota,Vissanna peta,1,0,295,296,0,0,232,232,208,0,0,17733,17733,12250,0,0,73,73
10751,VISAKHAPATANAM,Kasimkota,Yenugutuni,4,0,384,388,2,0,316,318,321,30,0,9163,9193,7412,0,0,6,6
10752,VISAKHAPATANAM,Kasimkota,Zattapureddituni,39,0,209,248,11,0,134,145,113,67,0,6673,6740,4902,0,0,14,14
10753,VISAKHAPATANAM,Kotauratla,Akasahebpeta,34,2,259,295,31,0,230,261,231,3202,0,23225,26427,15427,22,0,170,192
10754,VISAKHAPATANAM,Kotauratla,Annavaram,43,0,447,490,36,0,368,404,405,3759,0,35835,39594,24893,29,0,225,254
10755,VISAKHAPATANAM,Kotauratla,Bapiraju kothapalle,79,0,385,464,57,0,333,390,354,3186,0,27370,30556,18830,11,0,153,164
10756,VISAKHAPATANAM,Kotauratla,Bodapalem,37,0,507,544,36,0,445,481,407,1805,0,26862,28667,16068,3,0,49,52
10757,VISAKHAPATANAM,Kotauratla,Chinaboddepalle,51,18,283,352,43,14,248,305,273,3799,1212,25361,30372,15719,25,6,183,214
10758,VISAKHAPATANAM,Kotauratla,Chowduvada,55,0,314,369,38,0,240,278,269,3110,0,21470,24580,17726,14,0,125,139
10759,VISAKHAPATANAM,Kotauratla,Gottivada,29,18,291,338,20,18,250,288,282,914,609,18311,19834,15427,3,0,55,58
10760,VISAKHAPATANAM,Kotauratla,Jalluru,72,1,198,271,60,0,156,216,192,5569,0,14431,20000,12289,37,0,88,125
10761,VISAKHAPATANAM,Kotauratla,Kailasapatnam,123,53,185,361,107,52,160,319,289,5993,2889,10218,19100,11173,17,2,29,48
10762,VISAKHAPATANAM,Kotauratla,Kodavatipudi,64,21,539,624,56,21,482,559,494,2700,1655,28719,33074,17457,5,8,79,92
10763,VISAKHAPATANAM,Kotauratla,Kotauratla,186,0,370,556,78,0,250,328,264,5529,0,21405,26934,14399,29,0,128,157
10764,VISAKHAPATANAM,Kotauratla,Lingapuram,19,0,398,417,11,0,354,365,336,475,0,29522,29997,17346,1,0,138,139
10765,VISAKHAPATANAM,Kotauratla,NEELIGUNTA,0,0,333,333,0,0,300,300,272,0,0,26621,26621,16207,0,0,161,161
10766,VISAKHAPATANAM,Kotauratla,Pamulavaka,165,2,650,817,94,0,406,500,473,6880,0,31794,38674,21571,26,0,148,174
10767,VISAKHAPATANAM,Kotauratla,Panduru,74,5,443,522,23,0,259,282,263,1312,0,18752,20064,10302,4,0,93,97
10768,VISAKHAPATANAM,Kotauratla,Pippallakothapalle,20,60,507,587,20,60,481,561,495,1837,4186,43198,49221,23858,11,18,246,275
10769,VISAKHAPATANAM,Kotauratla,Rajupeta,7,0,556,563,5,0,435,440,407,373,0,29598,29971,17347,0,0,85,85
10770,VISAKHAPATANAM,Kotauratla,Ramachandrapalem,20,19,380,419,18,17,328,363,326,1442,1716,31660,34818,18877,6,9,206,221
10771,VISAKHAPATANAM,Kotauratla,Ramachandrapuram,0,57,282,339,0,0,214,214,193,0,0,15962,15962,9810,0,0,70,70
10772,VISAKHAPATANAM,Kotauratla,SUNKAPURU,55,0,369,424,47,0,295,342,317,4037,0,26170,30207,16422,25,0,156,181
10773,VISAKHAPATANAM,Kotauratla,Thadaparthi Jaggampeta,7,43,509,559,3,39,307,349,326,218,2616,26628,29462,15714,1,10,131,142
10774,VISAKHAPATANAM,Kotauratla,Thangedu,111,0,432,543,93,0,293,386,344,7916,0,26224,34140,21602,43,0,113,156
10775,VISAKHAPATANAM,Kotauratla,Venkata puram,77,17,576,670,56,0,368,424,334,4062,0,27178,31240,13944,12,0,94,106
10776,VISAKHAPATANAM,Kotauratla,Yendapalle,45,0,338,383,34,0,289,323,242,2857,0,27329,30186,18112,23,0,176,199
10777,VISAKHAPATANAM,Koyyuru,Aadakula,53,343,284,680,41,237,225,503,481,3245,15880,11718,30843,15844,14,64,3,81
10778,VISAKHAPATANAM,Koyyuru,Anthada,0,481,0,481,0,350,0,350,439,0,17921,0,17921,9769,0,40,0,40
10779,VISAKHAPATANAM,Koyyuru,BAKALURU,0,338,7,345,0,321,5,326,338,0,30276,477,30753,16567,0,180,3,183
10780,VISAKHAPATANAM,Koyyuru,Balaram,0,85,333,418,0,69,241,310,331,0,3258,10986,14244,7409,0,8,3,11
10781,VISAKHAPATANAM,Koyyuru,Bangarammapeta,1,251,0,252,1,237,0,238,264,58,17923,0,17981,9619,0,86,0,86
10782,VISAKHAPATANAM,Koyyuru,Battapanukulu,0,197,8,205,0,141,6,147,145,0,6003,232,6235,3685,0,10,0,10
10783,VISAKHAPATANAM,Koyyuru,Budaralla,0,1410,0,1410,0,658,0,658,737,0,21293,0,21293,11442,0,24,0,24
10784,VISAKHAPATANAM,Koyyuru,Cheedipalem,30,346,99,475,15,165,9,189,180,706,6232,434,7372,4420,0,4,0,4
10785,VISAKHAPATANAM,Koyyuru,Chimtampadu,1,274,1,276,0,180,0,180,179,0,9412,0,9412,4449,0,15,0,15
10786,VISAKHAPATANAM,Koyyuru,Chintalapadu,6,387,55,448,0,342,47,389,421,0,19945,1218,21163,11049,0,56,0,56
10787,VISAKHAPATANAM,Koyyuru,Downuru,4,588,8,600,2,435,1,438,452,48,25918,12,25978,13950,0,90,0,90
10788,VISAKHAPATANAM,Koyyuru,Gadabapalem,1,312,7,320,0,290,6,296,362,0,25198,426,25624,13624,0,132,1,133
10789,VISAKHAPATANAM,Koyyuru,Kantharam,0,78,297,375,0,64,236,300,316,0,4404,19791,24195,13530,0,19,104,123
10790,VISAKHAPATANAM,Koyyuru,KINAPARTHI,0,252,18,270,0,207,16,223,229,0,8368,257,8625,5084,0,11,0,11
10791,VISAKHAPATANAM,Koyyuru,Kommika,1,746,11,758,1,580,9,590,591,26,26645,300,26971,13682,0,24,0,24
10792,VISAKHAPATANAM,Koyyuru,Kondagokira,10,254,18,282,6,164,14,184,185,419,8117,428,8964,4957,0,11,0,11
10793,VISAKHAPATANAM,Koyyuru,KOYYURU,3,288,110,401,2,245,87,334,359,52,11891,4375,16318,8744,0,13,2,15
10794,VISAKHAPATANAM,Koyyuru,M.Bhimavaram,2,556,0,558,1,90,0,91,61,5,896,0,901,360,0,0,0,0
10795,VISAKHAPATANAM,Koyyuru,M.Makavaram,1,410,35,446,1,340,17,358,397,50,20813,595,21458,11804,0,24,0,24
10796,VISAKHAPATANAM,Koyyuru,MAMPA,6,618,107,731,2,506,84,592,630,83,21486,5169,26738,15146,0,28,11,39
10797,VISAKHAPATANAM,Koyyuru,Marriwada,15,595,26,636,15,477,21,513,585,1233,35335,1543,38111,20798,6,150,4,160
10798,VISAKHAPATANAM,Koyyuru,Mulapeta,4,415,1,420,0,346,1,347,406,0,27137,128,27265,14884,0,120,1,121
10799,VISAKHAPATANAM,Koyyuru,Nadimpalem,2,224,16,242,2,195,9,206,235,66,12460,584,13110,7280,0,36,1,37
10800,VISAKHAPATANAM,Koyyuru,Nallagonda,2,226,32,260,1,193,25,219,270,87,14973,1873,16933,9810,0,60,7,67
10801,VISAKHAPATANAM,Koyyuru,P.Makavaram,0,327,21,348,0,178,9,187,183,0,5950,61,6011,3361,0,9,0,9
10802,VISAKHAPATANAM,Koyyuru,R.KOTHURU,3,95,232,330,0,0,0,0,0,0,0,0,0,0,0,0,0,0
10803,VISAKHAPATANAM,Koyyuru,Rajendrappalem,7,420,92,519,2,252,25,279,279,21,11623,341,11985,7182,0,14,0,14
10804,VISAKHAPATANAM,Koyyuru,Ratnampeta,5,121,96,222,1,82,60,143,143,41,3497,2528,6066,3663,0,3,2,5
10805,VISAKHAPATANAM,Koyyuru,Ravanapalli,0,307,6,313,0,244,5,249,251,0,20925,358,21283,11405,0,115,0,115
10806,VISAKHAPATANAM,Koyyuru,Revallu,3,415,114,532,0,300,54,354,320,0,12908,2241,15149,8856,0,8,1,9
10807,VISAKHAPATANAM,Koyyuru,Sarabhanna palem,0,303,23,326,0,245,13,258,295,0,17100,641,17741,10945,0,65,1,66
10808,VISAKHAPATANAM,Koyyuru,U.Cheedipalem,3,610,0,613,1,86,0,87,87,11,1977,0,1988,1027,0,0,0,0
10809,VISAKHAPATANAM,Koyyuru,Velagalapalem,0,213,0,213,0,184,0,184,214,0,10830,0,10830,5994,0,33,0,33
10810,VISAKHAPATANAM,Madugula,Avuruvada,24,529,129,682,9,410,69,488,442,232,19565,3018,22815,12002,0,27,2,29
10811,VISAKHAPATANAM,Madugula,CHINTALURU,44,118,222,384,22,0,9,31,19,264,0,9,273,131,0,0,0,0
10812,VISAKHAPATANAM,Madugula,D.GOTIVADA,6,66,269,341,6,59,167,232,188,432,3641,10753,14826,7760,0,10,29,39
10813,VISAKHAPATANAM,Madugula,Gadirai,34,0,447,481,7,0,70,77,69,135,0,684,819,510,0,0,0,0
10814,VISAKHAPATANAM,Madugula,Gotivada Agaraharam,14,0,363,377,10,0,225,235,178,488,0,9345,9833,5111,2,0,11,13
10815,VISAKHAPATANAM,Madugula,Jalampalle,39,518,262,819,29,301,190,520,470,1336,14460,5550,21346,11744,0,42,3,45
10816,VISAKHAPATANAM,Madugula,Jammadevipeta,78,102,297,477,69,44,238,351,299,5060,1166,16489,22715,12374,24,0,64,88
10817,VISAKHAPATANAM,Madugula,Jampena,16,1,277,294,15,1,232,248,248,1141,100,16210,17451,11337,5,1,54,60
10818,VISAKHAPATANAM,Madugula,K. J. Puram,88,2,700,790,56,0,462,518,386,3101,0,19921,23022,12741,8,0,24,32
10819,VISAKHAPATANAM,Madugula,K. Vallapuram,56,72,262,390,29,31,75,135,102,973,1001,1882,3856,1934,0,0,1,1
10820,VISAKHAPATANAM,Madugula,Kinthalli,47,0,173,220,21,0,87,108,92,566,0,2308,2874,1821,0,0,0,0
10821,VISAKHAPATANAM,Madugula,Lovaponnavolu,42,307,167,516,33,253,125,411,362,2413,19633,12077,34123,17256,8,92,83,183
10822,VISAKHAPATANAM,Madugula,M. Koduru,21,2,538,561,0,1,430,431,406,0,51,24759,24810,14456,0,0,40,40
10823,VISAKHAPATANAM,Madugula,M. Kotapadu,55,0,249,304,43,0,170,213,195,2491,0,8889,11380,6675,3,0,11,14
10824,VISAKHAPATANAM,Madugula,M.K. Vallapuram,2,0,274,276,0,0,152,152,148,0,0,8560,8560,4921,0,0,12,12
10825,VISAKHAPATANAM,Madugula,Madugula,36,80,697,813,25,51,579,655,585,1078,2293,38247,41618,28162,1,3,91,95
10826,VISAKHAPATANAM,Madugula,Mukundapuram,91,9,162,262,31,0,67,98,89,722,0,2249,2971,1968,0,0,1,1
10827,VISAKHAPATANAM,Madugula,Pongalipaka,32,5,285,322,23,4,233,260,215,1329,98,15821,17248,10366,3,0,50,53
10828,VISAKHAPATANAM,Madugula,POTHANAPUDI,19,4,483,506,13,0,331,344,291,600,0,16448,17048,8802,0,0,5,5
10829,VISAKHAPATANAM,Madugula,SAGARAM,22,38,583,643,20,31,487,538,500,1277,2620,36611,40508,23365,1,11,144,156
10830,VISAKHAPATANAM,Madugula,SANKARAM,16,595,60,671,8,296,7,311,280,315,10869,221,11405,5857,0,7,0,7
10831,VISAKHAPATANAM,Madugula,Satyavaram,59,35,297,391,55,27,212,294,267,3103,1082,8416,12601,8021,7,2,3,12
10832,VISAKHAPATANAM,Madugula,Tatiparthi,46,241,100,387,37,210,87,334,299,2499,10653,4712,17864,9547,10,29,7,46
10833,VISAKHAPATANAM,Madugula,V.J. puram,22,12,174,208,20,11,149,180,158,1616,1112,13242,15970,9418,7,5,66,78
10834,VISAKHAPATANAM,Madugula,Vantarlapalem,44,0,174,218,41,0,67,108,70,3043,0,3981,7024,2984,13,0,11,24
10835,VISAKHAPATANAM,Madugula,Veeranarayanam,37,2,633,672,2,2,172,176,150,23,30,6270,6323,3222,0,0,5,5
10836,VISAKHAPATANAM,Madugula,Veeravilli,145,11,264,420,50,2,24,76,69,3083,153,350,3586,1862,7,1,0,8
10837,VISAKHAPATANAM,Madugula,VOMMALI,108,4,883,995,71,3,602,676,583,2238,107,13767,16112,8874,2,0,12,14
10838,VISAKHAPATANAM,Makavarapalem,Bayyavaram,32,0,291,323,28,0,243,271,241,2295,0,19111,21406,14297,14,0,92,106
10839,VISAKHAPATANAM,Makavarapalem,Bheemaboinapalem,25,0,373,398,23,0,272,295,270,2576,0,27662,30238,20871,21,0,217,238
10840,VISAKHAPATANAM,Makavarapalem,Burugupalem,66,0,530,596,45,0,374,419,396,3144,0,30118,33262,20865,10,0,138,148
10841,VISAKHAPATANAM,Makavarapalem,G.VENKATAPURAM,122,0,542,664,60,0,390,450,383,3118,0,23588,26706,16497,8,0,77,85
10842,VISAKHAPATANAM,Makavarapalem,Gangavaram,6,1,511,518,5,0,446,451,421,513,0,43514,44027,26385,4,0,294,298
10843,VISAKHAPATANAM,Makavarapalem,Giduthuru,136,1,437,574,69,0,223,292,270,2810,0,6242,9052,6083,3,0,0,3
10844,VISAKHAPATANAM,Makavarapalem,Jangalapalli,83,0,273,356,51,0,211,262,243,3561,0,20098,23659,14338,14,0,127,141
10845,VISAKHAPATANAM,Makavarapalem,Koduru,37,0,652,689,25,0,323,348,332,652,0,15164,15816,10696,0,0,19,19
10846,VISAKHAPATANAM,Makavarapalem,Kondala Agraharam,25,0,508,533,13,0,384,397,383,807,0,35215,36022,26312,2,0,201,203
10847,VISAKHAPATANAM,Makavarapalem,Latchannapalem,25,1,770,796,23,0,583,606,542,1044,0,44845,45889,28854,2,0,203,205
10848,VISAKHAPATANAM,Makavarapalem,Makavarapalem,88,0,528,616,41,0,316,357,314,2045,0,24250,26295,18665,1,0,101,102
10849,VISAKHAPATANAM,Makavarapalem,Mallavaram,48,0,215,263,43,0,135,178,145,4381,0,11489,15870,9345,29,0,70,99
10850,VISAKHAPATANAM,Makavarapalem,Narayana rajupeta,3,0,147,150,3,0,134,137,124,295,0,13535,13830,8447,2,0,95,97
10851,VISAKHAPATANAM,Makavarapalem,P.P. Agaraharam,28,0,397,425,22,0,375,397,372,2181,0,40960,43141,26999,14,0,308,322
10852,VISAKHAPATANAM,Makavarapalem,Papayyapalem,8,0,716,724,5,0,511,516,454,409,0,35361,35770,22433,1,0,137,138
10853,VISAKHAPATANAM,Makavarapalem,Peddipalem,35,0,409,444,17,0,318,335,323,985,0,28323,29308,18914,4,0,146,150
10854,VISAKHAPATANAM,Makavarapalem,Pydipala,65,0,461,526,60,0,362,422,400,5346,0,26879,32225,21224,32,0,123,155
10855,VISAKHAPATANAM,Makavarapalem,RAMANNAPALEM,28,1,572,601,19,0,474,493,503,1558,0,43284,44842,30646,9,0,272,281
10856,VISAKHAPATANAM,Makavarapalem,Ratchapalle,53,1,435,489,33,1,248,282,246,2214,39,19981,22234,15353,4,0,82,86
10857,VISAKHAPATANAM,Makavarapalem,SETTIPALEM,8,0,248,256,2,0,185,187,173,210,0,18276,18486,13133,2,0,137,139
10858,VISAKHAPATANAM,Makavarapalem,Tadapala,45,0,497,542,40,0,468,508,486,2461,0,43640,46101,25410,6,0,261,267
10859,VISAKHAPATANAM,Makavarapalem,Thamaram,58,1,417,476,25,0,277,302,277,1811,0,21819,23630,15235,13,0,119,132
10860,VISAKHAPATANAM,Makavarapalem,Tootipala,47,0,910,957,30,0,765,795,707,1778,0,61673,63451,34121,10,0,315,325
10861,VISAKHAPATANAM,Makavarapalem,Vajragada,87,0,1045,1132,40,0,376,416,361,1569,0,22057,23626,15409,0,0,34,34
10862,VISAKHAPATANAM,Makavarapalem,Z. Gangavaram,61,0,214,275,39,0,148,187,175,4307,0,15765,20072,11157,35,0,116,151
10863,VISAKHAPATANAM,Munagapaka,Arabupalem,25,0,101,126,12,0,29,41,34,731,0,1218,1949,1553,1,0,1,2
10864,VISAKHAPATANAM,Munagapaka,CHERLOPALEM,3,0,451,454,0,0,310,310,279,0,0,26276,26276,20511,0,0,153,153
10865,VISAKHAPATANAM,Munagapaka,Chuchikonda,53,0,337,390,45,0,135,180,165,2398,0,5693,8091,4729,4,0,6,10
10866,VISAKHAPATANAM,Munagapaka,Ganaparthi,61,0,397,458,49,0,232,281,263,4373,0,15081,19454,13143,23,0,30,53
10867,VISAKHAPATANAM,Munagapaka,Gantavarnipalem,44,2,288,334,27,2,237,266,275,1615,112,16469,18196,10735,2,0,38,40
10868,VISAKHAPATANAM,Munagapaka,Madakapalem,3,0,186,189,0,0,162,162,135,0,0,11606,11606,8403,0,0,40,40
10869,VISAKHAPATANAM,Munagapaka,MELUPAKA,117,4,445,566,80,2,256,338,304,4329,67,16961,21357,15151,5,0,40,45
10870,VISAKHAPATANAM,Munagapaka,Munagapaka,128,0,1451,1579,83,0,403,486,419,6570,0,37297,43867,29133,24,0,233,257
10871,VISAKHAPATANAM,Munagapaka,Nagavaram,44,0,707,751,7,0,203,210,215,605,0,10638,11243,10306,2,0,12,14
10872,VISAKHAPATANAM,Munagapaka,Nagulapalli,7,0,102,109,1,0,0,1,0,20,0,0,20,0,0,0,0,0
10873,VISAKHAPATANAM,Munagapaka,P. Anandapuram,26,0,149,175,8,0,39,47,30,483,0,1959,2442,875,3,0,8,11
10874,VISAKHAPATANAM,Munagapaka,Patipalle,48,0,805,853,3,0,424,427,400,215,0,32048,32263,22520,1,0,132,133
10875,VISAKHAPATANAM,Munagapaka,RAJUPETA,3,0,212,215,0,0,109,109,108,0,0,6991,6991,6473,0,0,7,7
10876,VISAKHAPATANAM,Munagapaka,T. Sirasapalle,11,0,498,509,2,0,68,70,68,56,0,1351,1407,1113,0,0,0,0
10877,VISAKHAPATANAM,Munagapaka,Thimmarajupeta,0,0,3,3,0,0,3,3,1,0,0,50,50,8,0,0,0,0
10878,VISAKHAPATANAM,Munagapaka,Thotada,83,2,845,930,4,0,148,152,123,93,0,2880,2973,1869,0,0,0,0
10879,VISAKHAPATANAM,Munagapaka,Ummalada,47,0,32,79,0,0,5,5,7,0,0,100,100,70,0,0,0,0
10880,VISAKHAPATANAM,Munagapaka,Vadrapalle,14,0,640,654,7,0,323,330,261,439,0,12507,12946,9311,0,0,19,19
10881,VISAKHAPATANAM,Munagapaka,Venkatapuram,11,0,44,55,0,0,0,0,0,0,0,0,0,0,0,0,0,0
10882,VISAKHAPATANAM,Munagapaka,Vompolu,15,3,241,259,7,0,147,154,129,510,0,10273,10783,8361,1,0,50,51
10883,VISAKHAPATANAM,Munchingiputtu,Babusala,0,663,0,663,0,602,0,602,647,0,40240,0,40240,19619,0,163,0,163
10884,VISAKHAPATANAM,Munchingiputtu,bangarumetta,0,751,0,751,0,570,0,570,601,0,37623,0,37623,18273,0,131,0,131
10885,VISAKHAPATANAM,Munchingiputtu,Barada,1,375,10,386,0,322,10,332,349,0,14798,996,15794,7734,0,24,6,30
10886,VISAKHAPATANAM,Munchingiputtu,BUNGAPUT,1,538,1,540,0,435,1,436,467,0,26663,54,26717,14184,0,60,0,60
10887,VISAKHAPATANAM,Munchingiputtu,Busiputtu,1,456,0,457,0,323,0,323,351,0,18021,0,18021,9367,0,52,0,52
10888,VISAKHAPATANAM,Munchingiputtu,Dareli,6,624,0,630,5,565,0,570,581,95,42995,0,43090,20940,0,199,0,199
10889,VISAKHAPATANAM,Munchingiputtu,Doddiputtu,3,506,0,509,0,392,0,392,500,0,26712,0,26712,13691,0,81,0,81
10890,VISAKHAPATANAM,Munchingiputtu,Jarjula,0,636,0,636,0,500,0,500,577,0,31655,0,31655,15636,0,67,0,67
10891,VISAKHAPATANAM,Munchingiputtu,Jerrala,1,415,18,434,0,365,19,384,460,0,28438,1880,30318,16007,0,130,13,143
10892,VISAKHAPATANAM,Munchingiputtu,Jolaputtu,0,428,0,428,0,377,0,377,399,0,24183,0,24183,12439,0,82,0,82
10893,VISAKHAPATANAM,Munchingiputtu,Karimukhiputtu,1,485,0,486,1,417,0,418,432,24,31588,0,31612,15032,0,132,0,132
10894,VISAKHAPATANAM,Munchingiputtu,KILAGADA,2,642,0,644,2,406,0,408,448,65,17609,0,17674,9121,0,18,0,18
10895,VISAKHAPATANAM,Munchingiputtu,Kinchput,2,663,1,666,1,465,1,467,544,129,26049,20,26198,13050,1,65,0,66
10896,VISAKHAPATANAM,Munchingiputtu,Kumada,6,622,0,628,0,449,0,449,479,0,27296,0,27296,14798,0,116,0,116
10897,VISAKHAPATANAM,Munchingiputtu,Laxmipuram,2,704,38,744,0,606,37,643,647,0,27293,1015,28308,14166,0,26,0,26
10898,VISAKHAPATANAM,Munchingiputtu,Makavaram,3,631,26,660,1,542,26,569,632,11,29962,1171,31144,15806,0,48,0,48
10899,VISAKHAPATANAM,Munchingiputtu,Panasaput,1,394,0,395,1,391,0,392,470,36,30668,0,30704,15252,0,126,0,126
10900,VISAKHAPATANAM,Munchingiputtu,Pedaguda,0,571,0,571,0,453,0,453,435,0,23387,0,23387,11757,0,44,0,44
10901,VISAKHAPATANAM,Munchingiputtu,Rangabayalu,0,456,0,456,0,339,0,339,379,0,13352,0,13352,7062,0,29,0,29
10902,VISAKHAPATANAM,Munchingiputtu,Sujanakota,1,633,61,695,0,360,44,404,394,0,14180,1596,15776,7800,0,17,0,17
10903,VISAKHAPATANAM,Munchingiputtu,Vanabhansangi,0,232,3,235,0,213,3,216,223,0,23037,237,23274,12083,0,143,1,144
10904,VISAKHAPATANAM,Munchingiputtu,Vanugumma,1,481,0,482,1,428,0,429,466,11,28359,0,28370,14451,0,74,0,74
10905,VISAKHAPATANAM,Munchingiputtu,YENUGURAI,0,485,10,495,0,431,10,441,504,0,29681,893,30574,15833,0,106,6,112
10906,VISAKHAPATANAM,Nakkapalli,Amalapuram,1,0,435,436,1,0,266,267,235,29,0,13094,13123,7411,0,0,14,14
10907,VISAKHAPATANAM,Nakkapalli,BANGARAMMAPETA,0,0,190,190,0,0,121,121,132,0,0,3477,3477,2788,0,0,1,1
10908,VISAKHAPATANAM,Nakkapalli,Bodugallam,30,0,60,90,27,0,39,66,54,1603,0,2331,3934,2231,5,0,5,10
10909,VISAKHAPATANAM,Nakkapalli,Buchirajupeta,36,0,123,159,25,0,72,97,80,1450,0,4608,6058,4467,6,0,23,29
10910,VISAKHAPATANAM,Nakkapalli,CHANDANADA,38,0,169,207,13,0,62,75,39,1002,0,4214,5216,2943,3,0,28,31
10911,VISAKHAPATANAM,Nakkapalli,Chinadoddigallu,143,1,735,879,108,0,335,443,403,5065,0,19011,24076,15214,4,0,83,87
10912,VISAKHAPATANAM,Nakkapalli,Chinateenarla,9,0,356,365,1,0,164,165,143,64,0,10233,10297,6002,0,0,23,23
10913,VISAKHAPATANAM,Nakkapalli,Chittibatla Agraharam,0,0,299,299,0,0,203,203,157,0,0,13884,13884,8012,0,0,49,49
10914,VISAKHAPATANAM,Nakkapalli,Chukalavarilakshmipuram,54,0,141,195,44,0,63,107,90,3207,0,3289,6496,3878,13,0,9,22
10915,VISAKHAPATANAM,Nakkapalli,Devavaram,65,2,773,840,26,0,336,362,335,1253,0,17272,18525,14996,5,0,31,36
10916,VISAKHAPATANAM,Nakkapalli,Donivanilakshmipuram,65,0,526,591,48,0,360,408,377,2397,0,23645,26042,19758,7,0,63,70
10917,VISAKHAPATANAM,Nakkapalli,Donkada,100,1,497,598,73,0,343,416,160,4370,0,15766,20136,5224,16,0,37,53
10918,VISAKHAPATANAM,Nakkapalli,Dosulapadu,29,141,588,758,24,103,469,596,551,1881,4546,39916,46343,23577,10,6,205,221
10919,VISAKHAPATANAM,Nakkapalli,G.JagannadhaPuram,71,0,269,340,30,0,113,143,108,661,0,2573,3234,1764,0,0,0,0
10920,VISAKHAPATANAM,Nakkapalli,Godicherla,69,0,365,434,58,0,263,321,268,2738,0,18617,21355,15087,2,0,58,60
10921,VISAKHAPATANAM,Nakkapalli,Gullipadu,26,0,234,260,23,0,149,172,96,2292,0,10333,12625,4663,15,0,33,48
10922,VISAKHAPATANAM,Nakkapalli,Gunipudi,107,1,176,284,88,1,140,229,209,6131,26,9057,15214,9556,33,0,33,66
10923,VISAKHAPATANAM,Nakkapalli,Janakayyapeta,1,0,425,426,0,0,357,357,348,0,0,23428,23428,21841,0,0,85,85
10924,VISAKHAPATANAM,Nakkapalli,Kagita,94,0,184,278,88,0,114,202,116,8279,0,6521,14800,6376,54,0,25,79
10925,VISAKHAPATANAM,Nakkapalli,Mukundarajupeta,40,0,224,264,34,0,181,215,222,2806,0,16627,19433,12676,14,0,108,122
10926,VISAKHAPATANAM,Nakkapalli,N. Narasapauram,1,0,286,287,0,0,269,269,232,0,0,24194,24194,13693,0,0,124,124
10927,VISAKHAPATANAM,Nakkapalli,Nakkapalle,228,0,188,416,46,0,21,67,59,1074,0,679,1753,1298,1,0,0,1
10928,VISAKHAPATANAM,Nakkapalli,Nayampudi,8,0,190,198,1,0,127,128,106,7,0,9782,9789,7158,0,0,50,50
10929,VISAKHAPATANAM,Nakkapalli,Nellipudi,22,1,186,209,12,1,76,89,71,443,18,2467,2928,2446,0,0,3,3
10930,VISAKHAPATANAM,Nakkapalli,Pedadoddigallu,43,0,405,448,28,0,345,373,353,1714,0,24618,26332,17261,7,0,86,93
10931,VISAKHAPATANAM,Nakkapalli,Pedateenarla,2,0,564,566,1,0,347,348,350,108,0,19691,19799,14968,1,0,35,36
10932,VISAKHAPATANAM,Nakkapalli,Rajayyapeta,11,1,890,902,0,0,416,416,425,0,0,22813,22813,18488,0,0,27,27
10933,VISAKHAPATANAM,Nakkapalli,Ramanayyapeta,26,1,262,289,19,0,133,152,32,1563,0,5842,7405,1363,11,0,11,22
10934,VISAKHAPATANAM,Nakkapalli,Rebaka,22,53,354,429,17,34,263,314,308,1391,559,26072,28022,13826,9,2,167,178
10935,VISAKHAPATANAM,Nakkapalli,Uddandapuram,65,1,386,452,47,0,156,203,136,2909,0,11479,14388,6357,8,0,48,56
10936,VISAKHAPATANAM,Nakkapalli,Upmaka,17,0,829,846,11,0,377,388,364,432,0,23982,24414,18739,1,0,70,71
10937,VISAKHAPATANAM,Nakkapalli,Vempadu,187,0,514,701,40,0,320,360,316,2545,0,24935,27480,16246,10,0,121,131
10938,VISAKHAPATANAM,Narsipatnam,Amalapuram,63,68,797,928,47,23,568,638,642,3256,2381,49320,54957,32105,12,16,296,324
10939,VISAKHAPATANAM,Narsipatnam,Balighattam,123,104,1432,1659,75,86,903,1064,984,1842,7999,54315,64156,42341,0,46,139,185
10940,VISAKHAPATANAM,Narsipatnam,CHETTUPALLI,221,12,1130,1363,125,6,835,966,924,6446,300,53997,60743,42856,14,0,115,129
10941,VISAKHAPATANAM,Narsipatnam,Dharmasagaram,10,0,937,947,8,0,847,855,809,478,0,74491,74969,46857,1,0,416,417
10942,VISAKHAPATANAM,Narsipatnam,Gabbada,47,0,487,534,28,0,360,388,365,2304,0,30991,33295,23808,18,0,185,203
10943,VISAKHAPATANAM,Narsipatnam,GURAMDORAPALEM,100,0,279,379,78,0,234,312,282,4941,0,15796,20737,13422,22,0,70,92
10944,VISAKHAPATANAM,Narsipatnam,Narsipatnam,2,0,265,267,0,0,66,66,57,0,0,2962,2962,1823,0,0,0,0
10945,VISAKHAPATANAM,Narsipatnam,NEELAMPETA,16,0,249,265,13,0,204,217,207,523,0,9428,9951,6901,1,0,21,22
10946,VISAKHAPATANAM,Narsipatnam,Ordinary Laxmipuram,60,0,285,345,45,0,249,294,277,3968,0,20096,24064,16416,21,0,81,102
10947,VISAKHAPATANAM,Narsipatnam,PEDABODDEPALLI,159,0,1057,1216,122,0,587,709,666,6559,0,28505,35064,25512,13,0,68,81
10948,VISAKHAPATANAM,Narsipatnam,Vemulapudi,246,0,2148,2394,103,0,1384,1487,1392,4034,0,89199,93233,50276,3,0,218,221
10949,VISAKHAPATANAM,Narsipatnam,Yerakannapalem,32,0,522,554,17,0,443,460,443,796,0,25714,26510,14965,2,0,61,63
10950,VISAKHAPATANAM,Nathavaram,ANANTHA PADMANABHAPURAM,52,0,478,530,29,0,305,334,299,2014,0,15490,17504,9662,10,0,14,24
10951,VISAKHAPATANAM,Nathavaram,Chammachinta,324,153,426,903,154,62,95,311,240,10023,3630,3268,16921,8278,44,11,2,57
10952,VISAKHAPATANAM,Nathavaram,Cherlopalem,105,0,869,974,91,0,638,729,604,7256,0,43004,50260,25631,31,0,124,155
10953,VISAKHAPATANAM,Nathavaram,D. YERRAVARAM,104,29,262,395,32,25,172,229,209,2779,2171,13915,18865,11211,18,12,62,92
10954,VISAKHAPATANAM,Nathavaram,GANDHI NAGARAM,82,3,105,190,58,2,56,116,82,4437,150,3717,8304,4585,16,0,16,32
10955,VISAKHAPATANAM,Nathavaram,Gannavaram,114,16,729,859,72,6,535,613,592,3760,173,35156,39089,25935,9,0,96,105
10956,VISAKHAPATANAM,Nathavaram,Golugonda Peta,106,0,348,454,80,0,270,350,308,5525,0,18910,24435,13637,26,0,80,106
10957,VISAKHAPATANAM,Nathavaram,Gummidigonda,115,50,453,618,85,44,272,401,334,7018,2696,12430,22144,12125,32,9,5,46
10958,VISAKHAPATANAM,Nathavaram,Gunupudi,82,1,876,959,50,0,696,746,638,3251,0,47078,50329,27035,8,0,134,142
10959,VISAKHAPATANAM,Nathavaram,K.V. Sarabhavaram,0,174,10,184,0,145,4,149,143,0,11088,366,11454,5713,0,55,2,57
10960,VISAKHAPATANAM,Nathavaram,M. Binnavaram,307,52,361,720,145,39,228,412,397,9054,1939,14842,25835,12924,9,3,20,32
10961,VISAKHAPATANAM,Nathavaram,MADHAVANAGARAM,96,25,394,515,57,17,256,330,259,3582,1424,18096,23102,11411,15,7,61,83
10962,VISAKHAPATANAM,Nathavaram,MALLUBHUPALA PATNAM,0,0,0,0,0,0,0,0,0,0,0,0,0,0,0,0,0,0
10963,VISAKHAPATANAM,Nathavaram,MALLUBHUPALA PATNAM(L),163,1,1007,1171,107,0,728,835,705,4421,0,48630,53051,28360,6,0,146,152
10964,VISAKHAPATANAM,Nathavaram,Manuyapuratla,265,1,654,920,128,0,376,504,313,7387,0,20080,27467,11391,27,0,52,79
10965,VISAKHAPATANAM,Nathavaram,Nathavaram,442,82,1204,1728,290,49,744,1083,1041,16773,3445,30804,51022,25567,30,12,35,77
10966,VISAKHAPATANAM,Nathavaram,P.K. Gudam,68,1,452,521,43,0,347,390,324,2589,0,20617,23206,11697,12,0,33,45
10967,VISAKHAPATANAM,Nathavaram,Pedda jaggampeta,61,0,362,423,45,0,296,341,265,2688,0,16219,18907,9569,8,0,20,28
10968,VISAKHAPATANAM,Nathavaram,Rajupeta Agaraharam,59,28,467,554,32,15,373,420,377,1995,680,23174,25849,14409,9,1,75,85
10969,VISAKHAPATANAM,Nathavaram,S.B. Patnam,82,0,126,208,76,0,117,193,177,5697,0,10981,16678,8247,23,0,69,92
10970,VISAKHAPATANAM,Nathavaram,Sarugudu,11,936,50,997,7,719,37,763,734,474,35643,2250,38367,20801,2,78,9,89
10971,VISAKHAPATANAM,Nathavaram,Srungavaram,113,0,393,506,91,0,285,376,299,5104,0,21569,26673,14772,10,0,74,84
10972,VISAKHAPATANAM,Nathavaram,Valasampeta,51,108,383,542,38,94,283,415,341,2029,5080,17938,25047,12973,7,8,50,65
10973,VISAKHAPATANAM,Nathavaram,Vedurupalle,56,28,339,423,27,24,229,280,238,1518,2347,11301,15166,8283,5,15,15,35
10974,VISAKHAPATANAM,Nathavaram,Veerabhoopati Agraharam,94,0,87,181,43,0,37,80,57,477,0,1467,1944,825,0,0,2,2
10975,VISAKHAPATANAM,Nathavaram,Y.D. Peta,160,71,578,809,76,42,322,440,335,4243,2384,19324,25951,12353,6,5,51,62
10976,VISAKHAPATANAM,Nathavaram,YerakabhoopatiAgraharam,36,0,175,211,18,0,129,147,79,982,0,8564,9546,3971,3,0,19,22
10977,VISAKHAPATANAM,Nathavaram,Zilledipudi,37,0,575,612,34,0,466,500,480,2402,0,35130,37532,21140,11,0,132,143
10978,VISAKHAPATANAM,Paderu,Ayinada,1,627,0,628,0,560,0,560,573,0,27691,0,27691,15027,0,50,0,50
10979,VISAKHAPATANAM,Paderu,Badimela,20,331,12,363,0,248,2,250,237,0,14517,72,14589,6940,0,40,0,40
10980,VISAKHAPATANAM,Paderu,Barisingi,0,214,0,214,0,193,0,193,236,0,14163,0,14163,7212,0,62,0,62
10981,VISAKHAPATANAM,Paderu,Chinthalaveedhi,1,500,28,529,1,393,8,402,419,19,20845,254,21118,12411,0,57,0,57
10982,VISAKHAPATANAM,Paderu,Devapuram,0,723,0,723,0,592,0,592,614,0,33088,0,33088,17621,0,83,0,83
10983,VISAKHAPATANAM,Paderu,Dokuluru,0,386,0,386,0,364,0,364,422,0,22158,0,22158,11371,0,55,0,55
10984,VISAKHAPATANAM,Paderu,Gobbangi,1,250,0,251,1,237,0,238,273,30,17865,0,17895,8534,0,68,0,68
10985,VISAKHAPATANAM,Paderu,Gondili,1,732,0,733,0,596,0,596,602,0,27075,0,27075,13775,0,41,0,41
10986,VISAKHAPATANAM,Paderu,Gonduvuru,0,323,0,323,0,290,0,290,343,0,20030,0,20030,10725,0,71,0,71
10987,VISAKHAPATANAM,Paderu,Guttalaputtu,3,353,80,436,1,259,57,317,327,12,12430,2078,14520,7640,0,18,0,18
10988,VISAKHAPATANAM,Paderu,Iradapalli,2,717,62,781,2,635,29,666,713,123,39115,360,39598,19924,0,82,0,82
10989,VISAKHAPATANAM,Paderu,Kadeli,1,390,0,391,0,333,0,333,368,0,25255,0,25255,14102,0,116,0,116
10990,VISAKHAPATANAM,Paderu,Kinchuru,0,456,0,456,0,291,0,291,325,0,8719,0,8719,4301,0,5,0,5
10991,VISAKHAPATANAM,Paderu,Kindangi,13,357,27,397,10,234,21,265,315,583,10460,1488,12531,7877,1,15,5,21
10992,VISAKHAPATANAM,Paderu,Kujjali,0,615,2,617,0,508,2,510,565,0,29102,80,29182,15942,0,65,0,65
10993,VISAKHAPATANAM,Paderu,Lagisipalli,0,270,0,270,0,210,0,210,215,0,15086,0,15086,8567,0,65,0,65
10994,VISAKHAPATANAM,Paderu,Minumuluru,18,378,1,397,16,343,1,360,382,615,20987,12,21614,11400,2,68,0,70
10995,VISAKHAPATANAM,Paderu,Modapalli,0,275,0,275,0,224,0,224,231,0,13400,0,13400,6605,0,40,0,40
10996,VISAKHAPATANAM,Paderu,Munchingiputtu,0,332,7,339,0,297,6,303,344,0,20047,118,20165,10508,0,64,0,64
10997,VISAKHAPATANAM,Paderu,Paderu,37,1009,137,1183,10,520,22,552,548,381,19671,622,20674,12465,1,43,1,45
10998,VISAKHAPATANAM,Paderu,Salugu,1,990,0,991,0,827,0,827,775,0,50277,0,50277,24077,0,120,0,120
10999,VISAKHAPATANAM,Paderu,Thumpada,0,355,3,358,0,260,3,263,264,0,10950,188,11138,5593,0,9,1,10
11000,VISAKHAPATANAM,Paderu,Vanajangi,0,435,0,435,0,344,0,344,353,0,19301,0,19301,9230,0,46,0,46
11001,VISAKHAPATANAM,Paderu,Vanthadapalli,0,366,0,366,0,294,0,294,335,0,22466,0,22466,11914,0,104,0,104
11002,VISAKHAPATANAM,Paderu,Vanthalamamidi,6,913,1,920,2,724,1,727,732,78,45081,62,45221,23246,0,146,0,146
11003,VISAKHAPATANAM,Paderu,Vanugupalli,1,928,1,930,0,415,0,415,430,0,16529,0,16529,7799,0,20,0,20
11004,VISAKHAPATANAM,Padmanabham,Ananthavaram,87,2,627,716,67,2,490,559,541,2508,123,36368,38999,23016,5,0,143,148
11005,VISAKHAPATANAM,Padmanabham,Ayinada,11,0,380,391,8,0,315,323,319,528,0,24478,25006,19473,2,0,125,127
11006,VISAKHAPATANAM,Padmanabham,B.R. Tallavalasa,86,2,1053,1141,40,0,683,723,701,915,0,34781,35696,27664,0,0,32,32
11007,VISAKHAPATANAM,Padmanabham,Bandevupuram,161,0,275,436,83,0,203,286,305,4153,0,11682,15835,10394,4,0,23,27
11008,VISAKHAPATANAM,Padmanabham,CHERIKANDAM,16,0,159,175,14,0,118,132,126,942,0,3985,4927,3059,1,0,0,1
11009,VISAKHAPATANAM,Padmanabham,Chinnapuram,1,0,233,234,1,0,193,194,194,26,0,14039,14065,9938,0,0,52,52
11010,VISAKHAPATANAM,Padmanabham,Gandavaram,91,0,548,639,66,0,440,506,526,3040,0,26110,29150,16579,6,0,57,63
11011,VISAKHAPATANAM,Padmanabham,Korada,22,1,653,676,20,1,475,496,452,1337,82,26249,27668,16098,7,0,94,101
11012,VISAKHAPATANAM,Padmanabham,Kovvada,194,13,395,602,125,0,279,404,351,8057,0,13734,21791,13184,33,0,38,71
11013,VISAKHAPATANAM,Padmanabham,Krishnapuram,121,3,404,528,28,1,239,268,283,1043,23,7266,8332,6529,2,0,0,2
11014,VISAKHAPATANAM,Padmanabham,Maddi,22,0,637,659,16,0,472,488,517,360,0,18866,19226,13417,0,0,28,28
11015,VISAKHAPATANAM,Padmanabham,Nerellavalasa,31,6,320,357,25,5,248,278,298,1150,268,13920,15338,11744,1,1,26,28
11016,VISAKHAPATANAM,Padmanabham,Padmanabham,6,14,429,449,3,10,163,176,177,121,211,7069,7401,4923,0,0,7,7
11017,VISAKHAPATANAM,Padmanabham,Pandrangi,46,5,1017,1068,23,1,538,562,604,1068,81,27400,28549,23854,2,0,41,43
11018,VISAKHAPATANAM,Padmanabham,Penta,27,2,253,282,19,2,203,224,198,1560,59,16790,18409,12016,10,0,75,85
11019,VISAKHAPATANAM,Padmanabham,Potnuru,148,0,574,722,121,0,436,557,546,7246,0,23746,30992,18927,17,0,45,62
11020,VISAKHAPATANAM,Padmanabham,Reddipalle Agrm.,239,0,714,953,151,0,437,588,564,11477,0,17904,29381,16770,63,0,26,89
11021,VISAKHAPATANAM,Padmanabham,Revidi,20,0,422,442,9,0,307,316,306,393,0,19139,19532,15556,1,0,41,42
11022,VISAKHAPATANAM,Padmanabham,Tunivalasa,50,8,516,574,10,6,399,415,420,546,621,28105,29272,20915,2,3,99,104
11023,VISAKHAPATANAM,Padmanabham,Venkatapuram,0,0,327,327,0,0,254,254,261,0,0,15733,15733,11950,0,0,43,43
11024,VISAKHAPATANAM,Padmanabham,Vilasakannapalem,39,0,252,291,24,0,167,191,189,1383,0,6957,8340,5244,7,0,3,10
11025,VISAKHAPATANAM,Paravada,Bharinikam,20,0,147,167,14,0,91,105,91,1086,0,6453,7539,6287,6,0,23,29
11026,VISAKHAPATANAM,Paravada,Cheepurupalle (West),69,0,275,344,0,0,107,107,103,0,0,7861,7861,6847,0,0,46,46
11027,VISAKHAPATANAM,Paravada,Dasapatrunipalem,0,0,0,0,0,0,0,0,0,0,0,0,0,0,0,0,0,0
11028,VISAKHAPATANAM,Paravada,Edulapaka bonangi,1,0,119,120,1,0,99,100,83,18,0,7394,7412,6052,0,0,46,46
11029,VISAKHAPATANAM,Paravada,Gorlivani palem,5,1,240,246,4,0,171,175,157,448,0,16516,16964,14093,4,0,112,116
11030,VISAKHAPATANAM,Paravada,Kalapaka,8,0,288,296,2,0,185,187,175,30,0,11451,11481,10599,0,0,32,32
11031,VISAKHAPATANAM,Paravada,Kannuru,2,0,218,220,0,0,176,176,161,0,0,10654,10654,9079,0,0,11,11
11032,VISAKHAPATANAM,Paravada,Mutyalammapalem,0,0,0,0,0,0,0,0,0,0,0,0,0,0,0,0,0,0
11033,VISAKHAPATANAM,Paravada,Naidupalem,23,1,289,313,17,0,93,110,105,1463,0,6008,7471,6574,5,0,13,18
11034,VISAKHAPATANAM,Paravada,Paravada,3,0,116,119,1,0,21,22,20,97,0,2067,2164,1931,0,0,15,15
11035,VISAKHAPATANAM,Paravada,Payakarao Bonangi,28,0,211,239,6,0,114,120,99,301,0,7822,8123,6362,0,0,10,10
11036,VISAKHAPATANAM,Paravada,Pedamusidivada,30,0,374,404,1,0,140,141,139,62,0,9900,9962,8459,0,0,19,19
11037,VISAKHAPATANAM,Paravada,Ravada,4,0,396,400,0,0,116,116,109,0,0,7391,7391,6268,0,0,4,4
11038,VISAKHAPATANAM,Paravada,Salapuvanipalem,1,0,32,33,0,0,0,0,0,0,0,0,0,0,0,0,0,0
11039,VISAKHAPATANAM,Paravada,Thadi,0,0,0,0,0,0,0,0,0,0,0,0,0,0,0,0,0,0
11040,VISAKHAPATANAM,Paravada,Thanam,6,0,203,209,0,0,0,0,0,0,0,0,0,0,0,0,0,0
11041,VISAKHAPATANAM,Paravada,VENNELAPALEM,1,0,268,269,0,0,137,137,129,0,0,11046,11046,10382,0,0,70,70
11042,VISAKHAPATANAM,Payakaraopeta,Aratlakota,354,0,442,796,186,0,29,215,178,12463,0,1183,13646,8118,48,0,5,53
11043,VISAKHAPATANAM,Payakaraopeta,Edatam,96,0,390,486,73,0,219,292,237,4197,0,13569,17766,9127,10,0,33,43
11044,VISAKHAPATANAM,Payakaraopeta,Gopalapatnam,139,0,598,737,67,0,150,217,114,4623,0,6357,10980,5762,17,0,8,25
11045,VISAKHAPATANAM,Payakaraopeta,Guntapalle,148,0,404,552,89,0,142,231,142,5365,0,6206,11571,5852,14,0,6,20
11046,VISAKHAPATANAM,Payakaraopeta,Kandipudi,51,0,257,308,14,0,150,164,126,879,0,12124,13003,8974,1,0,59,60
11047,VISAKHAPATANAM,Payakaraopeta,Kesavaram,61,0,220,281,49,0,136,185,65,2329,0,5374,7703,2100,6,0,4,10
11048,VISAKHAPATANAM,Payakaraopeta,Kothuru,3,0,279,282,0,0,37,37,26,0,0,1567,1567,995,0,0,2,2
11049,VISAKHAPATANAM,Payakaraopeta,Kumarapuram,38,1,551,590,11,1,242,254,252,263,18,15793,16074,10863,0,0,41,41
11050,VISAKHAPATANAM,Payakaraopeta,Mangavaram,207,1,718,926,135,0,80,215,162,7344,0,3305,10649,5830,19,0,1,20
11051,VISAKHAPATANAM,Payakaraopeta,Masahebpeta,99,0,402,501,74,0,81,155,116,4167,0,3426,7593,4724,6,0,2,8
11052,VISAKHAPATANAM,Payakaraopeta,Namavaram,59,0,271,330,35,0,129,164,132,2009,0,8218,10227,6859,6,0,35,41
11053,VISAKHAPATANAM,Payakaraopeta,Padalavani Laxmipuram,207,0,103,310,71,0,0,71,61,1467,0,0,1467,1176,0,0,0,0
11054,VISAKHAPATANAM,Payakaraopeta,Palamanpeta,0,0,825,825,0,0,334,334,319,0,0,13858,13858,10752,0,0,20,20
11055,VISAKHAPATANAM,Payakaraopeta,Palteru,52,0,533,585,24,0,181,205,145,1228,0,10818,12046,8400,1,0,11,12
11056,VISAKHAPATANAM,Payakaraopeta,Payakarao peta,500,1,201,702,31,0,2,33,30,1301,0,15,1316,1095,2,0,0,2
11057,VISAKHAPATANAM,Payakaraopeta,Pedarama bhadra puram,341,3,205,549,54,0,6,60,49,3111,0,113,3224,2081,8,0,0,8
11058,VISAKHAPATANAM,Payakaraopeta,Pentakota,228,2,614,844,105,0,235,340,269,5045,0,9136,14181,9308,5,0,3,8
11059,VISAKHAPATANAM,Payakaraopeta,RAJAGOPALAPURAM,28,0,173,201,20,0,71,91,80,1326,0,4033,5359,3260,2,0,10,12
11060,VISAKHAPATANAM,Payakaraopeta,Rajavaram,86,0,501,587,37,0,194,231,208,893,0,7502,8395,6171,0,0,5,5
11061,VISAKHAPATANAM,Payakaraopeta,S. Narasapuram,110,0,279,389,53,0,122,175,155,3322,0,6503,9825,6975,10,0,10,20
11062,VISAKHAPATANAM,Payakaraopeta,Satyavaram,447,25,751,1223,179,0,7,186,166,10025,0,85,10110,5692,21,0,0,21
11063,VISAKHAPATANAM,Payakaraopeta,Seetharam puram,8,0,245,253,1,0,186,187,164,18,0,11542,11560,8360,0,0,31,31
11064,VISAKHAPATANAM,Payakaraopeta,Srirampuram,287,1,625,913,126,0,152,278,182,5283,0,4505,9788,5015,3,0,4,7
11065,VISAKHAPATANAM,Payakaraopeta,Venkatanagaram,0,0,742,742,0,0,331,331,322,0,0,6234,6234,5393,0,0,0,0
11066,VISAKHAPATANAM,Pedabayalu,Adugula puttu,2,541,0,543,1,488,0,489,543,24,31887,0,31911,16791,0,117,0,117
11067,VISAKHAPATANAM,Pedabayalu,Arada kota,0,578,0,578,0,378,0,378,426,0,23294,0,23294,12275,0,56,0,56
11068,VISAKHAPATANAM,Pedabayalu,Bondapalli,1,621,0,622,0,490,0,490,531,0,25949,0,25949,13146,0,53,0,53
11069,VISAKHAPATANAM,Pedabayalu,Bongaram,1,537,1,539,0,360,0,360,414,0,18305,0,18305,9678,0,21,0,21
11070,VISAKHAPATANAM,Pedabayalu,GALAGONDA,1,506,0,507,0,451,0,451,463,0,29373,0,29373,15218,0,95,0,95
11071,VISAKHAPATANAM,Pedabayalu,Gampari,0,630,0,630,0,471,0,471,474,0,21990,0,21990,11242,0,24,0,24
11072,VISAKHAPATANAM,Pedabayalu,GINNILAKOTA,1,563,0,564,1,450,0,451,502,138,25597,0,25735,12285,1,52,0,53
11073,VISAKHAPATANAM,Pedabayalu,Gomangi,1,630,0,631,0,242,0,242,242,0,4983,0,4983,2440,0,2,0,2
11074,VISAKHAPATANAM,Pedabayalu,Gullelu,0,354,0,354,0,268,0,268,310,0,17380,0,17380,9160,0,38,0,38
11075,VISAKHAPATANAM,Pedabayalu,Injarai,0,967,0,967,0,760,0,760,838,0,44005,0,44005,21024,0,114,0,114
11076,VISAKHAPATANAM,Pedabayalu,JAMIGUDA,1,764,0,765,0,166,0,166,157,0,5500,0,5500,2399,0,1,0,1
11077,VISAKHAPATANAM,Pedabayalu,Kimudupalli,11,955,1,967,4,757,1,762,740,102,36229,36,36367,17225,0,34,0,34
11078,VISAKHAPATANAM,Pedabayalu,Koravangi,0,428,0,428,0,271,0,271,284,0,12160,0,12160,6054,0,18,0,18
11079,VISAKHAPATANAM,Pedabayalu,Kuntharla,8,856,0,864,1,634,0,635,658,10,21076,0,21086,10263,0,17,0,17
11080,VISAKHAPATANAM,Pedabayalu,Laxmipeta,0,652,0,652,0,591,0,591,589,0,33974,0,33974,15817,0,66,0,66
11081,VISAKHAPATANAM,Pedabayalu,LINGETI,0,428,0,428,0,404,0,404,454,0,18506,0,18506,9276,0,33,0,33
11082,VISAKHAPATANAM,Pedabayalu,Parreda,0,623,0,623,0,486,0,486,469,0,27706,0,27706,14492,0,69,0,69
11083,VISAKHAPATANAM,Pedabayalu,Pedakodapalli,1,981,1,983,1,827,1,829,954,150,62847,23,63020,31059,1,207,0,208
11084,VISAKHAPATANAM,Pedabayalu,POIPALLI,0,386,0,386,0,359,0,359,417,0,26383,0,26383,12951,0,72,0,72
11085,VISAKHAPATANAM,Pedabayalu,Rudakota,1,552,2,555,0,471,2,473,508,0,35166,45,35211,17533,0,138,0,138
11086,VISAKHAPATANAM,Pedabayalu,Seekari,2,618,0,620,1,532,0,533,546,10,29821,0,29831,15491,0,77,0,77
11087,VISAKHAPATANAM,Pedabayalu,Seethagunta,0,438,1,439,0,329,0,329,369,0,17674,0,17674,8737,0,41,0,41
11088,VISAKHAPATANAM,Pedabayalu,Vanabangi,1,530,0,531,0,384,0,384,437,0,30875,0,30875,16394,0,147,0,147
11089,VISAKHAPATANAM,Pendurthi,Chintagatla,5,0,162,167,4,0,90,94,86,156,0,4825,4981,4160,0,0,6,6
11090,VISAKHAPATANAM,Pendurthi,Chinthala Agraharam,0,0,34,34,0,0,2,2,1,0,0,10,10,5,0,0,0,0
11091,VISAKHAPATANAM,Pendurthi,GAVARAPALEM,2,0,133,135,0,0,118,118,112,0,0,9338,9338,7980,0,0,48,48
11092,VISAKHAPATANAM,Pendurthi,Gorapalle,22,0,512,534,20,0,377,397,367,777,0,29319,30096,26227,1,0,150,151
11093,VISAKHAPATANAM,Pendurthi,Gurrampalem,61,2,380,443,31,0,255,286,274,1520,0,16228,17748,14489,2,0,29,31
11094,VISAKHAPATANAM,Pendurthi,JANGALAPALEM,2,0,128,130,0,0,64,64,58,0,0,3504,3504,2643,0,0,6,6
11095,VISAKHAPATANAM,Pendurthi,Jerripothulapalem,4,0,48,52,4,0,33,37,39,207,0,3007,3214,2685,1,0,20,21
11096,VISAKHAPATANAM,Pendurthi,Mudapaka,46,6,265,317,24,5,191,220,201,1658,447,12513,14618,11952,8,1,16,25
11097,VISAKHAPATANAM,Pendurthi,Pedagadi,13,0,217,230,0,0,18,18,14,0,0,1093,1093,838,0,0,0,0
11098,VISAKHAPATANAM,Pendurthi,Pinagadi,31,1,224,256,23,0,182,205,196,2125,0,15548,17673,14506,14,0,86,100
11099,VISAKHAPATANAM,Pendurthi,Rajayyapeta,68,1,152,221,30,1,115,146,142,1726,88,7829,9643,8436,6,0,5,11
11100,VISAKHAPATANAM,Pendurthi,Rampuram,11,0,302,313,9,0,204,213,188,595,0,16876,17471,13462,4,0,106,110
11101,VISAKHAPATANAM,Pendurthi,Saripalle,50,2,395,447,39,2,305,346,335,2178,69,18460,20707,13587,4,0,53,57
11102,VISAKHAPATANAM,Pendurthi,Sowbhagya rayapuram,30,0,177,207,6,0,119,125,125,306,0,9648,9954,9615,1,0,55,56
11103,VISAKHAPATANAM,Pendurthi,Valimeraka,31,0,279,310,1,0,124,125,115,94,0,9035,9129,8266,0,0,16,16
11104,VISAKHAPATANAM,Rambilli,Dimili,57,0,647,704,42,0,567,609,560,1479,0,32918,34397,25673,0,0,65,65
11105,VISAKHAPATANAM,Rambilli,Edullamma Lova,0,0,146,146,0,0,108,108,20,0,0,6008,6008,1109,0,0,12,12
11106,VISAKHAPATANAM,Rambilli,Gokivada,12,0,546,558,7,0,322,329,236,392,0,16189,16581,11024,0,0,21,21
11107,VISAKHAPATANAM,Rambilli,Gorapudi,15,1,235,251,6,0,108,114,91,90,0,4974,5064,3440,0,0,7,7
11108,VISAKHAPATANAM,Rambilli,Govinda palem,2,0,258,260,0,0,73,73,58,0,0,2943,2943,1683,0,0,1,1
11109,VISAKHAPATANAM,Rambilli,Gurjapalem,0,0,1,1,0,0,0,0,0,0,0,0,0,0,0,0,0,0
11110,VISAKHAPATANAM,Rambilli,Haripuram,0,0,299,299,0,0,165,165,146,0,0,9905,9905,7489,0,0,28,28
11111,VISAKHAPATANAM,Rambilli,Kalavalapalli,0,0,123,123,0,0,57,57,45,0,0,384,384,270,0,0,0,0
11112,VISAKHAPATANAM,Rambilli,Kattabolu,21,0,202,223,16,0,172,188,175,910,0,8222,9132,6589,1,0,3,4
11113,VISAKHAPATANAM,Rambilli,KOPPUGONDUPALEM,0,0,148,148,0,0,56,56,2,0,0,1227,1227,12,0,0,1,1
11114,VISAKHAPATANAM,Rambilli,Kotha Patnam,1,0,359,360,0,0,72,72,64,0,0,1432,1432,994,0,0,0,0
11115,VISAKHAPATANAM,Rambilli,Kotha peta,16,0,66,82,8,0,33,41,37,690,0,1836,2526,1506,2,0,2,4
11116,VISAKHAPATANAM,Rambilli,Kothuru,43,4,279,326,38,3,191,232,161,3064,45,12229,15338,9089,16,0,38,54
11117,VISAKHAPATANAM,Rambilli,Krishnampalem,6,0,185,191,4,0,151,155,120,235,0,14153,14388,7654,1,0,76,77
11118,VISAKHAPATANAM,Rambilli,Kumarapalli,20,0,168,188,18,0,146,164,117,1234,0,9703,10937,5688,8,0,36,44
11119,VISAKHAPATANAM,Rambilli,Lalamkoduru,28,0,496,524,16,0,186,202,190,1471,0,15203,16674,12980,11,0,46,57
11120,VISAKHAPATANAM,Rambilli,MAMIDIVADA,40,0,224,264,37,0,145,182,121,2195,0,11200,13395,5854,7,0,46,53
11121,VISAKHAPATANAM,Rambilli,Marripalem,6,0,124,130,6,0,112,118,4,285,0,5214,5499,340,1,0,7,8
11122,VISAKHAPATANAM,Rambilli,Moturupalem,0,0,0,0,0,0,0,0,0,0,0,0,0,0,0,0,0,0
11123,VISAKHAPATANAM,Rambilli,Mulajampa,6,1,300,307,6,1,280,287,281,157,78,19169,19404,13003,0,0,39,39
11124,VISAKHAPATANAM,Rambilli,Murakada,34,0,235,269,28,0,191,219,119,1239,0,11144,12383,6827,1,0,25,26
11125,VISAKHAPATANAM,Rambilli,Panchadarla,37,0,322,359,19,0,176,195,163,1224,0,13846,15070,10033,5,0,68,73
11126,VISAKHAPATANAM,Rambilli,PEDA KALAVALAPALLI,47,0,428,475,25,0,363,388,390,1368,0,29315,30683,25451,3,0,123,126
11127,VISAKHAPATANAM,Rambilli,Pudi,0,0,0,0,0,0,0,0,0,0,0,0,0,0,0,0,0,0
11128,VISAKHAPATANAM,Rambilli,Raja koduru,30,1,341,372,21,0,291,312,255,1495,0,24030,25525,15083,8,0,128,136
11129,VISAKHAPATANAM,Rambilli,Rajala,29,0,121,150,31,0,119,150,108,2083,0,9809,11892,6078,8,0,58,66
11130,VISAKHAPATANAM,Rambilli,Rambilli,30,1,366,397,23,0,113,136,138,860,0,7661,8521,7506,2,0,39,41
11131,VISAKHAPATANAM,Rambilli,Vadanarasa puram,8,0,283,291,0,0,54,54,41,0,0,1621,1621,769,0,0,1,1
11132,VISAKHAPATANAM,Rambilli,VELCHERU,68,1,186,255,37,1,128,166,144,2066,26,6003,8095,5981,2,0,6,8
11133,VISAKHAPATANAM,Rambilli,Zirayati chintuva,3,0,414,417,2,0,165,167,173,117,0,7866,7983,6575,0,0,17,17
11134,VISAKHAPATANAM,Ravikamatham,Cheemalapadu,4,576,51,631,3,301,49,353,354,135,11590,2730,14455,8525,0,17,7,24
11135,VISAKHAPATANAM,Ravikamatham,Chinapachila,68,1,616,685,45,1,470,516,420,1936,57,18411,20404,11193,7,0,9,16
11136,VISAKHAPATANAM,Ravikamatham,Dondapudi,76,0,816,892,43,0,456,499,432,1237,0,24904,26141,15771,0,0,54,54
11137,VISAKHAPATANAM,Ravikamatham,GAMPAVANIPALEM,0,0,444,444,0,0,356,356,341,0,0,23541,23541,13011,0,0,74,74
11138,VISAKHAPATANAM,Ravikamatham,Garnikam,40,0,410,450,23,0,273,296,299,665,0,11922,12587,7039,0,0,36,36
11139,VISAKHAPATANAM,Ravikamatham,Gompa,31,3,457,491,15,1,381,397,366,643,81,23627,24351,13152,3,0,58,61
11140,VISAKHAPATANAM,Ravikamatham,Guddipa,23,29,521,573,0,0,363,363,354,0,0,15465,15465,9189,0,0,15,15
11141,VISAKHAPATANAM,Ravikamatham,Gudiwada,31,0,674,705,21,0,493,514,525,822,0,26103,26925,15053,1,0,64,65
11142,VISAKHAPATANAM,Ravikamatham,Gummallapadu,25,0,287,312,23,0,270,293,302,1200,0,17039,18239,11474,1,0,51,52
11143,VISAKHAPATANAM,Ravikamatham,KANNAMPETA,36,0,656,692,17,0,457,474,466,858,0,28641,29499,16263,3,0,86,89
11144,VISAKHAPATANAM,Ravikamatham,Kavagunta,8,54,153,215,5,43,124,172,163,464,2131,6154,8749,6046,3,2,12,17
11145,VISAKHAPATANAM,Ravikamatham,KOMIRA,35,47,429,511,31,41,399,471,458,1925,3506,35546,40977,22586,7,12,179,198
11146,VISAKHAPATANAM,Ravikamatham,Kothakota,292,2,1426,1720,83,0,568,651,576,3671,0,34628,38299,23160,3,0,99,102
11147,VISAKHAPATANAM,Ravikamatham,Machavani palem,5,0,303,308,4,0,250,254,250,233,0,15649,15882,9486,0,0,32,32
11148,VISAKHAPATANAM,Ravikamatham,Marrivalasa,34,0,219,253,21,0,91,112,94,1146,0,3214,4360,2762,2,0,1,3
11149,VISAKHAPATANAM,Ravikamatham,Marupaka,26,8,837,871,4,0,516,520,527,269,0,27784,28053,15632,1,0,67,68
11150,VISAKHAPATANAM,Ravikamatham,Medivada,65,20,996,1081,23,9,495,527,454,1223,289,20929,22441,12137,0,0,22,22
11151,VISAKHAPATANAM,Ravikamatham,P.Ponnavolu,17,28,613,658,12,24,467,503,493,732,1621,25399,27752,13841,2,3,38,43
11152,VISAKHAPATANAM,Ravikamatham,Ravikamatham,61,14,777,852,0,1,329,330,312,0,62,14843,14905,8959,0,0,17,17
11153,VISAKHAPATANAM,Ravikamatham,T. Arjapuram,115,271,1199,1585,79,215,678,972,974,4221,10548,41238,56007,31244,4,8,45,57
11154,VISAKHAPATANAM,Ravikamatham,Tattaband,12,17,585,614,7,15,424,446,445,170,318,20342,20830,11212,0,0,39,39
11155,VISAKHAPATANAM,Ravikamatham,Totakurapalem,39,0,571,610,21,0,359,380,345,353,0,21558,21911,13352,0,0,58,58
11156,VISAKHAPATANAM,Ravikamatham,Z. Bennavaram,71,27,293,391,47,19,237,303,271,1339,263,13174,14776,7616,1,0,20,21
11157,VISAKHAPATANAM,Ravikamatham,Z. Kothapatnam,99,85,340,524,40,57,193,290,262,1649,2332,11074,15055,9889,3,0,17,20
11158,VISAKHAPATANAM,Rolugunta,Addasaram,41,45,241,327,35,29,213,277,271,1104,1002,16223,18329,10852,1,0,61,62
11159,VISAKHAPATANAM,Rolugunta,B. Bhupala patnam,109,0,308,417,86,0,283,369,361,5143,0,22391,27534,15042,16,0,104,120
11160,VISAKHAPATANAM,Rolugunta,Butchampeta,54,0,946,1000,38,0,651,689,638,1204,0,38484,39688,21946,1,0,62,63
11161,VISAKHAPATANAM,Rolugunta,Gundubadu,17,2,735,754,14,2,660,676,636,617,84,36088,36789,20306,0,0,43,43
11162,VISAKHAPATANAM,Rolugunta,Jaggampeta,138,46,954,1138,70,7,572,649,610,3543,224,17851,21618,10676,4,0,6,10
11163,VISAKHAPATANAM,Rolugunta,Janakirampuram,38,2,540,580,32,2,390,424,384,1483,152,28754,30389,15531,2,0,124,126
11164,VISAKHAPATANAM,Rolugunta,JanakirampuramAgrahara,6,0,291,297,3,0,238,241,230,232,0,16284,16516,10551,1,0,51,52
11165,VISAKHAPATANAM,Rolugunta,K.NAIDU PALEM,103,32,544,679,80,23,407,510,459,7039,1513,27732,36284,20946,34,1,78,113
11166,VISAKHAPATANAM,Rolugunta,Kanchugummala,37,0,311,348,33,0,274,307,288,2688,0,18365,21053,14314,15,0,58,73
11167,VISAKHAPATANAM,Rolugunta,Komaravolu,90,0,540,630,70,0,406,476,437,4070,0,24265,28335,17203,9,0,64,73
11168,VISAKHAPATANAM,Rolugunta,Kondapalem,31,4,468,503,23,4,399,426,449,1826,291,32697,34814,18992,10,1,129,140
11169,VISAKHAPATANAM,Rolugunta,Konthalam,79,269,527,875,56,177,390,623,622,3295,8674,27928,39897,21903,3,9,92,104
11170,VISAKHAPATANAM,Rolugunta,Kovvuru,27,14,505,546,16,4,378,398,316,917,108,25039,26064,14096,2,0,68,70
11171,VISAKHAPATANAM,Rolugunta,Kusarlapudi,35,1,746,782,31,1,618,650,636,2085,48,41201,43334,24807,5,0,86,91
11172,VISAKHAPATANAM,Rolugunta,M. Kothapatnam,92,199,276,567,54,84,207,345,309,4581,3405,15983,23969,15592,25,6,69,100
11173,VISAKHAPATANAM,Rolugunta,N.KOTHURU,16,0,351,367,4,0,247,251,221,171,0,18488,18659,11045,0,0,61,61
11174,VISAKHAPATANAM,Rolugunta,Nindugonda,50,0,336,386,29,0,181,210,159,1692,0,12085,13777,7369,1,0,43,44
11175,VISAKHAPATANAM,Rolugunta,Ratnampeta,73,118,441,632,67,75,403,545,541,5125,4686,33178,42989,22530,23,13,150,186
11176,VISAKHAPATANAM,Rolugunta,Rolugunta,119,45,756,920,62,11,457,530,539,4153,572,36677,41402,24890,14,0,174,188
11177,VISAKHAPATANAM,Rolugunta,Sarabhavaram,202,221,849,1272,130,174,668,972,994,10126,15448,50763,76337,41299,44,90,209,343
11178,VISAKHAPATANAM,Rolugunta,Vaddippa,103,1,285,389,81,1,244,326,278,5854,16,17380,23250,11738,18,0,51,69
11179,VISAKHAPATANAM,S Rayavaram,Bheemavaram,95,0,189,284,89,0,175,264,242,6817,0,12747,19564,10698,18,0,34,52
11180,VISAKHAPATANAM,S Rayavaram,Chingummuluru,37,0,327,364,35,0,309,344,311,2515,0,26075,28590,20700,12,0,99,111
11181,VISAKHAPATANAM,S Rayavaram,Darlapudi,162,0,639,801,67,0,384,451,404,3522,0,24404,27926,15710,7,0,43,50
11182,VISAKHAPATANAM,S Rayavaram,Dharmavaram Agraharam,10,1,273,284,7,0,194,201,191,218,0,7665,7883,5680,0,0,5,5
11183,VISAKHAPATANAM,S Rayavaram,GEDDAPALEM,55,0,240,295,54,0,220,274,51,3734,0,7950,11684,2239,11,0,0,11
11184,VISAKHAPATANAM,S Rayavaram,Gudivada,44,0,294,338,38,0,227,265,245,2295,0,12624,14919,10309,7,0,16,23
11185,VISAKHAPATANAM,S Rayavaram,Gurrajupeta,10,0,256,266,11,0,253,264,282,727,0,20858,21585,16356,2,0,109,111
11186,VISAKHAPATANAM,S Rayavaram,Janguluruvelampalem,31,0,308,339,33,0,286,319,317,1972,0,14627,16599,11651,4,0,32,36
11187,VISAKHAPATANAM,S Rayavaram,Karrivanipalem,12,0,141,153,13,0,119,132,48,884,0,7012,7896,2500,3,0,21,24
11188,VISAKHAPATANAM,S Rayavaram,Koruprolu,76,0,313,389,66,0,253,319,231,4801,0,16647,21448,12487,15,0,35,50
11189,VISAKHAPATANAM,S Rayavaram,Kotharevu Polavaram,2,0,415,417,1,0,403,404,432,46,0,17650,17696,17106,0,0,16,16
11190,VISAKHAPATANAM,S Rayavaram,Lingarajupalem,127,0,270,397,90,0,242,332,289,5955,0,15610,21565,12986,13,0,47,60
11191,VISAKHAPATANAM,S Rayavaram,Pedagummaluru,73,0,180,253,58,0,150,208,113,3816,0,10455,14271,5858,19,0,51,70
11192,VISAKHAPATANAM,S Rayavaram,Pedda Uppalam,66,0,434,500,32,0,301,333,248,1747,0,15326,17073,10072,4,0,22,26
11193,VISAKHAPATANAM,S Rayavaram,Penugollu,70,0,388,458,37,0,286,323,299,833,0,8206,9039,6054,0,0,2,2
11194,VISAKHAPATANAM,S Rayavaram,Petasudipuram,12,0,221,233,12,0,213,225,207,786,0,14906,15692,9385,2,0,48,50
11195,VISAKHAPATANAM,S Rayavaram,Pettugollapalli,3,0,309,312,2,0,251,253,238,48,0,15804,15852,10382,0,0,48,48
11196,VISAKHAPATANAM,S Rayavaram,Ramayyapatnam,53,0,286,339,27,0,196,223,196,1227,0,11821,13048,8452,1,0,18,19
11197,VISAKHAPATANAM,S Rayavaram,Revupolavaram,0,0,293,293,0,0,238,238,256,0,0,11997,11997,11222,0,0,10,10
11198,VISAKHAPATANAM,S Rayavaram,S. Rayavaram,149,5,393,547,113,4,275,392,318,3458,120,12136,15714,9528,2,0,17,19
11199,VISAKHAPATANAM,S Rayavaram,SAITAARUPETA,21,0,422,443,20,0,388,408,349,1705,0,12855,14560,7412,7,0,8,15
11200,VISAKHAPATANAM,S Rayavaram,Sarvasiddi,47,0,178,225,39,0,115,154,116,2826,0,7460,10286,5623,12,0,22,34
11201,VISAKHAPATANAM,S Rayavaram,Thimmapuram,49,0,637,686,30,0,453,483,444,1334,0,17254,18588,12035,1,0,15,16
11202,VISAKHAPATANAM,S Rayavaram,Upparapalli,12,0,413,425,4,0,340,344,322,158,0,12839,12997,8419,0,0,12,12
11203,VISAKHAPATANAM,S Rayavaram,Vakapadu,41,0,733,774,38,0,638,676,685,2995,0,33061,36056,28723,10,0,40,50
11204,VISAKHAPATANAM,S Rayavaram,Vemagiri,24,0,220,244,22,0,198,220,192,1907,0,19439,21346,10603,11,0,133,144
11205,VISAKHAPATANAM,S Rayavaram,VENKATAAPURAM,31,0,132,163,30,0,105,135,117,2819,0,7772,10591,5803,19,0,28,47
11206,VISAKHAPATANAM,S Rayavaram,Vommavaram,56,0,159,215,0,0,52,52,36,0,0,409,409,198,0,0,0,0
11207,VISAKHAPATANAM,Sabbavaram,Amrutapuram,44,1,489,534,17,1,146,164,109,982,73,7485,8540,5401,3,0,24,27
11208,VISAKHAPATANAM,Sabbavaram,Anthakapalle,25,0,760,785,14,0,437,451,399,515,0,27199,27714,20629,1,0,53,54
11209,VISAKHAPATANAM,Sabbavaram,Aripaka,69,0,439,508,35,0,158,193,163,2493,0,9170,11663,7320,11,0,18,29
11210,VISAKHAPATANAM,Sabbavaram,Asakapalle,35,0,623,658,1,0,360,361,289,20,0,30215,30235,20667,0,0,150,150
11211,VISAKHAPATANAM,Sabbavaram,Ayyannapalem,29,1,281,311,17,0,192,209,196,933,0,11661,12594,9301,2,0,36,38
11212,VISAKHAPATANAM,Sabbavaram,Bangarammapalem,44,0,350,394,13,0,301,314,288,891,0,28845,29736,16182,5,0,183,188
11213,VISAKHAPATANAM,Sabbavaram,Batajangalapalem,19,0,237,256,5,0,144,149,115,276,0,8435,8711,5675,2,0,28,30
11214,VISAKHAPATANAM,Sabbavaram,Boduvalasa,34,0,262,296,24,0,160,184,162,1202,0,8886,10088,6930,2,0,11,13
11215,VISAKHAPATANAM,Sabbavaram,Elluppi,38,0,289,327,33,0,188,221,200,2404,0,14888,17292,13950,14,0,70,84
11216,VISAKHAPATANAM,Sabbavaram,Gali bhimavaram,13,0,190,203,6,0,76,82,70,300,0,3992,4292,3322,1,0,14,15
11217,VISAKHAPATANAM,Sabbavaram,Gollalapalem,66,0,234,300,22,0,81,103,98,1964,0,6545,8509,6677,13,0,38,51
11218,VISAKHAPATANAM,Sabbavaram,Gotivada,4,1,325,330,2,1,178,181,166,20,67,9641,9728,7926,0,0,19,19
11219,VISAKHAPATANAM,Sabbavaram,Gullepalle,47,2,533,582,22,0,359,381,347,1762,0,24673,26435,20248,7,0,77,84
11220,VISAKHAPATANAM,Sabbavaram,Iruvada,23,0,322,345,5,0,152,157,124,129,0,8363,8492,5438,0,0,13,13
11221,VISAKHAPATANAM,Sabbavaram,Mallunaidupalem,99,1,717,817,38,0,294,332,311,1466,0,12780,14246,12865,0,0,2,2
11222,VISAKHAPATANAM,Sabbavaram,Mogalipuram,18,2,518,538,17,1,401,419,394,754,2,14211,14967,12680,0,0,0,0
11223,VISAKHAPATANAM,Sabbavaram,Nallaregulapalem,9,0,212,221,6,0,140,146,126,333,0,10394,10727,6413,1,0,51,52
11224,VISAKHAPATANAM,Sabbavaram,Narapadu,27,1,663,691,10,0,319,329,308,407,0,16793,17200,11083,0,0,34,34
11225,VISAKHAPATANAM,Sabbavaram,Pydivada Agraharam,14,0,401,415,3,0,114,117,104,15,0,4916,4931,3418,0,0,11,11
11226,VISAKHAPATANAM,Sabbavaram,Rayapura Agraharam,13,0,317,330,10,0,275,285,257,563,0,23763,24326,16777,1,0,121,122
11227,VISAKHAPATANAM,Sabbavaram,Sabbavaram,62,1,1105,1168,2,0,512,514,451,30,0,27072,27102,20441,0,0,41,41
11228,VISAKHAPATANAM,Sabbavaram,Tavvavanipalem,5,0,412,417,3,0,220,223,175,169,0,14903,15072,9685,0,0,29,29
11229,VISAKHAPATANAM,Sabbavaram,Tekkalipalem,10,0,364,374,8,0,237,245,205,732,0,19247,19979,12607,4,0,98,102
11230,VISAKHAPATANAM,Sabbavaram,Vangali,12,0,484,496,5,0,351,356,301,394,0,31100,31494,20607,2,0,165,167
11231,VISAKHAPATANAM,Yelamanchili,Bayyavaram,25,41,420,486,14,3,235,252,249,1248,154,14155,15557,12381,7,1,41,49
11232,VISAKHAPATANAM,Yelamanchili,Eti koppaka,107,12,1027,1146,11,6,720,737,731,239,246,28005,28490,17248,0,0,16,16
11233,VISAKHAPATANAM,Yelamanchili,GUNDRUBILLI,0,0,138,138,0,0,119,119,119,0,0,3641,3641,2873,0,0,0,0
11234,VISAKHAPATANAM,Yelamanchili,Jampapalem,34,0,319,353,25,0,238,263,230,1952,0,14100,16052,10299,7,0,43,50
11235,VISAKHAPATANAM,Yelamanchili,Kattupalem,29,0,223,252,24,0,151,175,154,1443,0,9443,10886,6894,5,0,27,32
11236,VISAKHAPATANAM,Yelamanchili,Kokkirapalli,66,0,722,788,34,0,478,512,477,1136,0,13086,14222,10871,0,0,2,2
11237,VISAKHAPATANAM,Yelamanchili,Kothali,35,0,280,315,27,0,227,254,231,1461,0,14339,15800,10944,2,0,30,32
11238,VISAKHAPATANAM,Yelamanchili,KRISHNAPURAM,15,6,323,344,13,6,300,319,298,955,540,27040,28535,19125,6,4,174,184
11239,VISAKHAPATANAM,Yelamanchili,Lakkavaram,0,0,147,147,0,0,95,95,94,0,0,7039,7039,5259,0,0,21,21
11240,VISAKHAPATANAM,Yelamanchili,Line Kothuru,20,0,260,280,14,0,198,212,172,303,0,12546,12849,10130,0,0,31,31
11241,VISAKHAPATANAM,Yelamanchili,Padmanabharaju peta,40,1,279,320,32,0,214,246,246,1098,0,9172,10270,7716,1,0,13,14
11242,VISAKHAPATANAM,Yelamanchili,Pedda Palli,41,0,505,546,20,0,296,316,283,575,0,6626,7201,5242,0,0,0,0
11243,VISAKHAPATANAM,Yelamanchili,Pothu Reddi palem,19,2,199,220,16,1,147,164,130,1137,106,9995,11238,6977,3,1,15,19
11244,VISAKHAPATANAM,Yelamanchili,Pulaparthi,54,1,342,397,34,0,258,292,271,1837,0,17856,19693,12673,2,0,50,52
11245,VISAKHAPATANAM,Yelamanchili,Purusotha puram,29,0,144,173,24,0,102,126,116,1580,0,7123,8703,6003,5,0,19,24
11246,VISAKHAPATANAM,Yelamanchili,RAMARAIDUPALEM,21,0,174,195,17,0,137,154,137,1217,0,9053,10270,6610,2,0,29,31
11247,VISAKHAPATANAM,Yelamanchili,Regupalem,35,0,317,352,24,0,206,230,186,1804,0,14815,16619,11835,7,0,43,50
11248,VISAKHAPATANAM,Yelamanchili,RUKMINIPURAM,11,0,218,229,11,0,189,200,148,480,0,9997,10477,6493,0,0,15,15
11249,VISAKHAPATANAM,Yelamanchili,Sakulla palem,6,0,223,229,5,0,204,209,190,264,0,9485,9749,7408,1,0,11,12
11250,VISAKHAPATANAM,Yelamanchili,Somilingapalem,41,0,397,438,39,0,321,360,324,2803,0,20919,23722,15034,8,0,69,77
11251,VISAKHAPATANAM,Yelamanchili,Teruvupalli,34,0,360,394,12,0,294,306,279,303,0,13083,13386,9613,0,0,6,6
11252,VISAKHAPATANAM,Yelamanchili,Thurangalapalem,20,0,205,225,12,0,165,177,169,1157,0,12003,13160,8970,9,0,41,50
11253,VISAKHAPATANAM,Yelamanchili,Yellamanchili,65,1,870,936,6,0,383,389,343,240,0,19539,19779,14604,0,0,31,31
11254,VISAKHAPATANAM,Yelamanchili,Yerravaram,0,0,369,369,0,0,280,280,269,0,0,20337,20337,18334,0,0,17,17
11255,VIZIANAGARAM,Badangi,AKULAKATTA,44,70,282,396,39,56,183,278,269,3246,4996,15617,23859,14461,21,32,100,153
11256,VIZIANAGARAM,Badangi,ANAVARAM,77,6,353,436,62,5,259,326,336,6167,368,25315,31850,16858,41,3,171,215
11257,VIZIANAGARAM,Badangi,BADANGI,169,27,742,938,134,21,504,659,621,12460,2277,48624,63361,36603,93,17,322,432
11258,VIZIANAGARAM,Badangi,BHEEMAVARAM,81,17,390,488,55,13,267,335,308,4525,830,14443,19798,10957,22,1,33,56
11259,VIZIANAGARAM,Badangi,BOTSHAVANIVALASA,327,63,340,730,254,57,240,551,518,18072,4280,19860,42212,22338,64,16,99,179
11260,VIZIANAGARAM,Badangi,DONKINIVALASA,31,0,249,280,24,0,161,185,164,1841,0,13277,15118,8978,8,0,56,64
11261,VIZIANAGARAM,Badangi,GAJARAYUNIVALASA,36,0,483,519,24,0,268,292,273,686,0,13924,14610,9298,0,0,24,24
11262,VIZIANAGARAM,Badangi,GOLLADI,1,3,129,133,0,1,88,89,84,0,101,9208,9309,5194,0,1,66,67
11263,VIZIANAGARAM,Badangi,GUDEPUVALASA,28,1,505,534,21,0,367,388,424,1604,0,31410,33014,17886,8,0,166,174
11264,VIZIANAGARAM,Badangi,K. GOLLADI,79,46,748,873,52,35,543,630,636,4379,2505,40504,47388,28091,22,11,152,185
11265,VIZIANAGARAM,Badangi,KODURU,286,37,1220,1543,147,29,555,731,695,11305,1989,36615,49909,30139,55,5,123,183
11266,VIZIANAGARAM,Badangi,KOTIPALLI,91,4,440,535,67,2,254,323,334,6159,212,18453,24824,15818,38,2,75,115
11267,VIZIANAGARAM,Badangi,LAKSHMIPURAM,32,71,189,292,18,48,105,171,148,1090,2304,8439,11833,6003,3,5,31,39
11268,VIZIANAGARAM,Badangi,MALLAMPETA,46,0,197,243,35,0,161,196,186,3192,0,10844,14036,7627,21,0,32,53
11269,VIZIANAGARAM,Badangi,MUGADA,184,6,876,1066,98,4,375,477,409,7016,368,23101,30485,18347,20,2,66,88
11270,VIZIANAGARAM,Badangi,PALTERU,2,0,547,549,0,0,397,397,377,0,0,19139,19139,12084,0,0,33,33
11271,VIZIANAGARAM,Badangi,PEDDAPALLI,29,0,347,376,17,0,177,194,173,1550,0,11706,13256,7151,9,0,38,47
11272,VIZIANAGARAM,Badangi,PINAPENKI,97,17,369,483,66,14,264,344,325,4798,1340,12074,18212,9786,14,7,3,24
11273,VIZIANAGARAM,Badangi,PINDRANGIVALASA,37,31,438,506,2,13,174,189,174,226,1210,15375,16811,8718,2,4,83,89
11274,VIZIANAGARAM,Badangi,PINNAVALASA,35,0,283,318,30,0,194,224,209,2832,0,13753,16585,9250,18,0,52,70
11275,VIZIANAGARAM,Badangi,PUDIVALASA,29,0,146,175,24,0,120,144,152,2504,0,12446,14950,8634,20,0,93,113
11276,VIZIANAGARAM,Badangi,REJERU,54,11,577,642,41,11,386,438,388,1467,507,14366,16340,8813,0,0,0,0
11277,VIZIANAGARAM,Badangi,TENTUVALASA,30,13,210,253,18,8,131,157,153,1595,370,12118,14083,8212,9,0,68,77
11278,VIZIANAGARAM,Badangi,VADADA,192,28,774,994,106,22,454,582,573,9582,1750,35290,46622,23493,57,9,159,225
11279,VIZIANAGARAM,Badangi,VEERASAGARAM,36,22,400,458,19,12,227,258,257,1696,442,19020,21158,12303,8,1,102,111
11280,VIZIANAGARAM,Badangi,VENKAMPETA.P,0,36,372,408,0,31,273,304,306,0,2962,20795,23757,13719,0,17,89,106
11281,VIZIANAGARAM,Balajipeta,AJJADA,122,8,936,1066,98,7,649,754,854,5746,600,39815,46161,25610,7,3,81,91
11282,VIZIANAGARAM,Balajipeta,AMPAVILLI,135,19,518,672,100,10,338,448,446,8026,692,25644,34362,20473,34,2,108,144
11283,VIZIANAGARAM,Balajipeta,ARASADA,114,12,786,912,82,9,521,612,611,7448,555,28334,36337,20559,49,0,25,74
11284,VIZIANAGARAM,Balajipeta,BALIJIPETA,124,1,815,940,85,0,343,428,466,4196,0,10557,14753,9048,4,0,1,5
11285,VIZIANAGARAM,Balajipeta,BARLI,108,5,593,706,82,3,419,504,477,6318,207,20451,26976,15170,21,0,12,33
11286,VIZIANAGARAM,Balajipeta,CHAKARAPALLI,68,47,221,336,55,36,148,239,269,4848,3475,11499,19822,10763,30,25,28,83
11287,VIZIANAGARAM,Balajipeta,CHILAKALAPALLI,175,30,888,1093,103,28,436,567,548,6923,1939,22119,30981,19752,21,5,12,38
11288,VIZIANAGARAM,Balajipeta,GALAVILLI,102,7,1367,1476,61,0,699,760,749,4556,0,31613,36169,21090,23,0,16,39
11289,VIZIANAGARAM,Balajipeta,GANGADA,146,14,746,906,91,7,482,580,549,5868,310,37235,43413,27344,16,0,148,164
11290,VIZIANAGARAM,Balajipeta,MIRTHIVALASA,37,0,546,583,26,0,413,439,450,2109,0,40010,42119,22348,10,0,220,230
11291,VIZIANAGARAM,Balajipeta,NARAMNAIDUVALASA,73,6,354,433,56,3,283,342,372,3015,253,19387,22655,11758,6,0,44,50
11292,VIZIANAGARAM,Balajipeta,NARAYANAPURAM,148,59,1035,1242,1,52,579,632,689,13,2097,15144,17254,9707,0,0,0,0
11293,VIZIANAGARAM,Balajipeta,NUKALAVADA,49,0,512,561,34,0,298,332,363,1398,0,9712,11110,6767,0,0,0,0
11294,VIZIANAGARAM,Balajipeta,PADAMAYAVALASA,88,5,164,257,72,2,109,183,184,5543,91,8315,13949,7337,30,0,19,49
11295,VIZIANAGARAM,Balajipeta,PALAGARA,141,30,656,827,103,24,413,540,593,7443,1976,21164,30583,17863,30,7,12,49
11296,VIZIANAGARAM,Balajipeta,PANUKUVALASA,68,6,313,387,57,4,243,304,325,4310,361,18212,22883,12933,3,1,40,44
11297,VIZIANAGARAM,Balajipeta,PEDAPENKI,408,41,1283,1732,189,25,673,887,838,9613,905,33257,43775,23031,19,0,27,46
11298,VIZIANAGARAM,Balajipeta,PEDDIMPETA,48,37,640,725,31,30,461,522,532,2150,1380,25570,29100,15495,1,2,23,26
11299,VIZIANAGARAM,Balajipeta,SIVARAMPURAM,16,14,291,321,9,11,235,255,246,721,915,18631,20267,10957,5,5,104,114
11300,VIZIANAGARAM,Balajipeta,SUBHADRA,15,4,486,505,8,4,359,371,344,556,359,24411,25326,13947,3,2,45,50
11301,VIZIANAGARAM,Balajipeta,TUMARADA,167,0,673,840,119,0,387,506,531,9131,0,25410,34541,20703,27,0,58,85
11302,VIZIANAGARAM,Balajipeta,VANTHARAM,113,10,483,606,57,10,381,448,454,2222,332,13437,15991,8578,0,0,0,0
11303,VIZIANAGARAM,Balajipeta,VENGALARAYAPURAM,49,7,323,379,32,4,209,245,220,235,22,754,1011,548,0,0,0,0
11304,VIZIANAGARAM,Balajipeta,VENGAPURAM,122,44,552,718,92,30,318,440,461,9173,2872,25888,37933,22609,59,19,129,207
11305,VIZIANAGARAM,Bhoghapuram,A RAVIVALASA,12,0,493,505,10,0,364,374,363,980,0,34043,35023,25260,6,0,203,209
11306,VIZIANAGARAM,Bhoghapuram,BHOGAPURAM,177,0,871,1048,132,0,475,607,537,9896,0,30019,39915,27742,29,0,87,116
11307,VIZIANAGARAM,Bhoghapuram,BYREDDIPALEM,2,0,383,385,1,0,320,321,350,62,0,17269,17331,12157,0,0,17,17
11308,VIZIANAGARAM,Bhoghapuram,CHAKI VALASA,9,0,344,353,7,0,242,249,294,295,0,16795,17090,11459,0,0,50,50
11309,VIZIANAGARAM,Bhoghapuram,CHEPALAKANCHERU,8,0,648,656,2,0,347,349,275,31,0,8300,8331,6330,0,0,0,0
11310,VIZIANAGARAM,Bhoghapuram,CHERUKU PALLI,90,0,364,454,54,0,233,287,239,3507,0,15290,18797,11467,10,0,49,59
11311,VIZIANAGARAM,Bhoghapuram,DALLIPETA,0,0,282,282,0,0,242,242,255,0,0,21752,21752,17100,0,0,125,125
11312,VIZIANAGARAM,Bhoghapuram,GUDEPU VALASA,110,0,203,313,51,0,132,183,161,4558,0,12366,16924,12909,34,0,93,127
11313,VIZIANAGARAM,Bhoghapuram,GUDI VADA,49,4,878,931,37,3,490,530,375,1833,165,19856,21854,12798,2,1,7,10
11314,VIZIANAGARAM,Bhoghapuram,KAVULAVADA,6,0,643,649,0,0,496,496,540,0,0,47493,47493,33979,0,0,295,295
11315,VIZIANAGARAM,Bhoghapuram,KONDRAJUPALEM,1,0,272,273,0,0,188,188,198,0,0,11223,11223,10790,0,0,13,13
11316,VIZIANAGARAM,Bhoghapuram,LINGALAVALASA,17,0,393,410,9,0,210,219,187,356,0,8503,8859,7245,0,0,0,0
11317,VIZIANAGARAM,Bhoghapuram,MUKKAM,2,0,391,393,1,0,280,281,296,58,0,19401,19459,18185,0,0,94,94
11318,VIZIANAGARAM,Bhoghapuram,MUNJERU,129,0,875,1004,81,0,605,686,627,5316,0,53688,59004,48190,29,0,323,352
11319,VIZIANAGARAM,Bhoghapuram,NANDIGAM,64,0,320,384,49,0,228,277,259,4078,0,21622,25700,19764,24,0,145,169
11320,VIZIANAGARAM,Bhoghapuram,POLIPALLI,25,0,850,875,17,0,572,589,417,1379,0,48023,49402,29811,7,0,195,202
11321,VIZIANAGARAM,Bhoghapuram,RAJAPULOVA,11,0,271,282,0,0,0,0,0,0,0,0,0,0,0,0,0,0
11322,VIZIANAGARAM,Bhoghapuram,RAMACHANDRAPETA,24,1,561,586,16,1,360,377,392,684,33,15837,16554,15243,0,0,2,2
11323,VIZIANAGARAM,Bhoghapuram,RAVADA,61,6,785,852,49,4,405,458,422,4124,414,32228,36766,30691,21,3,134,158
11324,VIZIANAGARAM,Bhoghapuram,REDDIKANCHERU,58,3,544,605,44,3,433,480,441,3472,190,33434,37096,29423,24,0,146,170
11325,VIZIANAGARAM,Bhoghapuram,SAVARAVILLI,18,0,712,730,10,0,406,416,368,52,0,3174,3226,2281,0,0,0,0
11326,VIZIANAGARAM,Bhoghapuram,TUDEM,0,0,356,356,0,0,296,296,299,0,0,14017,14017,11914,0,0,17,17
11327,VIZIANAGARAM,Bobbili,ALAJANGI,381,3,1245,1629,293,2,743,1038,1113,11432,33,29139,40604,23602,6,0,9,15
11328,VIZIANAGARAM,Bobbili,C.H.BODDAVALASA,60,221,259,540,45,83,216,344,377,2025,6043,11845,19913,11552,0,25,13,38
11329,VIZIANAGARAM,Bobbili,CHINTADA,131,1,960,1092,104,1,671,776,802,6827,57,37235,44119,23732,20,0,39,59
11330,VIZIANAGARAM,Bobbili,DIBBAGUDDIVALASA,46,74,398,518,39,61,330,430,443,2802,4701,27778,35281,22262,8,12,125,145
11331,VIZIANAGARAM,Bobbili,GONGADAVALASA,20,15,305,340,17,15,276,308,329,1295,1275,23430,26000,14347,6,7,148,161
11332,VIZIANAGARAM,Bobbili,GOPALARAYUDUPETA,153,86,647,886,127,43,504,674,632,7814,2137,37830,47781,26383,20,1,111,132
11333,VIZIANAGARAM,Bobbili,GORLESEETHARAMPURAM,53,42,198,293,51,36,180,267,272,4263,2379,13013,19655,10723,31,2,35,68
11334,VIZIANAGARAM,Bobbili,J.RANGARAYAPURAM,0,1,230,231,0,1,209,210,250,0,63,15693,15756,9744,0,0,74,74
11335,VIZIANAGARAM,Bobbili,JAGANNADHAPURAM,103,2,226,331,91,1,193,285,335,7814,61,14002,21877,13360,41,0,46,87
11336,VIZIANAGARAM,Bobbili,KALAVRAI,60,10,487,557,52,6,349,407,443,3225,454,21788,25467,15039,10,2,57,69
11337,VIZIANAGARAM,Bobbili,KAMMAVALASA,73,0,379,452,60,0,329,389,377,4276,0,22617,26893,15277,2,0,10,12
11338,VIZIANAGARAM,Bobbili,KARADA,134,97,547,778,96,58,300,454,460,5232,2388,9584,17204,11346,1,0,0,1
11339,VIZIANAGARAM,Bobbili,KASIDORAVALASA,9,178,116,303,9,152,96,257,255,357,4161,4996,9514,6330,0,1,3,4
11340,VIZIANAGARAM,Bobbili,KINTHALAVANIPETA,62,1,296,359,54,1,254,309,332,4527,111,21941,26579,15928,23,1,116,140
11341,VIZIANAGARAM,Bobbili,KOMATIPALLI,126,1,749,876,90,1,538,629,641,3215,29,15484,18728,12108,0,0,0,0
11342,VIZIANAGARAM,Bobbili,KONDADEVUPALLE,31,2,415,448,15,0,290,305,312,750,0,20975,21725,12453,1,0,82,83
11343,VIZIANAGARAM,Bobbili,KOTHAPENTA,7,0,194,201,7,0,176,183,178,714,0,16806,17520,9867,5,0,106,111
11344,VIZIANAGARAM,Bobbili,KRISHNAPURAM,68,0,244,312,61,0,207,268,295,4811,0,13217,18028,10863,21,0,17,38
11345,VIZIANAGARAM,Bobbili,M.BURJAVALASA,61,46,672,779,46,41,539,626,709,3262,3136,34193,40591,23676,12,12,67,91
11346,VIZIANAGARAM,Bobbili,METTAVALASA,11,0,743,754,6,0,436,442,421,257,0,24221,24478,17410,0,0,49,49
11347,VIZIANAGARAM,Bobbili,NARAYANAPPAVALASA,4,2,223,229,1,2,192,195,188,90,68,13509,13667,8597,0,0,46,46
11348,VIZIANAGARAM,Bobbili,PAKKI,178,6,1188,1372,121,4,794,919,859,6402,312,28412,35126,19036,2,0,8,10
11349,VIZIANAGARAM,Bobbili,PARADHI,122,2,932,1056,60,1,493,554,531,3934,16,21802,25752,17309,8,0,23,31
11350,VIZIANAGARAM,Bobbili,PENTA,52,1,572,625,30,0,421,451,448,1591,0,31134,32725,19268,4,0,112,116
11351,VIZIANAGARAM,Bobbili,PIRIDI,204,4,968,1176,156,2,799,957,915,6701,59,33499,40259,22388,2,0,8,10
11352,VIZIANAGARAM,Bobbili,RAMUDUVALASA,56,0,165,221,46,0,152,198,222,3530,0,11456,14986,9130,16,0,59,75
11353,VIZIANAGARAM,Bobbili,RANGARAYAPURAM,123,15,359,497,83,12,277,372,423,4602,521,14959,20082,14086,7,0,20,27
11354,VIZIANAGARAM,Bobbili,SEETHAYYAPETA,32,0,110,142,26,0,89,115,114,1835,0,6581,8416,5296,7,0,21,28
11355,VIZIANAGARAM,Bobbili,SIVADAVALASA,58,0,406,464,44,0,308,352,368,3153,0,18099,21252,12839,16,0,37,53
11356,VIZIANAGARAM,Bobbili,VELAGAVALASA.A Pt,24,0,151,175,22,0,126,148,153,1147,0,7229,8376,5131,3,0,13,16
11357,VIZIANAGARAM,Bondapalle,AMBATIVALASA,86,6,907,999,68,4,609,681,695,5864,334,49183,55381,41547,36,2,216,254
11358,VIZIANAGARAM,Bondapalle,B.RAJERU,80,2,545,627,56,2,402,460,403,3843,154,22866,26863,14272,13,0,25,38
11359,VIZIANAGARAM,Bondapalle,BILLALAVALASA,45,0,451,496,36,0,350,386,378,3370,0,28368,31738,21362,24,0,130,154
11360,VIZIANAGARAM,Bondapalle,BONDAPALLI,353,3,1744,2100,253,1,1045,1299,1198,19939,73,65773,85785,55750,67,0,146,213
11361,VIZIANAGARAM,Bondapalle,CHINATAMARAPALLI,54,5,313,372,38,5,227,270,260,3247,449,19239,22935,13185,21,2,114,137
11362,VIZIANAGARAM,Bondapalle,DEVUPALLI,249,37,1201,1487,164,34,621,819,782,15914,3554,57899,77367,44450,93,25,310,428
11363,VIZIANAGARAM,Bondapalle,GARUDABILLI,53,0,689,742,47,0,489,536,493,3608,0,35693,39301,26584,14,0,130,144
11364,VIZIANAGARAM,Bondapalle,GITTUPALLI,61,0,372,433,49,0,248,297,278,4016,0,18484,22500,12709,19,0,74,93
11365,VIZIANAGARAM,Bondapalle,GOLLIPALEM,161,34,987,1182,119,8,591,718,681,10210,596,40976,51782,28963,52,0,100,152
11366,VIZIANAGARAM,Bondapalle,GOTLAM,126,1,1206,1333,105,1,829,935,984,8425,65,75455,83945,60740,39,0,405,444
11367,VIZIANAGARAM,Bondapalle,GRAHAPATHIAGRAHARAM,10,0,411,421,8,0,201,209,204,731,0,15588,16319,9567,5,0,80,85
11368,VIZIANAGARAM,Bondapalle,GUMADAM  J.,37,0,346,383,14,0,230,244,231,1151,0,18663,19814,12506,4,0,89,93
11369,VIZIANAGARAM,Bondapalle,K.AGRHARAM,33,0,414,447,25,0,189,214,182,1723,0,13512,15235,8908,6,0,50,56
11370,VIZIANAGARAM,Bondapalle,KANIMERAKA,163,0,733,896,112,0,339,451,423,8816,0,20324,29140,17958,39,0,49,88
11371,VIZIANAGARAM,Bondapalle,KERATAM,43,4,342,389,36,3,232,271,261,3385,268,21254,24907,18348,25,2,134,161
11372,VIZIANAGARAM,Bondapalle,KONDAKINDAM,20,36,296,352,15,29,207,251,255,1121,2389,16714,20224,13283,5,12,82,99
11373,VIZIANAGARAM,Bondapalle,KOTHAPALEM,21,43,374,438,18,36,262,316,269,1483,3342,23262,28087,15308,10,19,122,151
11374,VIZIANAGARAM,Bondapalle,M.KOTHAVALASA,29,0,638,667,19,0,445,464,435,1808,0,35785,37593,24456,11,0,154,165
11375,VIZIANAGARAM,Bondapalle,MARUVADA,80,0,252,332,60,0,126,186,170,5700,0,11326,17026,9505,28,0,62,90
11376,VIZIANAGARAM,Bondapalle,MUDDURU,48,0,556,604,39,0,406,445,431,2850,0,26835,29685,16962,7,0,35,42
11377,VIZIANAGARAM,Bondapalle,NELIVADA,92,0,551,643,48,0,280,328,296,3774,0,21993,25767,18080,22,0,99,121
11378,VIZIANAGARAM,Bondapalle,OMPALLI,15,2,554,571,7,1,401,409,462,391,118,33753,34262,20931,1,1,168,170
11379,VIZIANAGARAM,Bondapalle,RACHAKINDAM,65,6,505,576,46,5,326,377,351,4209,413,29755,34377,19263,27,3,177,207
11380,VIZIANAGARAM,Bondapalle,RAINDRAM,92,0,552,644,74,0,264,338,303,6388,0,22588,28976,17469,33,0,113,146
11381,VIZIANAGARAM,Bondapalle,VEDURUVEDA,16,237,224,477,8,158,127,293,281,514,11994,11078,23586,13502,1,53,61,115
11382,VIZIANAGARAM,Bondapalle,VENDRAM,24,1,333,358,16,0,279,295,316,1382,0,23034,24416,17136,8,0,107,115
11383,VIZIANAGARAM,Cheepurupalle,ALAJANGI,156,4,797,957,126,2,416,544,536,8220,66,28272,36558,20525,13,0,106,119
11384,VIZIANAGARAM,Cheepurupalle,CHEEPURAPALLI,264,32,3870,4166,80,12,1965,2057,2044,1380,234,36766,38380,24966,0,0,1,1
11385,VIZIANAGARAM,Cheepurupalle,DEVARAPODILAM,100,1,439,540,71,0,250,321,276,5827,0,20578,26405,15328,20,0,95,115
11386,VIZIANAGARAM,Cheepurupalle,GOLLALAMULAGAM,78,1,607,686,48,1,403,452,459,3981,25,31003,35009,23554,17,0,123,140
11387,VIZIANAGARAM,Cheepurupalle,GOLLALAPALAEM,28,1,279,308,25,0,177,202,200,2071,0,14326,16397,9991,10,0,89,99
11388,VIZIANAGARAM,Cheepurupalle,ITIKARLAPALLI,71,0,699,770,47,0,340,387,354,1017,0,6105,7122,4588,0,0,0,0
11389,VIZIANAGARAM,Cheepurupalle,KARAKAM,105,4,741,850,68,3,386,457,468,3371,95,12127,15593,10118,7,0,2,9
11390,VIZIANAGARAM,Cheepurupalle,KARLAM,74,7,1259,1340,61,4,719,784,709,4739,306,53494,58539,39377,15,2,139,156
11391,VIZIANAGARAM,Cheepurupalle,METAPALLI,103,7,1047,1157,57,4,542,603,562,1964,198,26967,29129,19630,0,0,13,13
11392,VIZIANAGARAM,Cheepurupalle,NIMMALAVALASA,133,30,503,666,72,23,217,312,283,2360,780,8830,11970,8090,1,0,4,5
11393,VIZIANAGARAM,Cheepurupalle,PADANADIPALLI,220,7,578,805,160,7,331,498,477,6206,170,9762,16138,9470,4,0,1,5
11394,VIZIANAGARAM,Cheepurupalle,PARLA,23,1,527,551,14,0,328,342,323,1037,0,22223,23260,15430,3,0,37,40
11395,VIZIANAGARAM,Cheepurupalle,PATHIKAYAVALASA,57,2,562,621,39,1,386,426,372,2780,14,17571,20365,11576,9,0,1,10
11396,VIZIANAGARAM,Cheepurupalle,PATTIKAYAPALAVALASA,55,1,1530,1586,48,0,1086,1134,1043,1658,0,46107,47765,24817,1,0,4,5
11397,VIZIANAGARAM,Cheepurupalle,PERIPI,35,6,673,714,23,3,411,437,439,911,57,16894,17862,10038,0,0,2,2
11398,VIZIANAGARAM,Cheepurupalle,RAMALINGAPURAM,58,35,898,991,42,31,606,679,679,2905,1690,37417,42012,26913,8,4,59,71
11399,VIZIANAGARAM,Cheepurupalle,RAVIVALASA,110,3,972,1085,70,2,667,739,767,4774,226,45372,50372,29820,17,2,148,167
11400,VIZIANAGARAM,Dattirajeru,BHUPALARAJAPURAM,19,1,426,446,9,1,255,265,270,386,43,19841,20270,11975,0,0,97,97
11401,VIZIANAGARAM,Dattirajeru,CHINACHAMALAPALLE,5,0,454,459,2,0,303,305,290,104,0,27490,27594,15917,0,0,150,150
11402,VIZIANAGARAM,Dattirajeru,CHINAKADA,76,1,448,525,63,1,299,363,341,5872,102,20920,26894,15651,37,1,72,110
11403,VIZIANAGARAM,Dattirajeru,CHOWDANTHIVALASA,117,12,370,499,80,4,232,316,294,7154,406,19592,27152,15947,48,3,102,153
11404,VIZIANAGARAM,Dattirajeru,CHUKKAPETA,33,2,274,309,25,1,195,221,222,1709,24,14318,16051,8690,5,0,74,79
11405,VIZIANAGARAM,Dattirajeru,DASUPETA,5,1,249,255,3,0,188,191,192,322,0,17876,18198,10145,2,0,124,126
11406,VIZIANAGARAM,Dattirajeru,DATTIRAJERU,110,0,319,429,87,0,215,302,285,7528,0,17092,24620,14546,40,0,78,118
11407,VIZIANAGARAM,Dattirajeru,DATTOI,57,13,896,966,34,9,539,582,617,2135,451,30808,33394,20048,4,1,63,68
11408,VIZIANAGARAM,Dattirajeru,GADASAM,73,1,748,822,52,0,550,602,588,4083,0,43345,47428,26100,20,0,183,203
11409,VIZIANAGARAM,Dattirajeru,GOBHYAM,58,4,480,542,46,3,316,365,361,4034,177,26149,30360,16411,27,1,151,179
11410,VIZIANAGARAM,Dattirajeru,GUTCHIMI,85,5,276,366,68,4,205,277,259,6322,350,16975,23647,12801,43,2,99,144
11411,VIZIANAGARAM,Dattirajeru,INGILAPALLI,65,102,618,785,49,59,338,446,474,3709,3128,25999,32836,19845,12,12,127,151
11412,VIZIANAGARAM,Dattirajeru,K.KOTHAVALASA,37,0,566,603,23,0,370,393,406,1657,0,25043,26700,16755,2,0,84,86
11413,VIZIANAGARAM,Dattirajeru,KANNAM,39,0,214,253,31,0,151,182,189,2988,0,13717,16705,10711,19,0,76,95
11414,VIZIANAGARAM,Dattirajeru,KOMATIPALLI,107,4,214,325,92,2,167,261,240,8169,180,14323,22672,14763,44,1,70,115
11415,VIZIANAGARAM,Dattirajeru,KORAPAKRISHNAPURAM,51,0,436,487,38,0,334,372,416,4037,0,31077,35114,21784,29,0,182,211
11416,VIZIANAGARAM,Dattirajeru,M.LINGALAVALASA,27,2,423,452,19,1,372,392,405,1299,72,34777,36148,19569,6,0,203,209
11417,VIZIANAGARAM,Dattirajeru,MARADAM,178,1,689,868,133,1,403,537,483,11814,71,29498,41383,24458,69,0,127,196
11418,VIZIANAGARAM,Dattirajeru,P.LINGALAVALASA,85,1,497,583,56,0,276,332,309,4354,0,15956,20310,12129,23,0,38,61
11419,VIZIANAGARAM,Dattirajeru,PACHALAVALASA,21,0,495,516,18,0,367,385,415,1176,0,25908,27084,15513,3,0,99,102
11420,VIZIANAGARAM,Dattirajeru,PEDAKOADA,122,0,740,862,77,0,367,444,433,4184,0,18539,22723,12198,20,0,28,48
11421,VIZIANAGARAM,Dattirajeru,PEDAMANAPURAM,250,6,760,1016,185,4,449,638,597,15481,281,31152,46914,27692,80,0,98,178
11422,VIZIANAGARAM,Dattirajeru,PORALI,15,6,427,448,12,6,324,342,366,1053,671,33733,35457,20843,5,5,217,227
11423,VIZIANAGARAM,Dattirajeru,RAMACHANDRAPURAM,53,4,505,562,22,0,289,311,253,1533,0,21333,22866,13724,8,0,73,81
11424,VIZIANAGARAM,Dattirajeru,S.BURJAVALASA,16,14,135,165,12,11,110,133,138,487,807,10010,11304,6900,1,4,58,63
11425,VIZIANAGARAM,Dattirajeru,S.CHINTHALAVALASA,54,0,510,564,37,0,281,318,300,2960,0,22898,25858,14730,11,0,124,135
11426,VIZIANAGARAM,Dattirajeru,SARAYYAVALASA,12,15,349,376,5,10,213,228,215,359,729,20758,21846,13082,1,1,126,128
11427,VIZIANAGARAM,Dattirajeru,SHIKARUGANJI,46,16,450,512,31,12,283,326,304,2021,742,19147,21910,12730,10,4,57,71
11428,VIZIANAGARAM,Dattirajeru,T.BURJAVALASA,55,17,677,749,40,12,475,527,467,2791,794,33251,36836,20405,10,3,143,156
11429,VIZIANAGARAM,Dattirajeru,TADANDORAVALASA,27,15,214,256,17,12,162,191,181,1371,940,11775,14086,8296,7,4,50,61
11430,VIZIANAGARAM,Dattirajeru,V.KRISHNAPURAM,62,0,323,385,38,0,132,170,163,3083,0,10336,13419,8461,12,0,51,63
11431,VIZIANAGARAM,Dattirajeru,VANGARA,89,4,552,645,65,2,392,459,406,5571,139,28381,34091,18338,29,1,117,147
11432,VIZIANAGARAM,Dattirajeru,VINDHYAVASI,51,6,126,183,37,2,80,119,113,3861,182,7517,11560,7054,30,1,50,81
11433,VIZIANAGARAM,Dattirajeru,VIZIARAMPURAM,47,4,186,237,36,2,115,153,144,2025,83,7798,9906,6318,4,0,21,25
11434,VIZIANAGARAM,Dattirajeru,VIZIARAMPURAM(DASARIPETA),12,2,163,177,6,0,105,111,106,386,0,8833,9219,5784,1,0,39,40
11435,VIZIANAGARAM,Denkada,AKKIVARAM,9,0,1191,1200,1,0,620,621,651,20,0,35552,35572,23932,0,0,76,76
11436,VIZIANAGARAM,Denkada,AKULAPETA,18,1,157,176,15,0,127,142,123,1170,0,8603,9773,5866,4,0,17,21
11437,VIZIANAGARAM,Denkada,AMAKAM,28,0,619,647,18,0,371,389,353,1165,0,25051,26216,22410,2,0,37,39
11438,VIZIANAGARAM,Denkada,BANGARARAJU PETA,0,0,103,103,0,0,69,69,64,0,0,6154,6154,4821,0,0,22,22
11439,VIZIANAGARAM,Denkada,BANTUPALLI,66,1,505,572,51,1,249,301,244,1946,69,8213,10228,5661,1,0,1,2
11440,VIZIANAGARAM,Denkada,BODDAVALASA,45,0,538,583,26,0,326,352,263,947,0,9474,10421,7594,0,0,0,0
11441,VIZIANAGARAM,Denkada,CHINTALAVALASA,17,0,755,772,12,0,499,511,505,796,0,25355,26151,24797,1,0,7,8
11442,VIZIANAGARAM,Denkada,CHOLANGIPETA,149,2,413,564,68,0,203,271,249,4622,0,6334,10956,6698,17,0,1,18
11443,VIZIANAGARAM,Denkada,D.KOLLAM,12,0,231,243,8,0,148,156,159,579,0,7877,8456,6521,2,0,16,18
11444,VIZIANAGARAM,Denkada,D.TALLAVALASA,7,1,616,624,6,0,292,298,248,506,0,19119,19625,12222,3,0,46,49
11445,VIZIANAGARAM,Denkada,DENKADA,276,2,706,984,158,1,351,510,429,11053,41,18921,30015,19323,31,0,15,46
11446,VIZIANAGARAM,Denkada,GANTALAM,56,0,248,304,41,0,75,116,101,3265,0,5826,9091,6719,13,0,24,37
11447,VIZIANAGARAM,Denkada,GOLAGAM,23,0,195,218,17,0,147,164,146,1300,0,9548,10848,8154,4,0,19,23
11448,VIZIANAGARAM,Denkada,GUNUPUR,113,0,254,367,71,0,113,184,173,4577,0,7974,12551,10395,11,0,14,25
11449,VIZIANAGARAM,Denkada,GUNUPURUPETA,3,0,510,513,1,0,298,299,280,50,0,21363,21413,16863,0,0,45,45
11450,VIZIANAGARAM,Denkada,JONNADA,11,0,951,962,2,0,242,244,215,87,0,9630,9717,7588,0,0,5,5
11451,VIZIANAGARAM,Denkada,KONDARAJU PETA,0,0,248,248,0,0,139,139,111,0,0,9858,9858,7123,0,0,44,44
11452,VIZIANAGARAM,Denkada,MODAVALASA,19,0,314,333,8,0,141,149,128,402,0,8534,8936,7014,1,0,29,30
11453,VIZIANAGARAM,Denkada,MOPADA,32,0,405,437,21,0,272,293,256,1450,0,19065,20515,14558,3,0,53,56
11454,VIZIANAGARAM,Denkada,NATHAVALASA,3,18,323,344,0,11,190,201,187,0,526,10731,11257,9621,0,0,6,6
11455,VIZIANAGARAM,Denkada,PEDADA,96,0,170,266,60,0,105,165,139,4193,0,7785,11978,8777,15,0,20,35
11456,VIZIANAGARAM,Denkada,PEDDATADIVADA,118,2,1073,1193,67,2,502,571,501,5266,126,36482,41874,34402,20,0,67,87
11457,VIZIANAGARAM,Denkada,PINATADIVEDA,40,1,519,560,28,0,410,438,416,2146,0,27197,29343,23204,8,0,51,59
11458,VIZIANAGARAM,Denkada,RAGUMANDA,69,0,263,332,52,0,120,172,154,3556,0,7692,11248,8984,5,0,5,10
11459,VIZIANAGARAM,Denkada,SINGAVARAM,43,1,322,366,27,1,257,285,275,1606,52,19002,20660,17553,1,0,58,59
11460,VIZIANAGARAM,Denkada,VEDULLAVALASA,46,0,448,494,31,0,260,291,271,2002,0,14317,16319,11098,4,0,21,25
11461,VIZIANAGARAM,Gajapathinagaram,BANGARAMMAPETA,30,1,303,334,22,0,172,194,171,1128,0,8733,9861,6105,4,0,22,26
11462,VIZIANAGARAM,Gajapathinagaram,BHUDEVIPETA,13,0,170,183,9,0,104,113,127,677,0,5806,6483,3952,2,0,2,4
11463,VIZIANAGARAM,Gajapathinagaram,DAVALAPETA,12,0,309,321,11,0,240,251,288,898,0,16072,16970,10458,4,0,44,48
11464,VIZIANAGARAM,Gajapathinagaram,GAJAPATHINAGARAM,182,1,785,968,98,1,491,590,541,5814,55,26663,32532,23986,9,0,26,35
11465,VIZIANAGARAM,Gajapathinagaram,GANGACHOLAPENTA,143,2,648,793,114,2,525,641,702,8379,118,33508,42005,24780,22,0,79,101
11466,VIZIANAGARAM,Gajapathinagaram,GUDIVADA,40,2,116,158,37,1,92,130,118,2802,69,6483,9354,5372,12,0,25,37
11467,VIZIANAGARAM,Gajapathinagaram,KALAMRAJUPETA,33,0,494,527,26,0,426,452,523,1772,0,26786,28558,16858,4,0,55,59
11468,VIZIANAGARAM,Gajapathinagaram,KENGUVA,134,0,711,845,83,0,366,449,457,6821,0,25569,32390,20033,36,0,94,130
11469,VIZIANAGARAM,Gajapathinagaram,KONISA,58,3,373,434,47,2,241,290,246,2804,121,15437,18362,10828,10,0,43,53
11470,VIZIANAGARAM,Gajapathinagaram,KOTHABAGGAM,72,5,601,678,53,4,367,424,412,3497,118,24668,28283,17771,10,0,62,72
11471,VIZIANAGARAM,Gajapathinagaram,LINGALAVALASA,2,0,446,448,2,0,356,358,363,62,0,15735,15797,8392,0,0,1,1
11472,VIZIANAGARAM,Gajapathinagaram,LOGISA,27,2,523,552,22,2,412,436,429,1546,140,28231,29917,16367,4,0,23,27
11473,VIZIANAGARAM,Gajapathinagaram,M.GUMADAM,67,1,510,578,57,0,337,394,390,3523,0,26592,30115,16776,6,0,107,113
11474,VIZIANAGARAM,Gajapathinagaram,M.KOTHAVALASA,23,0,371,394,20,0,276,296,311,994,0,21301,22295,12575,2,0,86,88
11475,VIZIANAGARAM,Gajapathinagaram,MADHUPADA,59,0,552,611,42,0,305,347,371,3000,0,20777,23777,15773,8,0,66,74
11476,VIZIANAGARAM,Gajapathinagaram,MARRIVALASA,5,52,128,185,1,32,93,126,106,58,2852,5515,8425,4115,0,15,7,22
11477,VIZIANAGARAM,Gajapathinagaram,MARUPALLI,47,52,1154,1253,6,14,688,708,728,279,780,45845,46904,26741,0,1,90,91
11478,VIZIANAGARAM,Gajapathinagaram,MUTCHERLA,76,2,601,679,57,0,389,446,447,4589,0,32262,36851,20270,15,0,161,176
11479,VIZIANAGARAM,Gajapathinagaram,PATHABAGGAM,61,41,504,606,36,0,339,375,364,1663,0,16213,17876,9798,2,0,5,7
11480,VIZIANAGARAM,Gajapathinagaram,PIDISEELA,18,0,261,279,17,0,192,209,194,1353,0,13997,15350,9444,6,0,49,55
11481,VIZIANAGARAM,Gajapathinagaram,PURITIPENTA,104,13,902,1019,42,0,408,450,430,2037,0,20863,22900,15582,4,0,30,34
11482,VIZIANAGARAM,Gajapathinagaram,RAMANNAPETA,82,2,293,377,60,1,231,292,321,4999,39,19543,24581,13444,29,0,103,132
11483,VIZIANAGARAM,Gajapathinagaram,SALIPETA,7,1,246,254,5,0,157,162,156,370,0,11065,11435,6165,0,0,5,5
11484,VIZIANAGARAM,Gajapathinagaram,SEETHARAMPURAM,31,0,339,370,20,0,284,304,286,1551,0,23688,25239,13261,6,0,117,123
11485,VIZIANAGARAM,Gajapathinagaram,SRIRANGARAJAPURAM,15,2,563,580,11,1,431,443,482,921,106,40121,41148,22611,6,1,242,249
11486,VIZIANAGARAM,Gajapathinagaram,THUMMIKAPALLI,35,0,525,560,21,0,269,290,261,1290,0,17237,18527,10629,5,0,41,46
11487,VIZIANAGARAM,Gajapathinagaram,VEMALI,23,1,424,448,14,1,280,295,303,886,34,21742,22662,12476,0,0,91,91
11488,VIZIANAGARAM,Gajapathinagaram,ZINNAM,96,19,641,756,76,9,416,501,456,4230,460,26583,31273,17490,2,0,20,22
11489,VIZIANAGARAM,Gantyada,BONANGI,108,14,926,1048,47,3,475,525,526,344,68,11266,11678,7825,0,0,0,0
11490,VIZIANAGARAM,Gantyada,BUDATHANAPALLI,121,120,908,1149,76,76,537,689,615,4105,2433,28393,34931,22297,8,0,14,22
11491,VIZIANAGARAM,Gantyada,BURUDAPADU,33,0,195,228,26,0,140,166,134,1368,0,4171,5539,2795,0,0,0,0
11492,VIZIANAGARAM,Gantyada,CHANDRAMPETA,107,4,249,360,80,3,187,270,220,4414,145,12131,16690,7399,6,0,21,27
11493,VIZIANAGARAM,Gantyada,CHINAMANAPURAM,39,0,327,366,23,0,187,210,173,1505,0,11560,13065,7291,0,0,5,5
11494,VIZIANAGARAM,Gantyada,DIGUVA KONDAPARTHI,3,429,2,434,1,260,0,261,201,92,16171,0,16263,7156,0,39,0,39
11495,VIZIANAGARAM,Gantyada,GANTAYDA,145,5,541,691,114,1,364,479,472,8528,56,20731,29315,19927,27,0,30,57
11496,VIZIANAGARAM,Gantyada,GINGERU,41,1,554,596,31,0,427,458,430,2851,0,28659,31510,20132,17,0,76,93
11497,VIZIANAGARAM,Gantyada,GODIYADA,89,0,422,511,75,0,317,392,345,5544,0,20511,26055,14557,13,0,26,39
11498,VIZIANAGARAM,Gantyada,JAGGAPURAM,14,0,339,353,7,0,285,292,291,478,0,22482,22960,18741,1,0,66,67
11499,VIZIANAGARAM,Gantyada,KIRTHUBARTHI,30,0,391,421,20,0,209,229,205,885,0,15328,16213,9318,1,0,73,74
11500,VIZIANAGARAM,Gantyada,KONDATAMARAPALLI,46,0,520,566,38,0,333,371,376,3299,0,29760,33059,19871,19,0,121,140
11501,VIZIANAGARAM,Gantyada,KORLAM,85,0,762,847,68,0,437,505,447,4964,0,25464,30428,17506,15,0,67,82
11502,VIZIANAGARAM,Gantyada,KOTARUBILLI,86,1,204,291,68,1,91,160,150,4513,61,6137,10711,6825,16,0,17,33
11503,VIZIANAGARAM,Gantyada,KOTTHAVELAGADA,97,7,349,453,69,5,248,322,261,4125,309,15699,20133,11983,11,1,33,45
11504,VIZIANAGARAM,Gantyada,LAKIDAM,80,0,1164,1244,56,0,700,756,712,3351,0,39039,42390,26523,10,0,90,100
11505,VIZIANAGARAM,Gantyada,MADANAPURAM,96,3,466,565,75,1,366,442,405,4846,27,20295,25168,13897,19,0,41,60
11506,VIZIANAGARAM,Gantyada,MADHUPADA,72,0,681,753,45,0,412,457,406,2576,0,23946,26522,15994,1,0,47,48
11507,VIZIANAGARAM,Gantyada,MOKALAPADU,18,1,121,140,18,1,95,114,111,1194,105,5028,6327,3566,5,1,4,10
11508,VIZIANAGARAM,Gantyada,MURAPAKA,18,0,330,348,15,0,210,225,189,1026,0,16085,17111,10641,4,0,64,68
11509,VIZIANAGARAM,Gantyada,NARAVA,85,2,887,974,59,2,574,635,661,2865,119,32997,35981,28106,8,1,67,76
11510,VIZIANAGARAM,Gantyada,NEELAVATHI,68,3,593,664,53,2,429,484,455,3932,140,25026,29098,16621,9,0,26,35
11511,VIZIANAGARAM,Gantyada,PEDAMAJJIPALEM,86,4,393,483,66,2,245,313,307,5032,221,16893,22146,13874,19,2,60,81
11512,VIZIANAGARAM,Gantyada,PEDAVAMLI,72,2,826,900,53,0,499,552,486,3776,0,28068,31844,21247,16,0,74,90
11513,VIZIANAGARAM,Gantyada,PENASAM,18,0,503,521,15,0,366,381,349,1025,0,18378,19403,13237,4,0,14,18
11514,VIZIANAGARAM,Gantyada,PENTASREERAMPURAM,109,0,626,735,83,0,453,536,464,5472,0,20254,25726,14297,17,0,3,20
11515,VIZIANAGARAM,Gantyada,POLLANKI,40,4,168,212,32,3,93,128,101,2238,296,6595,9129,4735,3,2,12,17
11516,VIZIANAGARAM,Gantyada,RAMABHADRAPURAM,51,11,303,365,37,7,226,270,248,2219,278,13996,16493,9389,6,0,16,22
11517,VIZIANAGARAM,Gantyada,RAMAVARAM,164,29,688,881,114,22,481,617,607,6845,1669,21863,30377,20957,20,9,19,48
11518,VIZIANAGARAM,Gantyada,RAVIVALASA,63,0,237,300,52,0,166,218,199,3268,0,12251,15519,10937,5,0,26,31
11519,VIZIANAGARAM,Gantyada,REGUBILLI,18,1,307,326,13,0,206,219,183,617,0,8694,9311,5104,0,0,0,0
11520,VIZIANAGARAM,Gantyada,SIRIPURAM,66,0,442,508,51,0,237,288,238,3353,0,10669,14022,8563,14,0,12,26
11521,VIZIANAGARAM,Gantyada,TATIPUDI,20,3,107,130,16,3,69,88,81,1158,281,4766,6205,4400,6,1,23,30
11522,VIZIANAGARAM,Gantyada,VASADI,42,1,411,454,30,1,260,291,229,991,31,11757,12779,7426,0,0,7,7
11523,VIZIANAGARAM,Gantyada,VASANTHA,95,1,715,811,75,1,423,499,446,5411,98,21490,26999,15882,21,0,5,26
11524,VIZIANAGARAM,Garividi,ARTHAMURU,102,7,514,623,69,0,341,410,370,6291,0,31198,37489,24705,36,0,184,220
11525,VIZIANAGARAM,Garividi,BONDAPALLI,144,3,508,655,140,2,442,584,542,14262,171,44203,58636,31992,114,1,309,424
11526,VIZIANAGARAM,Garividi,CHUKKAVALASA,26,8,389,423,22,5,341,368,368,1367,190,25456,27013,20434,2,0,94,96
11527,VIZIANAGARAM,Garividi,DEVADAA,51,8,781,840,39,0,620,659,684,1731,0,34654,36385,21069,0,0,30,30
11528,VIZIANAGARAM,Garividi,DUMMEDA,46,1,369,416,38,1,283,322,298,3051,63,24053,27167,18695,15,0,120,135
11529,VIZIANAGARAM,Garividi,DUVVAM,40,1,428,469,34,0,309,343,331,2637,0,27926,30563,22074,15,0,196,211
11530,VIZIANAGARAM,Garividi,GADABAVALASA,15,106,227,348,0,66,100,166,175,0,7061,9564,16625,9426,0,50,56,106
11531,VIZIANAGARAM,Garividi,GEDDAPUVALASA,26,17,628,671,18,14,478,510,469,1519,935,36249,38703,25311,7,0,148,155
11532,VIZIANAGARAM,Garividi,GOTNANDI,130,0,226,356,108,0,149,257,242,9732,0,13220,22952,14491,71,0,83,154
11533,VIZIANAGARAM,Garividi,K.PALAVALASA,93,1,379,473,70,1,258,329,339,6328,91,23105,29524,16583,40,0,159,199
11534,VIZIANAGARAM,Garividi,KAPUSAMBHAM,86,0,535,621,69,0,409,478,513,6134,0,36916,43050,25761,32,0,220,252
11535,VIZIANAGARAM,Garividi,KODURU,84,1,814,899,74,0,559,633,640,5937,0,49927,55864,37334,25,0,268,293
11536,VIZIANAGARAM,Garividi,KONDADHADI,26,0,365,391,25,0,314,339,341,2336,0,25265,27601,16860,16,0,120,136
11537,VIZIANAGARAM,Garividi,KONDALAKSHMIPURAM,79,7,493,579,47,3,372,422,406,4126,270,30720,35116,26947,19,1,112,132
11538,VIZIANAGARAM,Garividi,KONDAPALEM,152,75,682,909,109,62,400,571,563,7791,4360,26012,38163,29554,24,15,58,97
11539,VIZIANAGARAM,Garividi,KONDASAMBHAM,5,2,511,518,1,1,363,365,371,104,43,19660,19807,11911,1,0,66,67
11540,VIZIANAGARAM,Garividi,KONURU,92,0,540,632,61,0,369,430,422,5376,0,31120,36496,26182,32,0,119,151
11541,VIZIANAGARAM,Garividi,KUMARAM,81,1,620,702,63,0,417,480,470,5910,0,35699,41609,25919,39,0,178,217
11542,VIZIANAGARAM,Garividi,M. DUGGIVALASA,68,3,385,456,53,1,288,342,338,4835,44,23236,28115,17892,31,0,101,132
11543,VIZIANAGARAM,Garividi,MANDIRIVALASA,65,30,466,561,39,26,313,378,326,3794,2478,28104,34376,18785,21,16,156,193
11544,VIZIANAGARAM,Garividi,REGATI AGRAHARAM,3,15,877,895,0,13,511,524,548,0,1051,46949,48000,26879,0,6,280,286
11545,VIZIANAGARAM,Garividi,SEERIPETA,73,16,362,451,63,12,270,345,337,5172,955,21803,27930,17328,30,5,114,149
11546,VIZIANAGARAM,Garividi,SIVARAM,82,3,667,752,39,3,513,555,549,2696,219,45165,48080,29483,10,1,243,254
11547,VIZIANAGARAM,Garividi,THATIGUDA,41,0,354,395,33,0,266,299,324,3458,0,27329,30787,21426,27,0,173,200
11548,VIZIANAGARAM,Garividi,THONDRANGI,31,0,523,554,25,0,371,396,384,1631,0,28868,30499,21176,7,0,124,131
11549,VIZIANAGARAM,Garividi,VEDULLAVALASA,117,5,1164,1286,90,4,833,927,955,5334,85,45531,50950,28454,8,0,40,48
11550,VIZIANAGARAM,Garividi,VENKUPATRUNIREGA,39,0,436,475,33,0,323,356,379,3273,0,30886,34159,19609,22,0,181,203
11551,VIZIANAGARAM,Garividi,YENUGUVALASA,22,2,842,866,19,1,679,699,712,1406,84,47725,49215,30897,3,0,148,151
11552,VIZIANAGARAM,Garugubilli,BURADAVENKATAPURAM,41,0,376,417,35,0,309,344,400,2524,0,14989,17513,9608,5,0,7,12
11553,VIZIANAGARAM,Garugubilli,CHILAKAM,118,4,469,591,88,3,326,417,403,4112,31,11033,15176,8903,3,0,10,13
11554,VIZIANAGARAM,Garugubilli,CHINAGUDABA,81,10,401,492,59,7,282,348,308,3131,310,15581,19022,10435,6,0,16,22
11555,VIZIANAGARAM,Garugubilli,DALAIVALASA,69,3,313,385,61,2,240,303,295,5477,178,18582,24237,14642,31,0,89,120
11556,VIZIANAGARAM,Garugubilli,GARUGUBILLI,62,2,790,854,39,1,431,471,418,2023,5,23180,25208,13692,4,0,26,30
11557,VIZIANAGARAM,Garugubilli,GIJABA,24,6,443,473,15,5,333,353,348,1041,345,17528,18914,10652,3,2,9,14
11558,VIZIANAGARAM,Garugubilli,GOTTIVALASA,41,4,480,525,30,3,382,415,433,2747,225,34072,37044,21579,15,1,178,194
11559,VIZIANAGARAM,Garugubilli,KONKIDIVARAM,44,30,389,463,36,26,323,385,402,2886,1992,24683,29561,15844,12,11,86,109
11560,VIZIANAGARAM,Garugubilli,KOTAVANIVALASA,0,0,5,5,0,0,0,0,0,0,0,0,0,0,0,0,0,0
11561,VIZIANAGARAM,Garugubilli,KOTHAPALLI,85,15,420,520,64,11,314,389,364,4824,704,18926,24454,13814,22,3,18,43
11562,VIZIANAGARAM,Garugubilli,KOTHURU,111,1,288,400,84,1,204,289,283,6710,105,16056,22871,13587,31,1,82,114
11563,VIZIANAGARAM,Garugubilli,LAKHANAPURAM,133,41,380,554,108,35,248,391,378,5582,1770,8305,15657,9403,2,2,0,4
11564,VIZIANAGARAM,Garugubilli,MARKONDAPUTTI,129,27,508,664,77,0,310,387,338,3982,0,18709,22691,12840,5,0,18,23
11565,VIZIANAGARAM,Garugubilli,MARUPENTA,27,0,449,476,20,0,359,379,382,1495,0,28856,30351,16335,9,0,152,161
11566,VIZIANAGARAM,Garugubilli,NAGURU,45,42,414,501,33,28,274,335,343,2372,1793,16815,20980,13808,11,5,28,44
11567,VIZIANAGARAM,Garugubilli,NAVIRI,6,0,3,9,0,0,0,0,0,0,0,0,0,0,0,0,0,0
11568,VIZIANAGARAM,Garugubilli,PEDAGUDABA,61,2,524,587,31,2,304,337,334,1057,83,16574,17714,10820,0,0,33,33
11569,VIZIANAGARAM,Garugubilli,PEDDURU,27,1,594,622,20,1,439,460,434,1820,115,38449,40384,21694,10,1,239,250
11570,VIZIANAGARAM,Garugubilli,RAVIVALASA,212,34,1059,1305,85,11,503,599,552,2293,534,19554,22381,16845,1,0,17,18
11571,VIZIANAGARAM,Garugubilli,RAVUPALLI,137,8,876,1021,105,6,546,657,584,8379,377,34381,43137,24592,34,0,76,110
11572,VIZIANAGARAM,Garugubilli,RAYANDORAVALASA,41,8,133,182,37,6,76,119,117,2688,611,5089,8388,5227,8,4,15,27
11573,VIZIANAGARAM,Garugubilli,SANTHOSHAPURAM,37,8,594,639,26,4,343,373,358,2216,355,25393,27964,15470,12,2,100,114
11574,VIZIANAGARAM,Garugubilli,SIVVAMU,63,66,380,509,49,49,241,339,331,3232,5097,18991,27320,15982,14,28,91,133
11575,VIZIANAGARAM,Garugubilli,SUNKII,2,17,345,364,1,16,262,279,284,104,1336,21584,23024,13664,1,7,99,107
11576,VIZIANAGARAM,Garugubilli,THOTAPALLI,88,56,446,590,62,29,271,362,359,3792,1849,19822,25463,13728,6,5,53,64
11577,VIZIANAGARAM,Garugubilli,UDDAVOLU,20,21,457,498,14,17,337,368,365,872,1418,25591,27881,15753,2,7,110,119
11578,VIZIANAGARAM,Garugubilli,ULLIBHADRA,92,0,472,564,63,0,318,381,397,3601,0,19054,22655,13995,12,0,58,70
11579,VIZIANAGARAM,Garugubilli,VALLARIGUDABA,58,0,385,443,35,0,217,252,214,2174,0,12565,14739,8408,6,0,10,16
11580,VIZIANAGARAM,Gummalakshmipuram,BALESU,1,415,1,417,1,375,0,376,240,112,31795,0,31907,12673,1,135,0,136
11581,VIZIANAGARAM,Gummalakshmipuram,BEERUPADU,2,351,2,355,0,301,2,303,246,0,15400,27,15427,7044,0,53,0,53
11582,VIZIANAGARAM,Gummalakshmipuram,CHAPARAIBIRIDI,56,591,0,647,44,477,0,521,477,3772,25106,0,28878,15034,20,55,0,75
11583,VIZIANAGARAM,Gummalakshmipuram,CHEEMUDUGUDA,13,620,15,648,9,443,11,463,504,293,31413,535,32241,17716,0,112,0,112
11584,VIZIANAGARAM,Gummalakshmipuram,CHINAGEESADA,20,395,0,415,8,301,0,309,279,588,19231,0,19819,8910,1,54,0,55
11585,VIZIANAGARAM,Gummalakshmipuram,DUDDUKALLU,92,826,17,935,80,712,5,797,755,6717,54507,252,61476,35842,37,232,0,269
11586,VIZIANAGARAM,Gummalakshmipuram,DUMMANGI,0,325,14,339,0,276,12,288,310,0,17726,726,18452,9681,0,63,1,64
11587,VIZIANAGARAM,Gummalakshmipuram,ELWINPETA,80,596,42,718,53,402,25,480,485,3313,29191,1208,33712,20994,8,125,2,135
11588,VIZIANAGARAM,Gummalakshmipuram,G.L.PURAM,38,101,80,219,23,44,35,102,99,1368,2198,1409,4975,4394,3,1,1,5
11589,VIZIANAGARAM,Gummalakshmipuram,GOIPAKA,137,400,0,537,95,316,0,411,463,9135,24552,0,33687,17623,60,117,0,177
11590,VIZIANAGARAM,Gummalakshmipuram,IRIDI,2,455,1,458,1,326,0,327,249,79,25791,0,25870,11623,0,110,0,110
11591,VIZIANAGARAM,Gummalakshmipuram,JARNA,5,400,6,411,0,247,2,249,213,0,8668,20,8688,4043,0,11,0,11
11592,VIZIANAGARAM,Gummalakshmipuram,KEDARIPURAM,116,305,21,442,105,245,14,364,398,9903,23203,1021,34127,18676,64,137,5,206
11593,VIZIANAGARAM,Gummalakshmipuram,KONDAVADA,16,371,0,387,11,295,0,306,331,1094,20575,0,21669,12490,6,81,0,87
11594,VIZIANAGARAM,Gummalakshmipuram,KUKKIDI,8,473,5,486,4,352,3,359,339,300,21168,265,21733,11410,1,69,2,72
11595,VIZIANAGARAM,Gummalakshmipuram,LAKKAGUDA,0,1,0,1,0,0,0,0,0,0,0,0,0,0,0,0,0,0
11596,VIZIANAGARAM,Gummalakshmipuram,LAKKAGUDA - I,31,385,7,423,25,278,6,309,323,2290,24803,620,27713,16601,14,145,4,163
11597,VIZIANAGARAM,Gummalakshmipuram,LUMBESU,0,523,3,526,0,431,2,433,456,0,42614,204,42818,21567,0,252,1,253
11598,VIZIANAGARAM,Gummalakshmipuram,MANDA,34,225,8,267,22,170,4,196,187,994,12363,258,13615,6858,3,48,0,51
11599,VIZIANAGARAM,Gummalakshmipuram,NELLIKUKKUVA,0,235,0,235,0,128,0,128,94,0,8326,0,8326,3727,0,24,0,24
11600,VIZIANAGARAM,Gummalakshmipuram,NODRUKONA,0,71,0,71,0,49,0,49,66,0,2289,0,2289,1411,0,3,0,3
11601,VIZIANAGARAM,Gummalakshmipuram,P. NODRUKONA,0,249,0,249,0,192,0,192,217,0,18367,0,18367,10253,0,127,0,127
11602,VIZIANAGARAM,Gummalakshmipuram,P.AMITI,8,730,8,746,7,472,2,481,434,564,26096,205,26865,13919,3,83,1,87
11603,VIZIANAGARAM,Gummalakshmipuram,PEDAKHARJA,11,423,2,436,9,341,1,351,338,672,25314,63,26049,12975,1,103,0,104
11604,VIZIANAGARAM,Gummalakshmipuram,RAYAGADAJAMMU,1,521,0,522,0,466,0,466,537,0,32422,0,32422,17729,0,110,0,110
11605,VIZIANAGARAM,Gummalakshmipuram,RELLA,94,209,12,315,67,171,2,240,266,5183,14419,93,19695,10246,26,74,0,100
11606,VIZIANAGARAM,Gummalakshmipuram,TADIKONDA,18,516,5,539,13,460,1,474,462,861,33805,52,34718,16091,3,124,0,127
11607,VIZIANAGARAM,Gummalakshmipuram,VANGARA,11,233,2,246,10,209,2,221,237,808,16757,173,17738,10202,1,81,1,83
11608,VIZIANAGARAM,Gummalakshmipuram,VOMKABADI,0,293,0,293,0,237,0,237,215,0,9957,0,9957,4536,0,6,0,6
11609,VIZIANAGARAM,Gurla,ANANDAPURAM,24,5,499,528,12,4,361,377,386,729,182,21640,22551,15727,1,0,52,53
11610,VIZIANAGARAM,Gurla,ATCHUTAPURAM,6,0,297,303,3,0,117,120,113,198,0,7864,8062,5957,1,0,29,30
11611,VIZIANAGARAM,Gurla,BHOOPALAPURAM,51,1,340,392,30,1,219,250,234,1986,104,9381,11471,7092,4,1,1,6
11612,VIZIANAGARAM,Gurla,CHINTALAPETA,19,0,1046,1065,16,0,582,598,552,233,0,7344,7577,4300,0,0,0,0
11613,VIZIANAGARAM,Gurla,CHINTAPALLIPETA,1,0,190,191,0,0,147,147,155,0,0,9609,9609,6742,0,0,12,12
11614,VIZIANAGARAM,Gurla,CHODAVARAM,90,10,416,516,65,7,277,349,311,3219,432,14193,17844,11546,0,0,1,1
11615,VIZIANAGARAM,Gurla,DEVUNIKANAPAKA,44,64,207,315,0,0,0,0,0,0,0,0,0,0,0,0,0,0
11616,VIZIANAGARAM,Gurla,DHAMARASINGI,85,21,575,681,46,7,391,444,369,446,17,4031,4494,2475,0,0,0,0
11617,VIZIANAGARAM,Gurla,GARIDA,88,1,285,374,68,1,239,308,301,5015,26,20385,25426,15969,12,0,110,122
11618,VIZIANAGARAM,Gurla,GARIKIVALASA,48,7,801,856,37,6,578,621,632,1796,280,30472,32548,22230,0,0,49,49
11619,VIZIANAGARAM,Gurla,GOSHADA,51,0,248,299,42,0,177,219,217,2925,0,12275,15200,10831,6,0,22,28
11620,VIZIANAGARAM,Gurla,GUDEM,71,0,820,891,48,0,457,505,451,3341,0,34005,37346,25529,9,0,100,109
11621,VIZIANAGARAM,Gurla,GUJJANGIVALASA,89,2,580,671,56,2,391,449,426,3885,113,27416,31414,22477,13,0,56,69
11622,VIZIANAGARAM,Gurla,GURLA,58,1,962,1021,39,1,567,607,591,2570,4,34990,37564,26577,3,0,61,64
11623,VIZIANAGARAM,Gurla,JAMMU,9,0,489,498,8,0,363,371,376,617,0,23457,24074,12812,1,0,31,32
11624,VIZIANAGARAM,Gurla,JAMMUPETA,9,1,325,335,3,0,214,217,232,98,0,8347,8445,6621,0,0,0,0
11625,VIZIANAGARAM,Gurla,KALAVACHERLA,0,0,259,259,0,0,192,192,192,0,0,14226,14226,11238,0,0,37,37
11626,VIZIANAGARAM,Gurla,KELLA,234,2,1436,1672,127,2,854,983,1000,7841,50,46939,54830,42949,20,0,60,80
11627,VIZIANAGARAM,Gurla,KONDAGANREDU,20,20,952,992,15,17,670,702,653,962,1151,41571,43684,23990,2,4,75,81
11628,VIZIANAGARAM,Gurla,KOTAGANDREDU,54,1,510,565,34,0,159,193,201,2303,0,7259,9562,7138,4,0,6,10
11629,VIZIANAGARAM,Gurla,LAVIDAM,28,2,370,400,27,2,290,319,294,1070,72,11178,12320,7124,0,0,0,0
11630,VIZIANAGARAM,Gurla,MANYAPURIPETA,23,0,226,249,15,0,143,158,130,1110,0,8581,9691,6333,3,0,16,19
11631,VIZIANAGARAM,Gurla,NADUPURU,39,1,355,395,27,1,223,251,255,823,28,7524,8375,6300,0,0,3,3
11632,VIZIANAGARAM,Gurla,NAGALLAVALASA,56,4,707,767,37,3,491,531,491,1827,165,26861,28853,17484,1,0,15,16
11633,VIZIANAGARAM,Gurla,PAKEERUKITTALI,34,34,369,437,17,25,255,297,273,1107,1881,18640,21628,12428,4,9,62,75
11634,VIZIANAGARAM,Gurla,PALAVALASA,26,1,558,585,21,0,418,439,442,1522,0,28492,30014,24756,7,0,67,74
11635,VIZIANAGARAM,Gurla,PALLIGENDREDU,99,0,238,337,71,0,185,256,231,2529,0,8927,11456,6719,0,0,3,3
11636,VIZIANAGARAM,Gurla,PEDABANTUPALLI,65,4,844,913,58,4,653,715,701,4254,192,54520,58966,32535,15,0,287,302
11637,VIZIANAGARAM,Gurla,PENUBARTHI,88,1,963,1052,66,1,683,750,731,4000,3,38215,42218,28453,7,0,34,41
11638,VIZIANAGARAM,Gurla,POLAYAVALASA,48,1,366,415,40,1,256,297,307,2498,89,16530,19117,13108,5,0,36,41
11639,VIZIANAGARAM,Gurla,PUNNAPUREDDIPETA,0,28,385,413,0,17,289,306,306,0,1058,20558,21616,16256,0,2,66,68
11640,VIZIANAGARAM,Gurla,RAGOLU,49,0,474,523,29,0,320,349,356,1501,0,20685,22186,14401,2,0,46,48
11641,VIZIANAGARAM,Gurla,SOLIPISOMARAJUPETA,209,11,330,550,111,2,188,301,285,4307,24,9332,13663,10805,7,0,14,21
11642,VIZIANAGARAM,Gurla,TATAVARIKITTALI,10,0,225,235,8,0,162,170,171,433,0,13756,14189,9301,0,0,78,78
11643,VIZIANAGARAM,Gurla,TATIPUDI,3,0,479,482,1,0,404,405,393,55,0,28640,28695,17389,0,0,70,70
11644,VIZIANAGARAM,Gurla,TETTANGI,54,17,672,743,36,5,368,409,406,1017,160,14705,15882,10581,0,0,17,17
11645,VIZIANAGARAM,Gurla,VALLAPURAM,93,0,848,941,77,0,558,635,625,4712,0,31659,36371,21087,9,0,33,42
11646,VIZIANAGARAM,Jami,ALAMANDA,256,3,1936,2195,108,0,793,901,775,6258,0,28080,34338,23115,14,0,19,33
11647,VIZIANAGARAM,Jami,ANNAMURAJUPETA,57,0,1005,1062,44,0,567,611,646,3032,0,26442,29474,18727,11,0,45,56
11648,VIZIANAGARAM,Jami,ATTADA,10,2,346,358,9,2,273,284,300,662,110,18737,19509,13837,3,0,59,62
11649,VIZIANAGARAM,Jami,BHEEMASINGHI,28,0,958,986,16,0,599,615,586,796,0,25461,26257,16433,1,0,10,11
11650,VIZIANAGARAM,Jami,CHINATADA,38,2,288,328,31,1,229,261,265,2325,2,16201,18528,9669,9,0,47,56
11651,VIZIANAGARAM,Jami,GODIKOMMU,66,0,215,281,40,0,136,176,169,2205,0,9653,11858,9787,3,0,26,29
11652,VIZIANAGARAM,Jami,JADDETIVALASA,82,0,403,485,61,0,263,324,303,4632,0,20065,24697,15589,21,0,90,111
11653,VIZIANAGARAM,Jami,JAGARAM,122,1,490,613,81,0,279,360,327,2800,0,11657,14457,7709,0,0,2,2
11654,VIZIANAGARAM,Jami,JAMI,383,30,2080,2493,96,0,1103,1199,1123,5811,0,75240,81051,48143,13,0,259,272
11655,VIZIANAGARAM,Jami,JANNIVALASA,69,0,164,233,50,0,109,159,134,4387,0,8218,12605,6216,22,0,35,57
11656,VIZIANAGARAM,Jami,KHALAGADA,60,1,556,617,36,1,375,412,432,1865,61,22563,24489,13881,4,0,21,25
11657,VIZIANAGARAM,Jami,KUMARAM,61,1,457,519,42,1,273,316,323,2678,57,14161,16896,13487,6,0,13,19
11658,VIZIANAGARAM,Jami,LAKSHMIPURAM,86,0,364,450,68,0,265,333,335,5270,0,14458,19728,12331,25,0,12,37
11659,VIZIANAGARAM,Jami,LOTLAPALLI,38,5,311,354,16,2,222,240,261,778,150,10749,11677,9511,0,0,13,13
11660,VIZIANAGARAM,Jami,MOKASA KOTHAVALASA,109,3,681,793,69,1,389,459,494,2492,20,13455,15967,11458,3,0,2,5
11661,VIZIANAGARAM,Jami,PAVADA,25,0,164,189,21,0,115,136,129,1631,0,9508,11139,6473,8,0,50,58
11662,VIZIANAGARAM,Jami,RAMABHADRAPURAM,85,0,513,598,57,0,338,395,449,6231,0,25695,31926,17844,43,0,87,130
11663,VIZIANAGARAM,Jami,RAMAYYAPALEM,124,20,188,332,92,12,126,230,215,4201,267,7677,12145,6348,1,0,5,6
11664,VIZIANAGARAM,Jami,SASANAPALLI,45,0,253,298,39,0,183,222,209,2325,0,12705,15030,7635,6,0,18,24
11665,VIZIANAGARAM,Jami,SIRIKIPALEM,93,0,296,389,67,0,203,270,267,4859,0,13761,18620,12772,10,0,42,52
11666,VIZIANAGARAM,Jami,THANAVARAM,51,1,335,387,31,0,199,230,179,1827,0,13099,14926,7574,4,0,43,47
11667,VIZIANAGARAM,Jami,THANDRANIGI,40,0,574,614,23,0,286,309,296,634,0,9824,10458,6154,1,0,2,3
11668,VIZIANAGARAM,Jami,VANNE,25,0,328,353,18,0,234,252,236,1091,0,15293,16384,8675,1,0,8,9
11669,VIZIANAGARAM,Jami,VENKATARAJUPALEM,18,3,295,316,17,3,239,259,258,1726,346,20979,23051,12675,12,3,118,133
11670,VIZIANAGARAM,Jami,VIZINIGIRI,52,2,505,559,42,1,290,333,295,1811,33,7161,9005,4225,1,0,0,1
11671,VIZIANAGARAM,Jiyyamma Valasa,ALAMANDA,93,408,153,654,57,282,86,425,425,3101,14390,6202,23693,12261,2,18,27,47
11672,VIZIANAGARAM,Jiyyamma Valasa,ALLUVADA,29,50,371,450,21,34,240,295,305,1034,1879,10333,13246,7661,0,0,2,2
11673,VIZIANAGARAM,Jiyyamma Valasa,ANKA VARAM,48,56,513,617,30,36,373,439,415,1466,1635,19470,22571,11376,1,1,25,27
11674,VIZIANAGARAM,Jiyyamma Valasa,ARNADA,28,389,33,450,13,240,17,270,202,673,11846,679,13198,6205,1,8,0,9
11675,VIZIANAGARAM,Jiyyamma Valasa,B J PURAM,67,26,245,338,51,25,180,256,265,2465,1314,5158,8937,4482,2,1,0,3
11676,VIZIANAGARAM,Jiyyamma Valasa,BASANGI,65,29,352,446,45,22,248,315,309,2011,1630,9194,12835,7231,0,0,0,0
11677,VIZIANAGARAM,Jiyyamma Valasa,BITRAPADU,76,7,365,448,65,5,294,364,369,4600,407,21489,26496,14094,11,2,66,79
11678,VIZIANAGARAM,Jiyyamma Valasa,BOMIKA,50,6,281,337,42,5,227,274,259,3143,251,12714,16108,8484,5,0,4,9
11679,VIZIANAGARAM,Jiyyamma Valasa,CH MERANGI,198,11,895,1104,132,4,497,633,620,2696,268,11518,14482,8109,0,0,0,0
11680,VIZIANAGARAM,Jiyyamma Valasa,CHINTALA BELAGAM,124,49,721,894,89,41,589,719,730,4947,3328,41707,49982,25531,4,15,50,69
11681,VIZIANAGARAM,Jiyyamma Valasa,DANGABHADRA,27,135,324,486,17,97,216,330,313,541,4758,10866,16165,8479,0,2,4,6
11682,VIZIANAGARAM,Jiyyamma Valasa,GAVARAM PETA,34,68,429,531,21,43,267,331,317,601,1617,11487,13705,7689,0,0,0,0
11683,VIZIANAGARAM,Jiyyamma Valasa,GEDA THIRUVADA,35,96,335,466,18,85,258,361,357,783,6628,17597,25008,13182,0,25,18,43
11684,VIZIANAGARAM,Jiyyamma Valasa,GUDI SINGAPURAM,51,108,199,358,35,81,123,239,221,2413,5640,7022,15075,8087,2,13,1,16
11685,VIZIANAGARAM,Jiyyamma Valasa,ITIKA,40,118,336,494,14,79,218,311,307,667,5575,15424,21666,12096,1,20,55,76
11686,VIZIANAGARAM,Jiyyamma Valasa,JIYYAMMA VALASA,102,181,955,1238,70,138,744,952,893,4732,7379,49532,61643,32177,8,8,97,113
11687,VIZIANAGARAM,Jiyyamma Valasa,JOGULA DUMMA,29,1,266,296,19,0,188,207,206,1076,0,7720,8796,4867,1,0,0,1
11688,VIZIANAGARAM,Jiyyamma Valasa,K .THIRUVADA,62,15,476,553,54,14,440,508,513,4548,1193,39861,45602,25324,21,7,240,268
11689,VIZIANAGARAM,Jiyyamma Valasa,KANNAPU DORA VALASA,99,18,645,762,72,14,531,617,598,5830,900,30855,37585,19979,28,1,66,95
11690,VIZIANAGARAM,Jiyyamma Valasa,KONDA CHILAKAM,0,418,1,419,0,337,0,337,361,0,15227,0,15227,7716,0,23,0,23
11691,VIZIANAGARAM,Jiyyamma Valasa,KUDAMA,60,91,623,774,49,79,532,660,715,2646,5149,33588,41383,21587,0,12,45,57
11692,VIZIANAGARAM,Jiyyamma Valasa,P MERANGI,116,72,782,970,75,53,504,632,605,4431,4291,28892,37614,21450,3,23,21,47
11693,VIZIANAGARAM,Jiyyamma Valasa,P TOLU MANDA,2,459,6,467,0,371,5,376,444,0,24442,126,24568,12706,0,57,0,57
11694,VIZIANAGARAM,Jiyyamma Valasa,PARJA PADU,18,86,559,663,14,66,454,534,551,910,4625,29554,35089,18512,0,6,24,30
11695,VIZIANAGARAM,Jiyyamma Valasa,PEDA BODDIDI,54,48,647,749,25,36,386,447,403,652,1684,13236,15572,8976,0,0,3,3
11696,VIZIANAGARAM,Jiyyamma Valasa,PIPPALA BHDRA,36,17,346,399,23,9,265,297,306,1587,495,15246,17328,9323,3,0,15,18
11697,VIZIANAGARAM,Jiyyamma Valasa,SHIKABADI,122,18,529,669,84,13,318,415,383,5480,824,19595,25899,14109,3,0,9,12
11698,VIZIANAGARAM,Jiyyamma Valasa,TAMARA KANDI JAMMU,0,100,0,100,0,80,0,80,86,0,4583,0,4583,2435,0,11,0,11
11699,VIZIANAGARAM,Jiyyamma Valasa,TAMARA KANDI JAMMU (H),2,428,2,432,1,355,1,357,418,68,18752,8,18828,9607,0,24,0,24
11700,VIZIANAGARAM,Jiyyamma Valasa,THALADUMMA,52,204,384,640,35,168,261,464,433,1627,11459,15960,29046,17391,2,45,31,78
11701,VIZIANAGARAM,Jiyyamma Valasa,THUMBILI,38,131,469,638,26,89,332,447,443,1653,4343,17057,23053,12771,3,10,60,73
11702,VIZIANAGARAM,Jiyyamma Valasa,THURAKA NAIDU VALASA,117,3,345,465,87,2,275,364,355,4947,80,12932,17959,9979,3,0,5,8
11703,VIZIANAGARAM,Komarada,ARTHAM,24,69,125,218,17,64,85,166,172,843,4443,5709,10995,7384,0,19,16,35
11704,VIZIANAGARAM,Komarada,CHINA KHERJALA,67,500,80,647,13,322,15,350,284,486,12413,506,13405,6956,2,19,1,22
11705,VIZIANAGARAM,Komarada,CHOLAPADAM,71,402,117,590,20,309,63,392,332,931,19245,4389,24565,15395,0,57,4,61
11706,VIZIANAGARAM,Komarada,DALAI PETA,95,30,299,424,23,22,237,282,324,779,1442,12681,14902,9192,0,6,27,33
11707,VIZIANAGARAM,Komarada,DEVUKONA,14,227,81,322,9,177,48,234,259,419,10432,2396,13247,7574,1,21,3,25
11708,VIZIANAGARAM,Komarada,DUGGI,166,0,45,211,144,0,38,182,186,9344,0,2150,11494,6833,29,0,5,34
11709,VIZIANAGARAM,Komarada,GANGAREGU VALASA,111,45,457,613,79,37,342,458,464,3736,2777,21417,27930,19061,6,10,58,74
11710,VIZIANAGARAM,Komarada,GUMADA,111,39,301,451,13,29,243,285,307,710,2262,17715,20687,14740,0,9,63,72
11711,VIZIANAGARAM,Komarada,GUNADA TELESU,63,430,16,509,20,301,8,329,312,362,10996,541,11899,6461,0,18,2,20
11712,VIZIANAGARAM,Komarada,GUNANUPURAM,34,65,352,451,29,54,302,385,406,1318,2084,17845,21247,14150,1,2,53,56
11713,VIZIANAGARAM,Komarada,KALLIKOTA,46,68,411,525,26,43,248,317,281,495,1582,11515,13592,8080,0,1,21,22
11714,VIZIANAGARAM,Komarada,KAMBA VALASA,54,314,178,546,39,259,100,398,406,1478,15899,3772,21149,13404,0,57,4,61
11715,VIZIANAGARAM,Komarada,KEMI SEELA,96,237,26,359,79,211,16,306,337,5529,13216,1052,19797,12188,18,24,3,45
11716,VIZIANAGARAM,Komarada,KOMARADA,257,112,900,1269,116,67,602,785,672,4781,4590,33769,43140,26588,3,15,80,98
11717,VIZIANAGARAM,Komarada,KOTIPAM,70,107,437,614,41,82,284,407,344,1923,5799,14970,22692,14126,0,18,25,43
11718,VIZIANAGARAM,Komarada,KOTTU,55,80,248,383,51,77,230,358,392,4392,5896,15994,26282,15292,23,19,35,77
11719,VIZIANAGARAM,Komarada,KUMMARI GUNTA,92,204,246,542,63,152,156,371,343,4255,12513,9696,26464,14004,19,63,29,111
11720,VIZIANAGARAM,Komarada,KUNTESU,109,318,14,441,83,225,7,315,311,4759,10657,335,15751,7975,8,12,0,20
11721,VIZIANAGARAM,Komarada,MADALANGI,53,94,254,401,37,77,157,271,275,1096,3885,7308,12289,7798,1,6,2,9
11722,VIZIANAGARAM,Komarada,MASIMANDA,15,284,25,324,2,124,7,133,95,10,4994,87,5091,2550,0,1,0,1
11723,VIZIANAGARAM,Komarada,NAYA,0,267,0,267,0,64,0,64,57,0,1454,0,1454,698,0,0,0,0
11724,VIZIANAGARAM,Komarada,NIMMALA PADU,20,5,74,99,17,5,66,88,101,1624,525,5707,7856,4710,8,4,32,44
11725,VIZIANAGARAM,Komarada,PALEM,32,372,61,465,24,293,38,355,359,1125,14437,2485,18047,8699,4,46,11,61
11726,VIZIANAGARAM,Komarada,PARASURAM PURAM,35,3,365,403,22,2,258,282,295,1121,64,14418,15603,11095,0,0,14,14
11727,VIZIANAGARAM,Komarada,PEDASEKHA,30,318,8,356,19,248,1,268,244,914,7465,12,8391,4499,2,6,0,8
11728,VIZIANAGARAM,Komarada,PUDESU,96,316,20,432,59,237,10,306,287,2722,14245,527,17494,8896,1,39,1,41
11729,VIZIANAGARAM,Komarada,SIVINI,144,39,257,440,87,30,158,275,307,4085,1833,7435,13353,9840,3,2,3,8
11730,VIZIANAGARAM,Komarada,THODUMU,19,6,153,178,16,6,119,141,151,1091,467,9008,10566,6754,1,2,33,36
11731,VIZIANAGARAM,Komarada,ULIPIRI,52,256,28,336,32,176,12,220,228,2189,6721,668,9578,6032,6,13,1,20
11732,VIZIANAGARAM,Komarada,VANNAM,44,104,108,256,36,86,68,190,185,1925,6526,4161,12612,6946,4,29,14,47
11733,VIZIANAGARAM,Komarada,VIKRAM PURAM,74,65,684,823,63,57,568,688,716,3490,4415,35352,43257,28682,3,16,79,98
11734,VIZIANAGARAM,Kothavalasa,APPANNADORAPALEM,16,307,37,360,12,279,11,302,333,864,22579,795,24238,14715,5,96,1,102
11735,VIZIANAGARAM,Kothavalasa,APPANNAPALEM,4,0,292,296,2,0,160,162,142,152,0,10844,10996,8666,0,0,44,44
11736,VIZIANAGARAM,Kothavalasa,CHIDIVALASA,29,4,322,355,24,2,257,283,272,1798,122,20107,22027,14396,6,0,63,69
11737,VIZIANAGARAM,Kothavalasa,CHINARAOPALLI,18,0,189,207,11,0,129,140,130,908,0,9308,10216,7873,5,0,30,35
11738,VIZIANAGARAM,Kothavalasa,CHINNIPALEM,17,0,159,176,13,0,123,136,131,1006,0,9876,10882,7419,5,0,30,35
11739,VIZIANAGARAM,Kothavalasa,CHINTHALAPALEM,51,0,284,335,33,0,167,200,209,2298,0,11033,13331,11706,8,0,20,28
11740,VIZIANAGARAM,Kothavalasa,DANDERU,10,1,335,346,7,1,285,293,287,548,5,21501,22054,16368,1,0,60,61
11741,VIZIANAGARAM,Kothavalasa,DESAPATHURINIPALEM,151,0,362,513,74,0,250,324,343,4299,0,17640,21939,20275,7,0,19,26
11742,VIZIANAGARAM,Kothavalasa,DEVADA,48,7,569,624,19,4,355,378,349,846,219,26681,27746,21846,3,0,122,125
11743,VIZIANAGARAM,Kothavalasa,GASNISETTYPALEM,17,0,330,347,10,0,207,217,219,606,0,13089,13695,10445,1,0,22,23
11744,VIZIANAGARAM,Kothavalasa,GOLLALAPALEM,0,0,288,288,0,0,199,199,196,0,0,17713,17713,16496,0,0,128,128
11745,VIZIANAGARAM,Kothavalasa,GULIVINDADA,34,0,342,376,28,0,238,266,274,1630,0,11119,12749,10708,2,0,5,7
11746,VIZIANAGARAM,Kothavalasa,KANTAKAPALLI,48,0,545,593,35,0,405,440,441,2273,0,29403,31676,21861,6,0,90,96
11747,VIZIANAGARAM,Kothavalasa,KATAKAPALLI,22,1,617,640,12,0,326,338,321,1123,0,15479,16602,10563,6,0,28,34
11748,VIZIANAGARAM,Kothavalasa,KOTHAVALASA,198,24,2323,2545,54,1,973,1028,970,2048,71,52526,54645,40779,1,0,65,66
11749,VIZIANAGARAM,Kothavalasa,MANGALAPALEM,32,0,416,448,16,0,229,245,235,977,0,13867,14844,13546,1,0,26,27
11750,VIZIANAGARAM,Kothavalasa,MISHIRAM,28,3,372,403,24,3,271,298,287,2107,192,23759,26058,19664,12,1,115,128
11751,VIZIANAGARAM,Kothavalasa,NIMALAPALEM,31,4,314,349,19,2,221,242,244,1358,195,14415,15968,13225,7,0,30,37
11752,VIZIANAGARAM,Kothavalasa,RAMALINGAPURAM,29,0,707,736,19,0,378,397,362,1830,0,31476,33306,21334,8,0,133,141
11753,VIZIANAGARAM,Kothavalasa,RELLI,30,0,268,298,22,0,167,189,152,889,0,9135,10024,6021,3,0,39,42
11754,VIZIANAGARAM,Kothavalasa,SANTHAPALEM,79,1,395,475,30,1,234,265,247,1835,6,20223,22064,16781,4,0,122,126
11755,VIZIANAGARAM,Kothavalasa,THUMIKAPALLI,74,2,792,868,62,1,658,721,695,4401,46,29866,34313,29761,8,0,11,19
11756,VIZIANAGARAM,Kothavalasa,UTTARAPALLI,115,0,262,377,87,0,188,275,238,6009,0,11883,17892,14159,20,0,25,45
11757,VIZIANAGARAM,Kothavalasa,VEERABHADRAPURAM,61,0,1034,1095,38,0,537,575,578,2817,0,32661,35478,29841,15,0,50,65
11758,VIZIANAGARAM,Kothavalasa,VIYYAMPETA,1,0,396,397,0,0,257,257,251,0,0,16023,16023,10583,0,0,34,34
11759,VIZIANAGARAM,Kurupam,BIYYALAVALASA,1,317,1,319,1,228,1,230,209,42,13321,18,13381,6271,0,42,0,42
11760,VIZIANAGARAM,Kurupam,GOTTIVADA,1,353,0,354,0,269,0,269,270,0,17968,0,17968,9614,0,66,0,66
11761,VIZIANAGARAM,Kurupam,GUJJIVAISIVADA,13,554,32,599,8,407,17,432,431,469,26514,1097,28080,13443,1,88,3,92
11762,VIZIANAGARAM,Kurupam,GUJJUVAI,4,443,10,457,3,340,7,350,370,172,15369,303,15844,7927,0,17,0,17
11763,VIZIANAGARAM,Kurupam,GUMMA,63,304,19,386,46,216,10,272,306,3292,15590,658,19540,11079,10,53,1,64
11764,VIZIANAGARAM,Kurupam,GUMMIDIGUDA,26,302,85,413,18,230,57,305,282,866,10969,3073,14908,7097,1,1,2,4
11765,VIZIANAGARAM,Kurupam,JARADA,0,227,0,227,0,178,0,178,210,0,8179,0,8179,4466,0,15,0,15
11766,VIZIANAGARAM,Kurupam,KICHADA,52,108,223,383,39,84,141,264,254,2675,8211,10975,21861,11542,5,48,53,106
11767,VIZIANAGARAM,Kurupam,KURUPAM,361,383,1329,2073,198,268,712,1178,1156,7186,16490,47057,70733,37435,10,58,197,265
11768,VIZIANAGARAM,Kurupam,MARRIPALLI,7,301,0,308,5,240,0,245,242,114,14348,0,14462,6345,0,28,0,28
11769,VIZIANAGARAM,Kurupam,MONDEMKHALLU,57,417,213,687,38,278,97,413,418,2750,22400,6418,31568,18479,10,106,15,131
11770,VIZIANAGARAM,Kurupam,NEELAKANTAPURAM,29,1087,36,1152,19,724,13,756,782,452,22943,320,23715,11516,0,24,0,24
11771,VIZIANAGARAM,Kurupam,OBBANGI,4,556,5,565,2,489,3,494,514,60,34793,98,34951,16973,0,122,0,122
11772,VIZIANAGARAM,Kurupam,P.LEVIDI,112,155,41,308,72,109,20,201,218,6854,12320,2056,21230,13618,40,89,17,146
11773,VIZIANAGARAM,Kurupam,PEDAGOTTILI,17,547,19,583,15,412,11,438,474,937,22992,392,24321,12463,2,40,0,42
11774,VIZIANAGARAM,Kurupam,PODI,1,308,0,309,0,237,0,237,264,0,16476,0,16476,7997,0,60,0,60
11775,VIZIANAGARAM,Kurupam,RASAKUNTUBAI,0,134,3,137,0,107,2,109,125,0,6537,199,6736,4206,0,15,1,16
11776,VIZIANAGARAM,Kurupam,THITTIRI,2,846,1,849,0,607,1,608,672,0,32534,33,32567,15793,0,77,0,77
11777,VIZIANAGARAM,Kurupam,VALASABALLERU,0,425,7,432,0,346,2,348,338,0,21138,33,21171,10596,0,74,0,74
11778,VIZIANAGARAM,Kurupam,VOOSAKONDA,4,369,4,377,2,296,3,301,345,105,23238,191,23534,11935,0,99,1,100
11779,VIZIANAGARAM,Kurupam,VUDAYAPURAM,41,412,2,455,25,317,1,343,352,817,13208,89,14114,7830,1,18,0,19
11780,VIZIANAGARAM,Kurupam,VURIDI,3,401,3,407,1,290,1,292,305,98,19347,6,19451,9980,0,64,0,64
11781,VIZIANAGARAM,Kurupam,YEGULAVADA,2,460,0,462,2,364,0,366,353,93,30324,0,30417,13955,0,135,0,135
11782,VIZIANAGARAM,Lakkavarapukota,BHEEMALI,25,3,353,381,10,0,276,286,255,643,0,16997,17640,13305,1,0,38,39
11783,VIZIANAGARAM,Lakkavarapukota,CHANDULURU,45,0,858,903,34,0,568,602,599,2358,0,46482,48840,27187,3,0,223,226
11784,VIZIANAGARAM,Lakkavarapukota,DASULALAPALEM,38,0,121,159,33,0,100,133,133,3118,0,8884,12002,8544,20,0,42,62
11785,VIZIANAGARAM,Lakkavarapukota,GANGUBUDI,14,0,428,442,8,0,257,265,265,437,0,18965,19402,16530,3,0,59,62
11786,VIZIANAGARAM,Lakkavarapukota,GANIVADA,74,6,411,491,63,4,280,347,359,4407,286,19569,24262,15383,17,1,66,84
11787,VIZIANAGARAM,Lakkavarapukota,GEDALAVANIPALEM,1,3,406,410,0,2,310,312,280,0,71,23705,23776,14032,0,0,81,81
11788,VIZIANAGARAM,Lakkavarapukota,GOLJAM,35,0,747,782,32,0,507,539,563,2824,0,28579,31403,19902,14,0,56,70
11789,VIZIANAGARAM,Lakkavarapukota,JAMADEVIPETA,27,0,257,284,20,0,181,201,190,1532,0,14207,15739,12508,7,0,76,83
11790,VIZIANAGARAM,Lakkavarapukota,KALLAMPUDI,31,1,270,302,28,1,222,251,279,2528,98,18081,20707,11985,3,0,20,23
11791,VIZIANAGARAM,Lakkavarapukota,KALLEPALLI REGA,48,2,680,730,40,2,610,652,704,3457,204,54853,58514,39991,14,1,305,320
11792,VIZIANAGARAM,Lakkavarapukota,KASAPETA,31,0,606,637,18,0,373,391,370,1463,0,22758,24221,14028,6,0,52,58
11793,VIZIANAGARAM,Lakkavarapukota,KITHANNAPETA,21,0,370,391,19,0,294,313,345,1558,0,14724,16282,12261,10,0,24,34
11794,VIZIANAGARAM,Lakkavarapukota,KONAMASIVANIPALEM,86,0,206,292,58,0,155,213,210,5088,0,14207,19295,15160,28,0,70,98
11795,VIZIANAGARAM,Lakkavarapukota,KOTAYADA,59,0,710,769,46,0,500,546,555,3700,0,41996,45696,26662,20,0,214,234
11796,VIZIANAGARAM,Lakkavarapukota,L.KOTA,169,1,516,686,96,1,327,424,380,5357,46,17917,23320,16347,11,0,33,44
11797,VIZIANAGARAM,Lakkavarapukota,L.KOTA TALARI,63,0,233,296,50,0,163,213,194,3142,0,11177,14319,9713,16,0,38,54
11798,VIZIANAGARAM,Lakkavarapukota,L.KOTASETHARAMPURAM,14,0,139,153,10,0,119,129,119,904,0,10849,11753,8512,8,0,85,93
11799,VIZIANAGARAM,Lakkavarapukota,LATCHAMPETA,29,0,429,458,19,0,316,335,326,453,0,19096,19549,12473,0,0,38,38
11800,VIZIANAGARAM,Lakkavarapukota,LINGAMPETA,13,1,284,298,12,1,259,272,275,1289,110,26492,27891,15911,11,1,249,261
11801,VIZIANAGARAM,Lakkavarapukota,MALLIVEEDU,51,0,297,348,43,0,205,248,224,3338,0,14198,17536,14264,12,0,16,28
11802,VIZIANAGARAM,Lakkavarapukota,MARLAPALLI,35,0,470,505,27,0,340,367,348,1008,0,24385,25393,17360,1,0,78,79
11803,VIZIANAGARAM,Lakkavarapukota,NARASANNAPETA,0,1,329,330,0,0,242,242,246,0,0,18715,18715,9604,0,0,71,71
11804,VIZIANAGARAM,Lakkavarapukota,POTHAMPETA,16,1,278,295,13,1,259,273,268,1158,107,22322,23587,13649,5,1,115,121
11805,VIZIANAGARAM,Lakkavarapukota,RANGAPURAM,22,0,219,241,19,0,195,214,219,1533,0,15580,17113,12422,8,0,91,99
11806,VIZIANAGARAM,Lakkavarapukota,RANGARAYAPURAM,48,2,346,396,44,1,276,321,311,2940,41,18456,21437,16757,10,0,41,51
11807,VIZIANAGARAM,Lakkavarapukota,REGA,45,0,683,728,33,0,487,520,572,2901,0,43581,46482,27378,17,0,258,275
11808,VIZIANAGARAM,Lakkavarapukota,RELLIGAVARAMPETA,28,1,367,396,15,0,271,286,282,661,0,20451,21112,14974,1,0,80,81
11809,VIZIANAGARAM,Lakkavarapukota,SANTHAPETA,8,0,162,170,4,0,124,128,116,267,0,9201,9468,6525,1,0,37,38
11810,VIZIANAGARAM,Lakkavarapukota,SREERAMPURAM,32,0,183,215,27,0,157,184,179,2628,0,15103,17731,12515,19,0,122,141
11811,VIZIANAGARAM,Lakkavarapukota,THAMARAPALLI,43,0,214,257,35,0,176,211,208,2592,0,14163,16755,11544,7,0,30,37
11812,VIZIANAGARAM,Lakkavarapukota,VEERABHADRAPETA,37,0,344,381,33,0,282,315,306,2453,0,17750,20203,12102,10,0,26,36
11813,VIZIANAGARAM,Makkuva,A.VENKAMPETA,9,18,371,398,7,18,339,364,352,511,1629,29209,31349,18422,2,9,154,165
11814,VIZIANAGARAM,Makkuva,BANGARUVALASA,32,8,170,210,25,5,148,178,185,2118,505,13647,16270,9789,10,3,73,86
11815,VIZIANAGARAM,Makkuva,CHAPPEBUTCHAMPETA,85,239,610,934,67,146,397,610,443,5567,11690,34840,52097,29621,35,41,187,263
11816,VIZIANAGARAM,Makkuva,CHEMUDU,53,162,662,877,26,85,405,516,505,2310,7311,32930,42551,25847,13,38,153,204
11817,VIZIANAGARAM,Makkuva,DABBAGEDDA,121,361,253,735,73,285,170,528,581,5134,22433,13415,40982,23382,20,94,61,175
11818,VIZIANAGARAM,Makkuva,DEVERASIRLAM,70,156,448,674,54,128,334,516,500,4589,12387,32161,49137,27316,26,74,195,295
11819,VIZIANAGARAM,Makkuva,KANNAMPETA,67,19,376,462,55,14,275,344,337,4147,933,18568,23648,14372,21,2,51,74
11820,VIZIANAGARAM,Makkuva,KASIPATNAM,142,24,1177,1343,107,17,845,969,967,9510,1444,70818,81772,47398,49,8,373,430
11821,VIZIANAGARAM,Makkuva,KAVIRIPALLI,0,0,0,0,0,0,0,0,0,0,0,0,0,0,0,0,0,0
11822,VIZIANAGARAM,Makkuva,KAVIRIPALLI (I),100,47,282,429,96,44,243,383,376,8625,4078,21694,34397,20383,52,25,128,205
11823,VIZIANAGARAM,Makkuva,KONA,55,20,547,622,38,16,457,511,559,3719,1632,44391,49742,29778,21,11,269,301
11824,VIZIANAGARAM,Makkuva,KOYYANNAPETA,55,31,487,573,28,24,275,327,310,2213,2057,26586,30856,16950,12,13,160,185
11825,VIZIANAGARAM,Makkuva,MAKKUVA,197,58,885,1140,122,18,700,840,770,9622,1485,53210,64317,42836,60,6,201,267
11826,VIZIANAGARAM,Makkuva,MARKONDAPUTTI,216,511,189,916,134,347,103,584,428,8876,26336,6589,41801,20654,31,77,24,132
11827,VIZIANAGARAM,Makkuva,NANDA,16,205,44,265,14,162,28,204,98,1470,12322,1790,15582,4591,7,51,5,63
11828,VIZIANAGARAM,Makkuva,PANASABHADRA,179,1155,114,1448,134,826,33,993,946,10105,61154,2141,73400,39954,49,274,2,325
11829,VIZIANAGARAM,Makkuva,SAMBARA,158,90,840,1088,74,54,597,725,683,5181,3480,41423,50084,33454,10,9,98,117
11830,VIZIANAGARAM,Makkuva,SANYASIRAJUPURAM,17,190,222,429,9,156,163,328,293,616,13118,12764,26498,14158,1,65,51,117
11831,VIZIANAGARAM,Makkuva,SARIYVALASA,27,32,301,360,24,31,259,314,319,1833,2853,22135,26821,16841,9,17,119,145
11832,VIZIANAGARAM,Makkuva,SEEBILLIPEDDAVALASA,77,147,80,304,62,110,53,225,206,5084,9572,3707,18363,9998,24,51,15,90
11833,VIZIANAGARAM,Makkuva,TURUMAMIDI,14,40,442,496,7,32,312,351,314,590,2180,27492,30262,18289,3,12,137,152
11834,VIZIANAGARAM,Makkuva,VENKATABHYRIPURAM,67,71,509,647,41,29,321,391,336,3048,2008,23841,28897,17312,10,6,84,100
11835,VIZIANAGARAM,Mentada,AGURU,179,60,141,380,152,57,112,321,327,10841,5012,7902,23755,12723,44,27,28,99
11836,VIZIANAGARAM,Mentada,AMARAYAVALASA,5,0,168,173,4,0,149,153,153,265,0,12704,12969,7102,1,0,68,69
11837,VIZIANAGARAM,Mentada,ANDRA,90,206,247,543,65,117,177,359,312,3053,5860,7801,16714,8894,3,7,2,12
11838,VIZIANAGARAM,Mentada,BADEVALASA,19,0,405,424,15,0,296,311,317,1117,0,21101,22218,12326,5,0,60,65
11839,VIZIANAGARAM,Mentada,BUTCHIRAJUPETA,3,17,83,103,0,14,72,86,98,0,1539,7201,8740,5085,0,13,58,71
11840,VIZIANAGARAM,Mentada,CHALLAPETA,34,8,392,434,26,3,276,305,299,2202,186,22538,24926,14543,8,1,121,130
11841,VIZIANAGARAM,Mentada,CHINTALAVALASA,8,19,119,146,7,17,110,134,125,666,1596,8853,11115,5471,4,8,44,56
11842,VIZIANAGARAM,Mentada,GURLA,31,12,305,348,24,12,245,281,295,1714,625,16385,18724,10278,5,2,51,58
11843,VIZIANAGARAM,Mentada,GURRAMMAVALASA,1,25,73,99,1,24,69,94,94,97,1940,5808,7845,4637,0,8,40,48
11844,VIZIANAGARAM,Mentada,IDDINAVALASA,38,4,235,277,33,0,189,222,223,2620,0,14121,16741,9721,8,0,59,67
11845,VIZIANAGARAM,Mentada,IPPALAVALASA,25,0,509,534,19,0,354,373,352,1594,0,27540,29134,16635,6,0,121,127
11846,VIZIANAGARAM,Mentada,JAGANNADHAPURAM,110,7,92,209,89,7,63,159,150,6744,592,4323,11659,6686,36,4,16,56
11847,VIZIANAGARAM,Mentada,JAKKUVA,42,1,647,690,36,1,549,586,569,2901,105,41777,44783,24602,12,1,167,180
11848,VIZIANAGARAM,Mentada,JAYATHI,56,40,602,698,45,25,441,511,500,2463,1002,24516,27981,15870,5,1,34,40
11849,VIZIANAGARAM,Mentada,K.LINGALAVALASA,8,421,32,461,2,287,22,311,293,115,14879,1472,16466,9085,0,30,2,32
11850,VIZIANAGARAM,Mentada,KANTUBUKATAVALASA,13,40,131,184,9,34,110,153,145,603,1138,8503,10244,6271,2,0,34,36
11851,VIZIANAGARAM,Mentada,KHAILAM,7,0,197,204,3,0,154,157,150,242,0,10482,10724,6507,1,0,32,33
11852,VIZIANAGARAM,Mentada,KOMPANGI,48,0,294,342,36,0,251,287,288,2662,0,17792,20454,12328,12,0,71,83
11853,VIZIANAGARAM,Mentada,KUNERU,10,139,58,207,6,96,36,138,136,586,5839,3355,9780,5364,4,28,24,56
11854,VIZIANAGARAM,Mentada,KUNTINAVALASA,84,2,810,896,73,2,699,774,719,6573,158,55629,62360,34333,37,1,271,309
11855,VIZIANAGARAM,Mentada,LOTHUGEDDA,115,281,98,494,101,233,79,413,419,6564,13716,6238,26518,15025,21,34,30,85
11856,VIZIANAGARAM,Mentada,MEESALAPETA,13,0,185,198,11,0,153,164,168,950,0,10056,11006,5510,4,0,13,17
11857,VIZIANAGARAM,Mentada,MENTADA,129,1,708,838,116,1,595,712,676,8140,87,40635,48862,27621,34,0,118,152
11858,VIZIANAGARAM,Mentada,PEDACHAMALAPALLE,31,1,261,293,28,1,189,218,188,2990,45,17639,20674,11934,24,0,107,131
11859,VIZIANAGARAM,Mentada,PEDAMEDAPALLI,136,0,754,890,128,0,709,837,879,10273,0,56856,67129,40587,48,0,269,317
11860,VIZIANAGARAM,Mentada,PITTADA,93,92,446,631,82,55,361,498,486,5601,3086,21281,29968,17219,19,2,31,52
11861,VIZIANAGARAM,Mentada,PORAM,77,0,618,695,54,0,406,460,450,4135,0,28637,32772,19674,18,0,94,112
11862,VIZIANAGARAM,Mentada,RABANDA,38,0,157,195,27,0,113,140,153,2594,0,10221,12815,6641,19,0,63,82
11863,VIZIANAGARAM,Mentada,THAMMIRAJUPETA.G,43,54,436,533,29,38,352,419,402,1662,2687,18036,22385,11931,2,5,15,22
11864,VIZIANAGARAM,Mentada,UDDANGI,15,59,141,215,14,48,130,192,177,850,1540,7828,10218,5583,3,2,10,15
11865,VIZIANAGARAM,Merakamudidam,BHEEMAVARAM,108,6,280,394,88,2,197,287,291,7832,52,11681,19565,14149,43,0,20,63
11866,VIZIANAGARAM,Merakamudidam,BHYRIPURAM,87,1,923,1011,59,0,462,521,546,5498,0,43975,49473,32413,25,0,232,257
11867,VIZIANAGARAM,Merakamudidam,BILLALAVALASA,130,1,243,374,68,0,109,177,170,5613,0,9676,15289,10884,34,0,74,108
11868,VIZIANAGARAM,Merakamudidam,BUDARAYAVALASA,53,1,823,877,33,1,460,494,477,2127,37,28955,31119,17786,4,0,79,83
11869,VIZIANAGARAM,Merakamudidam,CHELLAPURAM,65,5,449,519,49,2,351,402,457,2380,102,20887,23369,13343,3,0,22,25
11870,VIZIANAGARAM,Merakamudidam,CHINABANTUPALLE,39,6,763,808,19,4,516,539,584,991,370,43292,44653,25581,2,1,197,200
11871,VIZIANAGARAM,Merakamudidam,G.MARRIVALASA,11,82,332,425,1,60,249,310,313,11,4362,19207,23580,13915,0,22,96,118
11872,VIZIANAGARAM,Merakamudidam,GARBHAM,256,11,2530,2797,113,7,1500,1620,1631,9767,576,124390,134733,76270,47,2,599,648
11873,VIZIANAGARAM,Merakamudidam,GARUGUBILLI,114,101,986,1201,70,78,677,825,817,6147,6668,61407,74222,43271,31,34,337,402
11874,VIZIANAGARAM,Merakamudidam,GOLLALAVALASA,35,0,549,584,25,0,446,471,443,2671,0,28409,31080,15733,17,0,92,109
11875,VIZIANAGARAM,Merakamudidam,GOTTIPALLE,14,0,207,221,9,0,160,169,183,834,0,14794,15628,8927,4,0,88,92
11876,VIZIANAGARAM,Merakamudidam,H. KONDALAVERU,56,0,462,518,25,0,285,310,298,1961,0,25531,27492,15668,8,0,132,140
11877,VIZIANAGARAM,Merakamudidam,IPPALAVALASA,49,10,528,587,34,9,293,336,355,2185,635,20636,23456,14796,11,2,96,109
11878,VIZIANAGARAM,Merakamudidam,KONDALAVERU,7,140,25,172,1,98,6,105,101,118,9090,391,9599,5015,1,53,1,55
11879,VIZIANAGARAM,Merakamudidam,KORLAM,31,9,645,685,21,6,481,508,519,1311,231,34014,35556,22690,1,0,108,109
11880,VIZIANAGARAM,Merakamudidam,M.RAVIVALASA,12,0,528,540,3,0,289,292,264,128,0,21809,21937,14771,0,0,84,84
11881,VIZIANAGARAM,Merakamudidam,MERAKAMUDIDAM,160,1,950,1111,126,0,558,684,748,9628,0,42935,52563,35023,34,0,136,170
11882,VIZIANAGARAM,Merakamudidam,PULIGUMMI,30,4,617,651,14,3,182,199,197,793,200,10671,11664,7003,3,0,22,25
11883,VIZIANAGARAM,Merakamudidam,RACHAGUMADAM,118,0,214,332,88,0,138,226,222,7916,0,10429,18345,11731,47,0,43,90
11884,VIZIANAGARAM,Merakamudidam,RAMAYAVALASA,142,0,460,602,86,0,308,394,412,5414,0,25536,30950,16788,17,0,150,167
11885,VIZIANAGARAM,Merakamudidam,SATHAMVALASA,162,7,332,501,120,2,206,328,331,10335,105,17559,27999,16913,48,0,96,144
11886,VIZIANAGARAM,Merakamudidam,SOMALINGAPURAM,110,1,867,978,63,1,412,476,472,4126,65,32525,36716,21673,10,0,155,165
11887,VIZIANAGARAM,Merakamudidam,UTTARAVILLI,228,18,1253,1499,148,6,550,704,658,4729,307,23694,28730,17522,0,0,9,9
11888,VIZIANAGARAM,Merakamudidam,VOOTAPALLI,40,18,604,662,22,17,422,461,463,1866,1756,34255,37877,21124,10,11,173,194
11889,VIZIANAGARAM,Merakamudidam,YADIKA,75,7,324,406,67,7,276,350,385,5882,388,22372,28642,16532,34,1,110,145
11890,VIZIANAGARAM,Nellimarla,ALUGOLU,109,0,781,890,94,0,509,603,608,8325,0,36424,44749,29105,47,0,126,173
11891,VIZIANAGARAM,Nellimarla,ATMARAMUNIAGRAHARAM,1,4,341,346,0,4,269,273,280,0,350,19465,19815,13793,0,1,70,71
11892,VIZIANAGARAM,Nellimarla,BOPPADAM,106,0,537,643,85,0,410,495,487,6206,0,30401,36607,27700,24,0,102,126
11893,VIZIANAGARAM,Nellimarla,BURADAPETA,4,0,731,735,4,0,585,589,639,438,0,34524,34962,24234,4,0,60,64
11894,VIZIANAGARAM,Nellimarla,CHANDRAMPETA,34,2,461,497,26,1,355,382,379,2030,116,28322,30468,23169,6,1,107,114
11895,VIZIANAGARAM,Nellimarla,DANNANAPETA,32,1,519,552,21,1,388,410,404,1039,20,22746,23805,16613,1,0,68,69
11896,VIZIANAGARAM,Nellimarla,GARIKAPETA,4,0,408,412,3,0,326,329,322,125,0,18888,19013,13890,0,0,29,29
11897,VIZIANAGARAM,Nellimarla,GUSHINI,137,19,1051,1207,59,10,590,659,648,5111,550,37620,43281,28056,32,3,108,143
11898,VIZIANAGARAM,Nellimarla,JARAJAPUPETA,97,0,893,990,0,0,0,0,0,0,0,0,0,0,0,0,0,0
11899,VIZIANAGARAM,Nellimarla,JOGIRAJUPETA,4,0,506,510,2,0,392,394,346,115,0,34709,34824,23407,0,0,211,211
11900,VIZIANAGARAM,Nellimarla,KONDAGUMPAM,78,0,787,865,63,0,488,551,558,4805,0,38509,43314,31610,14,0,134,148
11901,VIZIANAGARAM,Nellimarla,KONDAVELAGADA,88,2,651,741,71,1,424,496,464,4876,59,24982,29917,23050,11,0,47,58
11902,VIZIANAGARAM,Nellimarla,KOTHAPETA,65,31,274,370,42,22,205,269,269,2241,1743,14045,18029,13964,6,7,43,56
11903,VIZIANAGARAM,Nellimarla,MADHUPADA,4,0,107,111,0,0,68,68,56,0,0,5738,5738,3681,0,0,30,30
11904,VIZIANAGARAM,Nellimarla,MALYADA,44,0,313,357,35,0,273,308,276,2965,0,20407,23372,15122,11,0,70,81
11905,VIZIANAGARAM,Nellimarla,MOIDA(VIJIARAMPURAM),28,1,684,713,20,1,525,546,575,1191,24,20022,21237,15181,3,0,7,10
11906,VIZIANAGARAM,Nellimarla,NELLIMARLA,73,2,1707,1782,0,0,1,1,1,0,0,131,131,131,0,0,1,1
11907,VIZIANAGARAM,Nellimarla,PARASAM,41,1,385,427,34,1,272,307,314,2618,33,18948,21599,16372,10,0,41,51
11908,VIZIANAGARAM,Nellimarla,PUTHIKAPETA,1,0,345,346,1,0,275,276,304,19,0,12648,12667,9387,0,0,12,12
11909,VIZIANAGARAM,Nellimarla,RAMATHIRTHAM,7,27,229,263,2,17,143,162,157,191,1131,9381,10703,7515,0,5,38,43
11910,VIZIANAGARAM,Nellimarla,SARIPALLI,141,74,793,1008,116,60,617,793,733,7876,3861,36536,48273,35665,26,15,84,125
11911,VIZIANAGARAM,Nellimarla,SATHIVADA,91,1,786,878,73,1,616,690,604,4176,14,49842,54032,30304,11,0,231,242
11912,VIZIANAGARAM,Nellimarla,SITARAMUNIPETA,56,5,723,784,17,1,204,222,247,201,118,12120,12439,8005,0,1,30,31
11913,VIZIANAGARAM,Nellimarla,TAMMAPURAM,15,0,302,317,13,0,220,233,234,1210,0,21008,22218,13560,7,0,116,123
11914,VIZIANAGARAM,Nellimarla,TANGUDUBILLI,25,0,441,466,16,0,309,325,318,1155,0,20988,22143,15744,3,0,54,57
11915,VIZIANAGARAM,Nellimarla,TEKKALI,8,0,228,236,5,0,182,187,170,331,0,14779,15110,12218,0,0,71,71
11916,VIZIANAGARAM,Nellimarla,VALLURU,96,0,630,726,52,0,442,494,453,4013,0,28069,32082,23602,13,0,27,40
11917,VIZIANAGARAM,Nellimarla,VOMMI,97,0,472,569,63,0,324,387,384,4430,0,25239,29669,19585,17,0,111,128
11918,VIZIANAGARAM,Pachipenta,A.GOTTURU,3,601,1,605,1,402,0,403,346,63,24817,0,24880,12511,0,89,0,89
11919,VIZIANAGARAM,Pachipenta,AJURUU,1,190,0,191,0,159,0,159,161,0,10306,0,10306,5083,0,25,0,25
11920,VIZIANAGARAM,Pachipenta,BORRAMAMIDI,1,227,0,228,0,178,0,178,112,0,8260,0,8260,3025,0,14,0,14
11921,VIZIANAGARAM,Pachipenta,G. KARRIVALASA,32,440,483,955,1,209,231,441,383,50,10070,11988,22108,12736,0,19,38,57
11922,VIZIANAGARAM,Pachipenta,GARSIGUDDI,0,170,1,171,0,162,0,162,132,0,8912,0,8912,4329,0,3,0,3
11923,VIZIANAGARAM,Pachipenta,GOTTURU,0,2,0,2,0,0,0,0,0,0,0,0,0,0,0,0,0,0
11924,VIZIANAGARAM,Pachipenta,GRUVUNAIDUPETA,84,52,393,529,58,30,278,366,384,2888,1483,14690,19061,12935,6,3,32,41
11925,VIZIANAGARAM,Pachipenta,GUMMIDIGUDA,2,244,0,246,0,224,0,224,213,0,11011,0,11011,5978,0,19,0,19
11926,VIZIANAGARAM,Pachipenta,H.GOTTURU,0,1,0,1,0,0,0,0,0,0,0,0,0,0,0,0,0,0
11927,VIZIANAGARAM,Pachipenta,KARRIVALASA,2,43,21,66,1,0,1,2,0,78,0,76,154,0,0,0,0,0
11928,VIZIANAGARAM,Pachipenta,KERANGI,0,118,0,118,0,93,0,93,69,0,3186,0,3186,1433,0,1,0,1
11929,VIZIANAGARAM,Pachipenta,KERANGI(H.A),1,123,0,124,0,83,0,83,73,0,2018,0,2018,1097,0,0,0,0
11930,VIZIANAGARAM,Pachipenta,KESALI,161,403,128,692,131,325,95,551,539,9204,19340,6017,34561,18272,29,71,18,118
11931,VIZIANAGARAM,Pachipenta,KOTIKIPENTA,161,286,726,1173,106,179,527,812,713,6063,9140,36859,52062,26814,18,13,120,151
11932,VIZIANAGARAM,Pachipenta,MATHAMURU,17,41,435,493,15,34,312,361,366,548,2192,16077,18817,12672,2,8,19,29
11933,VIZIANAGARAM,Pachipenta,MILLIAKANCHERU,1,140,0,141,1,136,0,137,165,36,9670,0,9706,5209,0,28,0,28
11934,VIZIANAGARAM,Pachipenta,MIRTHIVALASA,379,211,2486,3076,192,125,1141,1458,1270,14218,10629,75915,100762,56756,58,51,292,401
11935,VIZIANAGARAM,Pachipenta,MODUGA,1,361,3,365,0,266,0,266,274,0,12136,0,12136,5565,0,20,0,20
11936,VIZIANAGARAM,Pachipenta,MOSURU,217,131,893,1241,148,74,383,605,482,10138,6081,18980,35199,21836,35,27,26,88
11937,VIZIANAGARAM,Pachipenta,MUTHAKODU,6,406,1,413,0,340,1,341,340,0,22741,65,22806,11330,0,76,0,76
11938,VIZIANAGARAM,Pachipenta,P.KONAVALASA,111,129,318,558,74,43,140,257,223,6718,1362,8526,16606,9623,43,3,25,71
11939,VIZIANAGARAM,Pachipenta,PACHIPENTA,35,1,46,82,0,0,2,2,1,0,0,188,188,64,0,0,1,1
11940,VIZIANAGARAM,Pachipenta,PADMAPURAM,23,510,15,548,16,434,11,461,473,1552,42674,1057,45283,23627,9,268,7,284
11941,VIZIANAGARAM,Pachipenta,PANCHALI,99,137,1505,1741,38,38,701,777,705,1329,747,26427,28503,17100,0,0,19,19
11942,VIZIANAGARAM,Pachipenta,PANUKUVALASA,6,682,65,753,1,423,17,441,392,71,30646,1267,31984,21412,0,94,5,99
11943,VIZIANAGARAM,Pachipenta,PEDDAVALASA,30,226,3,259,25,206,2,233,229,2179,18098,178,20455,10756,12,103,1,116
11944,VIZIANAGARAM,Pachipenta,RAIGUDDIVALASA,6,544,2,552,2,370,0,372,338,77,14077,0,14154,7191,0,7,0,7
11945,VIZIANAGARAM,Pachipenta,SATHABI,1,210,0,211,1,152,0,153,159,29,13083,0,13112,6708,0,54,0,54
11946,VIZIANAGARAM,Pachipenta,TADURU,23,233,42,298,13,88,27,128,144,1158,4001,2754,7913,4730,6,12,16,34
11947,VIZIANAGARAM,Pachipenta,TUMARAVILLI,0,3,0,3,0,0,0,0,0,0,0,0,0,0,0,0,0,0
11948,VIZIANAGARAM,Pachipenta,VISWANADHAPURAM,91,313,283,687,56,204,198,458,466,3514,12644,11461,27619,16142,12,40,32,84
11949,VIZIANAGARAM,Parvathipuram,ADDAPUSEELA,268,112,689,1069,177,28,297,502,542,13031,2204,18977,34212,20601,41,13,91,145
11950,VIZIANAGARAM,Parvathipuram,BALAGUDABA,0,0,1,1,0,0,0,0,0,0,0,0,0,0,0,0,0,0
11951,VIZIANAGARAM,Parvathipuram,BANDALUPPI,86,81,708,875,49,53,508,610,574,4154,5040,38042,47236,25901,25,31,157,213
11952,VIZIANAGARAM,Parvathipuram,BUDURAVADA,36,699,102,837,21,525,48,594,633,1283,35261,3392,39936,19658,1,128,9,138
11953,VIZIANAGARAM,Parvathipuram,CHINABONDAPALLI,156,4,693,853,102,2,451,555,544,6048,128,24490,30666,18385,20,1,40,61
11954,VIZIANAGARAM,Parvathipuram,DOKISEELA,133,305,169,607,79,215,118,412,423,5720,15725,9943,31388,16536,19,56,52,127
11955,VIZIANAGARAM,Parvathipuram,GANGA PURAM,21,111,239,371,16,94,184,294,285,1496,8065,16294,25855,15184,8,44,89,141
11956,VIZIANAGARAM,Parvathipuram,GOCHEKKA,28,201,44,273,24,152,19,195,194,1277,9699,1042,12018,6649,1,22,1,24
11957,VIZIANAGARAM,Parvathipuram,GOPALAPURAM,93,14,271,378,57,0,198,255,277,3702,0,15202,18904,10651,5,0,33,38
11958,VIZIANAGARAM,Parvathipuram,JAMADALA,67,48,575,690,50,31,341,422,425,3635,2383,24392,30410,17125,15,6,86,107
11959,VIZIANAGARAM,Parvathipuram,JAMMIDI VALADSA,25,3,472,500,19,2,335,356,369,1241,127,24190,25558,14101,4,0,28,32
11960,VIZIANAGARAM,Parvathipuram,K. PEDAMARIKA,54,375,82,511,31,208,38,277,320,1353,6517,1475,9345,5223,1,4,1,6
11961,VIZIANAGARAM,Parvathipuram,KAVITI BHADRA,10,11,160,181,6,8,96,110,104,574,706,8562,9842,6065,5,5,71,81
11962,VIZIANAGARAM,Parvathipuram,KRISHANPALLI,131,65,346,542,104,59,264,427,477,5442,3486,15612,24540,16458,2,7,28,37
11963,VIZIANAGARAM,Parvathipuram,L. BALAGUDABA,143,21,675,839,105,18,425,548,570,9680,1765,24326,35771,22179,57,10,26,93
11964,VIZIANAGARAM,Parvathipuram,LAXMINARAYANA PURAM,25,37,507,569,10,20,348,378,392,635,1392,23469,25496,17760,0,2,39,41
11965,VIZIANAGARAM,Parvathipuram,M R NAGARAM,51,8,661,720,30,3,448,481,480,2117,183,30677,32977,19843,5,0,63,68
11966,VIZIANAGARAM,Parvathipuram,MULAGA,54,360,316,730,38,251,235,524,579,2873,19451,18427,40751,23909,14,88,73,175
11967,VIZIANAGARAM,Parvathipuram,NARSIPURAM,271,84,1527,1882,148,57,895,1100,1167,9358,4634,46209,60201,38904,22,12,51,85
11968,VIZIANAGARAM,Parvathipuram,PEDABONDA PALLI,288,126,1142,1556,227,85,804,1116,1082,18886,7552,66221,92659,53777,86,43,283,412
11969,VIZIANAGARAM,Parvathipuram,PEDAMARIKA,38,5,221,264,27,4,144,175,208,1425,305,11037,12767,8227,4,2,46,52
11970,VIZIANAGARAM,Parvathipuram,PULIGUMMI,37,17,330,384,24,14,229,267,267,1664,1172,17950,20786,11936,5,6,82,93
11971,VIZIANAGARAM,Parvathipuram,PUTTUR,81,58,425,564,68,45,313,426,432,4350,3237,21844,29431,16681,13,9,64,86
11972,VIZIANAGARAM,Parvathipuram,SANGAM VALASA,78,369,458,905,45,246,330,621,610,3941,19426,27225,50592,30044,22,89,138,249
11973,VIZIANAGARAM,Parvathipuram,SUDIGAM,52,23,483,558,38,15,383,436,487,4033,1577,34736,40346,23304,25,11,202,238
11974,VIZIANAGARAM,Parvathipuram,TAALLABURIDI,119,51,885,1055,70,30,611,711,673,3891,2226,36799,42916,25600,3,5,87,95
11975,VIZIANAGARAM,Parvathipuram,VENKAM PETA,69,0,269,338,54,0,184,238,219,3833,0,10308,14141,8214,7,0,2,9
11976,VIZIANAGARAM,Parvathipuram,VENKATARAYUDU PETA,5,8,196,209,4,6,146,156,154,391,655,13520,14566,9468,3,6,74,83
11977,VIZIANAGARAM,Pusapatirega,ALLADAPALEM,62,4,238,304,43,1,112,156,136,3404,7,9299,12710,10105,19,0,52,71
11978,VIZIANAGARAM,Pusapatirega,CHALLAVANITHOTA,8,22,901,931,3,8,537,548,551,257,682,20917,21856,15158,2,5,15,22
11979,VIZIANAGARAM,Pusapatirega,CHINTAPALLI,42,0,361,403,37,0,179,216,214,1881,0,6023,7904,6532,3,0,2,5
11980,VIZIANAGARAM,Pusapatirega,CHODAMMAAGRAHARAM,60,27,971,1058,49,15,540,604,625,3491,656,29706,33853,26060,18,0,60,78
11981,VIZIANAGARAM,Pusapatirega,CHOWDAVADA,26,3,671,700,18,3,379,400,366,1663,179,23235,25077,14704,11,0,35,46
11982,VIZIANAGARAM,Pusapatirega,GOVINDA PURAM,35,1,415,451,24,0,300,324,305,1521,0,24527,26048,17181,3,0,127,130
11983,VIZIANAGARAM,Pusapatirega,GUMPAM,36,0,838,874,28,0,469,497,490,1859,0,30177,32036,23284,5,0,90,95
11984,VIZIANAGARAM,Pusapatirega,K AGRAHAM,126,0,353,479,100,0,234,334,383,8148,0,16172,24320,18828,28,0,48,76
11985,VIZIANAGARAM,Pusapatirega,KANDIVALASA,72,0,252,324,46,0,158,204,194,2948,0,12751,15699,13545,15,0,76,91
11986,VIZIANAGARAM,Pusapatirega,KANNI METTA,46,0,299,345,33,0,229,262,263,2364,0,16098,18462,16481,7,0,50,57
11987,VIZIANAGARAM,Pusapatirega,KANNIMELLA,122,0,552,674,78,0,333,411,404,3531,0,15523,19054,14775,6,0,13,19
11988,VIZIANAGARAM,Pusapatirega,KOLLAYAVALASA,66,1,516,583,60,1,275,336,340,4855,115,17159,22129,17112,17,1,33,51
11989,VIZIANAGARAM,Pusapatirega,KONADA,14,0,622,636,10,0,360,370,383,460,0,17873,18333,16871,2,0,20,22
11990,VIZIANAGARAM,Pusapatirega,KOPERLLA,59,0,475,534,27,0,245,272,245,1282,0,8598,9880,8298,2,0,2,4
11991,VIZIANAGARAM,Pusapatirega,KUMILI,322,46,1746,2114,155,40,736,931,887,8775,2853,35746,47374,36740,9,12,34,55
11992,VIZIANAGARAM,Pusapatirega,L PALLIPALAMM,13,2,236,251,10,2,184,196,175,763,201,13726,14690,11147,1,1,33,35
11993,VIZIANAGARAM,Pusapatirega,NADIPALLI,52,1,172,225,38,0,108,146,133,2180,0,7750,9930,7840,5,0,13,18
11994,VIZIANAGARAM,Pusapatirega,PASUPAM,26,7,303,336,22,7,193,222,240,2129,237,11760,14126,9926,13,0,35,48
11995,VIZIANAGARAM,Pusapatirega,PATTIVADA,31,0,852,883,24,0,626,650,712,1206,0,25938,27144,19239,0,0,20,20
11996,VIZIANAGARAM,Pusapatirega,PERAPURAM,50,2,414,466,34,1,325,360,362,2840,17,17173,20030,15555,14,0,17,31
11997,VIZIANAGARAM,Pusapatirega,PUSAPATIPALEM,25,0,168,193,20,0,106,126,131,1625,0,4146,5771,4825,4,0,1,5
11998,VIZIANAGARAM,Pusapatirega,PUSAPATIREGA,222,1,1449,1672,162,0,686,848,824,14205,0,51195,65400,45823,72,0,159,231
11999,VIZIANAGARAM,Pusapatirega,RELLI VALASA,230,0,1160,1390,136,0,605,741,766,6148,0,7540,13688,11035,6,0,0,6
12000,VIZIANAGARAM,Pusapatirega,TIPPALAVALASA,0,0,571,571,0,0,99,99,104,0,0,2642,2642,2598,0,0,0,0
12001,VIZIANAGARAM,Pusapatirega,VELDURU,7,1,580,588,4,0,387,391,424,326,0,22276,22602,19075,2,0,30,32
12002,VIZIANAGARAM,Pusapatirega,VEMPADAM,82,2,1074,1158,58,2,755,815,858,2430,55,42939,45424,27042,0,0,35,35
12003,VIZIANAGARAM,Pusapatirega,YERUKONDA,80,0,477,557,58,0,275,333,293,4102,0,12039,16141,11336,8,0,5,13
12004,VIZIANAGARAM,Ramabhadrapuram,ARIKITHOTA,233,2,637,872,162,2,333,497,440,13323,170,21197,34690,21648,81,1,65,147
12005,VIZIANAGARAM,Ramabhadrapuram,BUSAYAVALASA,3,26,452,481,1,19,253,273,255,10,1910,15844,17764,12931,0,14,34,48
12006,VIZIANAGARAM,Ramabhadrapuram,DUPPALAPUDI,37,77,144,258,26,57,109,192,188,2280,3971,9188,15439,9529,11,11,43,65
12007,VIZIANAGARAM,Ramabhadrapuram,GOLLAPETA,41,91,289,421,32,71,259,362,389,3148,6742,24573,34463,19366,19,43,153,215
12008,VIZIANAGARAM,Ramabhadrapuram,ITLAMAMIDIPALLI,20,1,308,329,18,0,246,264,250,1259,0,16647,17906,10185,9,0,69,78
12009,VIZIANAGARAM,Ramabhadrapuram,JANNIVALASA,0,164,297,461,0,61,232,293,288,0,2729,16922,19651,10274,0,8,36,44
12010,VIZIANAGARAM,Ramabhadrapuram,KONDAKENGUVA,29,135,423,587,14,94,278,386,370,725,3916,20152,24793,14072,1,14,69,84
12011,VIZIANAGARAM,Ramabhadrapuram,KOTASIRLAM,115,45,492,652,65,27,274,366,340,5530,1991,20967,28488,15548,35,11,109,155
12012,VIZIANAGARAM,Ramabhadrapuram,KOTHAREGA,0,21,292,313,0,16,220,236,220,0,1592,15424,17016,9819,0,11,54,65
12013,VIZIANAGARAM,Ramabhadrapuram,KOTTAKKI,229,73,871,1173,120,35,499,654,660,6335,1812,29455,37602,23704,16,7,71,94
12014,VIZIANAGARAM,Ramabhadrapuram,MAMIDIVALASA,2,0,263,265,1,0,195,196,200,57,0,10429,10486,6556,0,0,12,12
12015,VIZIANAGARAM,Ramabhadrapuram,MIRTHIVALASA,1,15,410,426,0,7,294,301,321,0,215,17742,17957,10804,0,0,40,40
12016,VIZIANAGARAM,Ramabhadrapuram,MUTCHERLAVALASA,50,0,334,384,27,0,216,243,224,2044,0,14643,16687,11117,9,0,49,58
12017,VIZIANAGARAM,Ramabhadrapuram,NAIDUVALASA,41,34,515,590,33,26,349,408,401,1278,1344,18720,21342,11756,0,0,34,34
12018,VIZIANAGARAM,Ramabhadrapuram,NARASAPURAM,19,6,169,194,16,6,135,157,158,1429,463,10454,12346,8088,6,1,37,44
12019,VIZIANAGARAM,Ramabhadrapuram,PARTHAREGA,65,13,280,358,45,6,191,242,254,3626,368,9896,13890,9057,17,2,16,35
12020,VIZIANAGARAM,Ramabhadrapuram,RAMABHADRAPURAM,140,9,977,1126,61,2,506,569,475,3958,113,34419,38490,26426,15,0,95,110
12021,VIZIANAGARAM,Ramabhadrapuram,RAVIVALASA,19,382,4,405,0,36,0,36,21,0,582,0,582,204,0,0,0,0
12022,VIZIANAGARAM,Ramabhadrapuram,ROMPALLI,139,15,553,707,73,6,308,387,408,5473,426,16788,22687,14609,25,2,21,48
12023,VIZIANAGARAM,Ramabhadrapuram,SITHARAMAPURAM,91,3,231,325,59,1,147,207,222,4346,74,10019,14439,8658,20,0,31,51
12024,VIZIANAGARAM,Ramabhadrapuram,SOMPURAM,11,7,415,433,5,4,184,193,153,140,77,7752,7969,4055,0,0,11,11
12025,VIZIANAGARAM,Ramabhadrapuram,THARAPURAM,91,0,529,620,55,0,353,408,400,5135,0,32341,37476,22956,29,0,186,215
12026,VIZIANAGARAM,Salur,ANNAMARAJUVALASA,15,403,67,485,7,229,24,260,277,261,12608,1421,14290,8093,0,41,4,45
12027,VIZIANAGARAM,Salur,DEENSARAI,1,95,0,96,0,74,0,74,69,0,3303,0,3303,1206,0,1,0,1
12028,VIZIANAGARAM,Salur,GANJAIBHADRA,4,406,0,410,0,221,0,221,199,0,10905,0,10905,5139,0,15,0,15
12029,VIZIANAGARAM,Salur,JEEGIRAM,189,11,146,346,119,3,17,139,134,6274,124,672,7070,5437,6,0,0,6
12030,VIZIANAGARAM,Salur,JILLEDUVALASA,0,162,0,162,0,151,0,151,124,0,10741,0,10741,4479,0,37,0,37
12031,VIZIANAGARAM,Salur,KANDULAPADAM,106,427,127,660,61,288,63,412,350,5021,20788,4212,30021,17464,20,64,10,94
12032,VIZIANAGARAM,Salur,KARADAVALASA,1,107,0,108,0,92,0,92,87,0,8917,0,8917,3148,0,53,0,53
12033,VIZIANAGARAM,Salur,KARASUVALASA,125,592,61,778,64,388,11,463,414,4733,29287,348,34368,21357,18,112,0,130
12034,VIZIANAGARAM,Salur,KODAMA,21,804,0,825,8,502,0,510,513,504,30170,0,30674,13743,1,105,0,106
12035,VIZIANAGARAM,Salur,KOTHAVALASA,16,559,35,610,6,259,4,269,248,309,12963,342,13614,7568,0,21,2,23
12036,VIZIANAGARAM,Salur,KOTTIPARUVA,23,348,11,382,12,194,4,210,159,610,10455,103,11168,5378,1,21,0,22
12037,VIZIANAGARAM,Salur,KURMARAJUPETA,99,247,508,854,67,103,360,530,502,4333,4802,22264,31399,20149,16,17,61,94
12038,VIZIANAGARAM,Salur,KURUKUTTI,115,1021,78,1214,63,634,48,745,594,5462,39154,3196,47812,22265,31,107,8,146
12039,VIZIANAGARAM,Salur,MAMIDIPALLI,202,145,949,1296,78,73,492,643,615,6253,6398,37281,49932,33764,36,33,166,235
12040,VIZIANAGARAM,Salur,MARRIPALLI,31,376,263,670,20,294,199,513,457,814,12870,10897,24581,13858,0,16,10,26
12041,VIZIANAGARAM,Salur,MAVUDI,19,336,23,378,13,183,5,201,118,297,9038,307,9642,3383,0,11,0,11
12042,VIZIANAGARAM,Salur,NARLAVALASA,3,507,4,514,1,242,2,245,238,42,14550,215,14807,6942,0,50,1,51
12043,VIZIANAGARAM,Salur,NELLIPARTHI,242,61,163,466,191,24,79,294,303,11642,339,3830,15811,9947,25,0,3,28
12044,VIZIANAGARAM,Salur,PAGULACHENNURU,3,223,0,226,2,206,0,208,154,149,18587,0,18736,7394,0,92,0,92
12045,VIZIANAGARAM,Salur,PARANNAVALASA,55,14,310,379,47,11,250,308,269,4550,1057,23754,29361,15009,26,6,134,166
12046,VIZIANAGARAM,Salur,PATTUCHENNURU,3,377,0,380,3,221,0,224,209,42,11393,0,11435,5989,0,23,0,23
12047,VIZIANAGARAM,Salur,PEDABORABANDA,100,103,918,1121,82,93,739,914,836,7082,7691,67697,82470,44945,33,35,373,441
12048,VIZIANAGARAM,Salur,PEDDAPADAM,293,267,455,1015,219,202,290,711,676,19635,13325,22477,55437,31838,112,44,92,248
12049,VIZIANAGARAM,Salur,PUROHITHUNIVALASA,56,60,357,473,32,41,269,342,357,1944,3228,19189,24361,15198,8,13,74,95
12050,VIZIANAGARAM,Salur,SAMPANGIPADU,1,231,0,232,0,168,0,168,154,0,11987,0,11987,6186,0,61,0,61
12051,VIZIANAGARAM,Salur,SARIKA,22,418,19,459,2,184,0,186,169,123,8731,0,8854,4561,1,22,0,23
12052,VIZIANAGARAM,Salur,SIVARAMAPURAM,54,2,614,670,40,1,466,507,476,3433,27,31853,35313,24340,17,0,90,107
12053,VIZIANAGARAM,Salur,THONAM,57,752,57,866,27,450,14,491,404,1536,25575,734,27845,12881,9,83,2,94
12054,VIZIANAGARAM,Salur,THONDA,25,562,28,615,10,344,4,358,286,575,21348,136,22059,10573,2,71,0,73
12055,VIZIANAGARAM,Seethanagaram,ANTIPETA,151,2,679,832,107,1,514,622,590,8961,102,42179,51242,29567,45,1,197,243
12056,VIZIANAGARAM,Seethanagaram,B.KRISHNAPURAM,23,0,377,400,19,0,277,296,281,1385,0,15755,17140,9902,6,0,11,17
12057,VIZIANAGARAM,Seethanagaram,BAGGAMDORAVALASA,31,15,300,346,20,14,244,278,286,1505,1169,12483,15157,8195,7,3,7,17
12058,VIZIANAGARAM,Seethanagaram,BAKKUPETA,24,57,210,291,17,46,156,219,199,1197,3799,10488,15484,8080,2,22,19,43
12059,VIZIANAGARAM,Seethanagaram,BURJA,227,20,766,1013,161,11,544,716,703,11568,411,26795,38774,23403,21,0,19,40
12060,VIZIANAGARAM,Seethanagaram,CHALLAMNAIDUVALASA,0,0,279,279,0,0,208,208,212,0,0,15364,15364,8412,0,0,58,58
12061,VIZIANAGARAM,Seethanagaram,CHINABOGILA,237,0,541,778,175,0,349,524,499,10120,0,15971,26091,16401,24,0,9,33
12062,VIZIANAGARAM,Seethanagaram,CHINAKALAM,4,0,176,180,4,0,147,151,151,335,0,11463,11798,7103,1,0,55,56
12063,VIZIANAGARAM,Seethanagaram,DAYANIDHIPURAM,6,0,437,443,5,0,347,352,346,359,0,24284,24643,13592,0,0,67,67
12064,VIZIANAGARAM,Seethanagaram,GEDALAVALASA,45,16,488,549,34,14,321,369,363,2797,1165,25022,28984,17066,16,6,95,117
12065,VIZIANAGARAM,Seethanagaram,GEDDALUPPPI,90,10,475,575,58,10,310,378,343,4696,650,18214,23560,12798,23,2,13,38
12066,VIZIANAGARAM,Seethanagaram,GUTCHIMI,107,8,523,638,84,6,339,429,406,5014,442,24088,29544,18544,14,1,88,103
12067,VIZIANAGARAM,Seethanagaram,IPPALAVALASA,50,0,314,364,26,0,214,240,230,1503,0,12800,14303,8948,2,0,19,21
12068,VIZIANAGARAM,Seethanagaram,JANUMULLAVALASA,22,3,517,542,16,2,404,422,408,1226,116,25722,27064,15000,5,1,25,31
12069,VIZIANAGARAM,Seethanagaram,JOGIMPETA,60,0,393,453,42,0,302,344,304,2713,0,21722,24435,13231,10,0,68,78
12070,VIZIANAGARAM,Seethanagaram,K.SEETHARAMPURAM,25,0,424,449,22,0,298,320,291,1718,0,22152,23870,13269,9,0,95,104
12071,VIZIANAGARAM,Seethanagaram,KHASAPETA,131,0,302,433,106,0,223,329,316,8869,0,17295,26164,14334,44,0,60,104
12072,VIZIANAGARAM,Seethanagaram,KOTHAVALASA,3,13,200,216,1,12,171,184,179,40,941,10502,11483,6174,0,3,11,14
12073,VIZIANAGARAM,Seethanagaram,KRISHNARAYAPURAM,0,0,525,525,0,0,408,408,386,0,0,35198,35198,20128,0,0,191,191
12074,VIZIANAGARAM,Seethanagaram,LACHAYYAPETA,144,0,495,639,113,0,363,476,458,9151,0,27509,36660,21364,49,0,66,115
12075,VIZIANAGARAM,Seethanagaram,LAKSHMIPURAM,5,2,710,717,2,2,512,516,531,48,167,14904,15119,8585,0,0,12,12
12076,VIZIANAGARAM,Seethanagaram,NIDAGALLU,206,26,1049,1281,123,19,664,806,754,7097,1245,37494,45836,24214,22,5,61,88
12077,VIZIANAGARAM,Seethanagaram,PANUKUPETA,68,0,283,351,53,0,226,279,248,4719,0,15897,20616,11663,25,0,36,61
12078,VIZIANAGARAM,Seethanagaram,PAPAMMAVALASA,21,8,200,229,15,6,139,160,157,987,546,9173,10706,6950,3,3,14,20
12079,VIZIANAGARAM,Seethanagaram,PEDABHOGILA,448,26,1278,1752,318,20,806,1144,1233,15827,1218,39304,56349,35854,20,3,33,56
12080,VIZIANAGARAM,Seethanagaram,PEDANKALAM,61,7,366,434,47,7,252,306,270,2582,258,12908,15748,8394,4,0,7,11
12081,VIZIANAGARAM,Seethanagaram,R.VENKAMPETA,24,49,409,482,17,44,350,411,402,1119,2820,22623,26562,15984,2,6,34,42
12082,VIZIANAGARAM,Seethanagaram,RAMAVARAM,41,0,420,461,32,0,331,363,375,2581,0,25722,28303,17896,11,0,105,116
12083,VIZIANAGARAM,Seethanagaram,RANGAMPETA,36,0,362,398,28,0,304,332,274,1885,0,23588,25473,14245,6,0,89,95
12084,VIZIANAGARAM,Seethanagaram,SEETHARAMPURAM,14,24,63,101,9,21,47,77,76,901,1753,4104,6758,3743,6,8,18,32
12085,VIZIANAGARAM,Seethanagaram,SUMITRA PURAM~,28,1,284,313,25,1,187,213,201,1986,91,11349,13426,7243,11,0,9,20
12086,VIZIANAGARAM,Seethanagaram,SURAMPETA,95,98,519,712,72,78,342,492,455,5249,6630,25180,37059,21448,21,33,102,156
12087,VIZIANAGARAM,Seethanagaram,THAMARAKANDI,60,35,725,820,47,26,453,526,483,2909,1792,21934,26635,14973,6,4,2,12
12088,VIZIANAGARAM,Seethanagaram,VENKATAPURAM,29,0,371,400,24,0,283,307,264,1512,0,18502,20014,9816,0,0,49,49
12089,VIZIANAGARAM,Srungavarapukota,ALUGUBILLI,91,1,363,455,65,1,267,333,291,5301,97,21156,26554,14400,25,0,105,130
12090,VIZIANAGARAM,Srungavarapukota,CHAMALAPALLI,2,1,257,260,2,1,206,209,209,187,88,17863,18138,11446,1,0,89,90
12091,VIZIANAGARAM,Srungavarapukota,DARAPARTHI,1,339,0,340,0,172,0,172,166,0,9204,0,9204,4111,0,13,0,13
12092,VIZIANAGARAM,Srungavarapukota,DHARMAVARAM,246,14,1194,1454,150,9,530,689,701,11866,600,40712,53178,32860,58,1,179,238
12093,VIZIANAGARAM,Srungavarapukota,GOPALAPALLI,40,3,295,338,24,3,207,234,204,1693,218,15168,17079,9519,4,1,62,67
12094,VIZIANAGARAM,Srungavarapukota,KILTHAMPALEM,73,281,993,1347,39,157,427,623,565,2778,9618,25775,38171,22561,13,24,76,113
12095,VIZIANAGARAM,Srungavarapukota,KOTHURU,64,3,314,381,53,2,236,291,297,4716,91,19531,24338,14996,29,0,98,127
12096,VIZIANAGARAM,Srungavarapukota,KOTTAM,85,1,602,688,67,1,366,434,380,5676,47,23395,29118,16952,30,0,66,96
12097,VIZIANAGARAM,Srungavarapukota,KRISHNAPURAM,45,3,293,341,33,3,201,237,240,2414,172,15159,17745,13347,10,1,53,64
12098,VIZIANAGARAM,Srungavarapukota,MAMIDIPALLI,33,0,316,349,25,0,220,245,253,1900,0,18804,20704,13067,9,0,102,111
12099,VIZIANAGARAM,Srungavarapukota,MULABODDAVARA,33,621,260,914,9,224,34,267,193,537,8912,1105,10554,5570,1,14,1,16
12100,VIZIANAGARAM,Srungavarapukota,MUSIDIPALLI,35,192,102,329,17,132,64,213,193,917,10366,5016,16299,9265,5,61,28,94
12101,VIZIANAGARAM,Srungavarapukota,PEDAKHANDEPALLI,76,2,858,936,53,1,413,467,394,2289,118,16929,19336,12205,5,1,26,32
12102,VIZIANAGARAM,Srungavarapukota,POTHANAPALLI,37,32,223,292,23,20,147,190,181,1435,896,9428,11759,8299,3,2,24,29
12103,VIZIANAGARAM,Srungavarapukota,RAVALLAPALEM,3,13,478,494,1,8,319,328,261,53,798,24317,25168,13220,0,5,115,120
12104,VIZIANAGARAM,Srungavarapukota,S.KOTA,205,106,3621,3932,42,63,1688,1793,1670,2393,1527,96022,99942,64994,5,0,171,176
12105,VIZIANAGARAM,Srungavarapukota,S.KOTA TALARI,36,1,906,943,29,0,496,525,516,1849,0,30108,31957,19451,3,0,47,50
12106,VIZIANAGARAM,Srungavarapukota,SANTHAGAVARAMMAPETA,56,2,412,470,39,2,240,281,280,3464,107,16318,19889,12537,21,0,55,76
12107,VIZIANAGARAM,Srungavarapukota,SEETHARAMPURAM,23,3,286,312,21,3,229,253,224,2123,224,16937,19284,10498,13,0,45,58
12108,VIZIANAGARAM,Srungavarapukota,SIVARAMRAUJUPETA,45,0,399,444,34,0,288,322,302,2415,0,22621,25036,15456,9,0,96,105
12109,VIZIANAGARAM,Srungavarapukota,TIMIDI,70,8,721,799,50,4,329,383,343,4156,410,15410,19976,11214,25,3,28,56
12110,VIZIANAGARAM,Srungavarapukota,VASI,34,0,301,335,28,0,189,217,217,2659,0,15357,18016,10201,19,0,78,97
12111,VIZIANAGARAM,Srungavarapukota,VEMULAPALLI,7,0,366,373,4,0,262,266,255,317,0,21513,21830,12113,1,0,95,96
12112,VIZIANAGARAM,Srungavarapukota,VENKATARAMANAPETA,80,47,1355,1482,49,38,923,1010,1029,4358,3710,65646,73714,41020,24,19,167,210
12113,VIZIANAGARAM,Srungavarapukota,VERANARAYANAM,107,7,393,507,76,7,249,332,308,6490,650,20185,27325,15041,31,4,90,125
12114,VIZIANAGARAM,Srungavarapukota,VINAYAKAPALLI,30,3,199,232,21,2,144,167,157,2104,191,10592,12887,7610,13,1,43,57
12115,VIZIANAGARAM,Therlam,AMITI,90,12,639,741,71,10,437,518,497,6269,687,32869,39825,21802,38,3,142,183
12116,VIZIANAGARAM,Therlam,ARASABALAGA,21,0,235,256,20,0,199,219,206,1914,0,18055,19969,11025,11,0,116,127
12117,VIZIANAGARAM,Therlam,CHEEKATIPETA,76,15,275,366,49,13,180,242,178,3421,818,11045,15284,8145,6,2,8,16
12118,VIZIANAGARAM,Therlam,CHINNAYYAPETA,10,2,633,645,5,2,402,409,371,445,174,31198,31817,15965,3,1,133,137
12119,VIZIANAGARAM,Therlam,D.GADABAVALASA,63,0,578,641,57,0,434,491,477,4007,0,31522,35529,21297,15,0,91,106
12120,VIZIANAGARAM,Therlam,GANGANNAPADU,20,24,475,519,18,21,314,353,382,1570,1303,21703,24576,14897,8,4,70,82
12121,VIZIANAGARAM,Therlam,GOLUGUVALASA,26,0,275,301,18,0,225,243,247,1703,0,16556,18259,10042,11,0,75,86
12122,VIZIANAGARAM,Therlam,GOPALAVALASA,63,4,256,323,51,4,168,223,171,3370,359,11516,15245,8663,9,3,37,49
12123,VIZIANAGARAM,Therlam,KAGAM,114,7,191,312,91,5,115,211,204,6630,382,5596,12608,6342,15,1,5,21
12124,VIZIANAGARAM,Therlam,KAVIRAYANIVALASA,4,3,452,459,3,3,279,285,302,184,233,23839,24256,12834,1,1,119,121
12125,VIZIANAGARAM,Therlam,KORATAM,84,0,614,698,52,0,384,436,424,4358,0,26897,31255,16566,21,0,80,101
12126,VIZIANAGARAM,Therlam,KUNAYAVALASA,192,30,660,882,157,18,433,608,606,12514,1168,32380,46062,24638,51,1,113,165
12127,VIZIANAGARAM,Therlam,KUSUMURU,71,12,410,493,57,8,299,364,370,3895,604,14554,19053,10053,12,1,17,30
12128,VIZIANAGARAM,Therlam,LINGAPURAM,20,0,153,173,19,0,112,131,143,1701,0,10049,11750,5749,7,0,51,58
12129,VIZIANAGARAM,Therlam,LINGAPURAM - I,12,0,180,192,8,0,134,142,138,624,0,11090,11714,5571,1,0,45,46
12130,VIZIANAGARAM,Therlam,LOCHERLA,0,0,0,0,0,0,0,0,0,0,0,0,0,0,0,0,0,0
12131,VIZIANAGARAM,Therlam,LOCHERLA(H.A),212,3,777,992,171,1,515,687,775,10715,46,25890,36651,19425,25,0,18,43
12132,VIZIANAGARAM,Therlam,M.R.AGRAHARAM,6,0,470,476,4,0,247,251,262,153,0,14299,14452,8028,0,0,25,25
12133,VIZIANAGARAM,Therlam,N.BURJAVALASA,24,0,243,267,19,0,158,177,167,1525,0,14024,15549,8734,8,0,96,104
12134,VIZIANAGARAM,Therlam,NANDABALAGA,96,90,831,1017,60,63,485,608,649,2982,2376,22147,27505,14908,9,1,17,27
12135,VIZIANAGARAM,Therlam,NANDIGAM,62,6,422,490,59,4,370,433,502,4663,173,22611,27447,16505,16,0,42,58
12136,VIZIANAGARAM,Therlam,NEMALAM,192,4,994,1190,126,2,409,537,522,9642,161,21643,31446,16977,22,0,11,33
12137,VIZIANAGARAM,Therlam,PAMULAVALASA,16,12,216,244,14,10,180,204,225,1195,822,14702,16719,9382,5,7,78,90
12138,VIZIANAGARAM,Therlam,PANUKUVALASA,56,5,501,562,40,3,366,409,367,3203,191,30925,34319,19339,9,1,151,161
12139,VIZIANAGARAM,Therlam,PERUMALI,136,0,448,584,90,0,199,289,252,6812,0,12867,19679,13177,24,0,26,50
12140,VIZIANAGARAM,Therlam,PUNUVALASA,126,9,457,592,100,8,332,440,433,7316,652,23668,31636,18699,29,4,79,112
12141,VIZIANAGARAM,Therlam,RAJAYYAPETA,5,4,333,342,3,4,222,229,212,141,298,16278,16717,9660,0,1,63,64
12142,VIZIANAGARAM,Therlam,RANGAPPAVALASA,168,45,287,500,94,34,208,336,289,5028,2597,14115,21740,11802,14,9,60,83
12143,VIZIANAGARAM,Therlam,SATHIVADA,52,1,276,329,35,1,173,209,181,2143,109,12998,15250,8687,6,1,56,63
12144,VIZIANAGARAM,Therlam,SUNDARADAA,73,11,422,506,55,9,285,349,408,2699,585,9723,13007,6808,2,0,0,2
12145,VIZIANAGARAM,Therlam,THERLAM,272,10,999,1281,166,9,466,641,769,11024,392,20917,32333,20114,23,0,32,55
12146,VIZIANAGARAM,Therlam,UDDAVOLU,402,92,868,1362,255,66,544,865,747,7299,2678,18933,28910,15159,0,2,2,4
12147,VIZIANAGARAM,Therlam,VELAGAVALASA,45,6,566,617,35,2,386,423,412,2421,24,24182,26627,13947,4,0,50,54
12148,VIZIANAGARAM,Therlam,VIJAYARAMAPURAM,74,21,795,890,51,18,504,573,570,3560,1368,35544,40472,21876,15,7,125,147
12149,VIZIANAGARAM,Vepada,AKULASEETHAMMAPETA,12,0,223,235,8,0,170,178,146,474,0,11937,12411,7180,1,0,41,42
12150,VIZIANAGARAM,Vepada,ARIGIPALAEM,48,0,214,262,27,0,138,165,142,1089,0,5670,6759,4499,0,0,2,2
12151,VIZIANAGARAM,Vepada,ATHAVA,75,1,365,441,56,1,244,301,243,3171,53,12801,16025,9403,7,0,7,14
12152,VIZIANAGARAM,Vepada,BALLANKI,128,2,385,515,100,1,329,430,382,7229,18,27158,34405,19558,31,0,116,147
12153,VIZIANAGARAM,Vepada,BANADHI,71,0,689,760,62,0,582,644,628,4682,0,44961,49643,25567,19,0,181,200
12154,VIZIANAGARAM,Vepada,BODDAM,33,0,851,884,16,0,468,484,453,1197,0,23648,24845,17670,6,0,26,32
12155,VIZIANAGARAM,Vepada,CHAMALAPALLI,31,72,162,265,20,67,106,193,176,1629,4750,8169,14548,8506,9,15,35,59
12156,VIZIANAGARAM,Vepada,CHINAGUDIPALA,1,0,397,398,0,0,245,245,213,0,0,14540,14540,9224,0,0,17,17
12157,VIZIANAGARAM,Vepada,DABIIRAJUPETA,33,4,383,420,29,2,287,318,282,1701,80,19310,21091,12740,5,0,41,46
12158,VIZIANAGARAM,Vepada,GUDIVADA,71,0,235,306,51,0,130,181,160,3392,0,9640,13032,8561,12,0,47,59
12159,VIZIANAGARAM,Vepada,JAGGAYYAPETA,7,0,227,234,5,0,166,171,164,417,0,12575,12992,8227,2,0,51,53
12160,VIZIANAGARAM,Vepada,JAKERU,49,0,299,348,27,0,195,222,223,1867,0,13771,15638,11710,3,0,37,40
12161,VIZIANAGARAM,Vepada,KARAKAVALASA,29,110,150,289,21,32,115,168,151,1846,3083,10566,15495,9157,10,22,58,90
12162,VIZIANAGARAM,Vepada,KONDAGANGUPUDI,43,308,456,807,27,229,227,483,444,1679,16343,17313,35335,18355,1,56,77,134
12163,VIZIANAGARAM,Vepada,KRISHNARAYUDUPETA,32,0,541,573,17,0,388,405,387,1448,0,34756,36204,20618,7,0,184,191
12164,VIZIANAGARAM,Vepada,KUMPALLI,40,4,581,625,24,3,424,451,423,1174,177,30249,31600,18222,0,0,95,95
12165,VIZIANAGARAM,Vepada,MUKUNDAPURAM,1,0,277,278,0,0,180,180,163,0,0,11326,11326,7399,0,0,23,23
12166,VIZIANAGARAM,Vepada,NALLABILLI,53,0,498,551,31,0,292,323,280,2120,0,17500,19620,11876,9,0,34,43
12167,VIZIANAGARAM,Vepada,NELLAKANTARAJAPURAM,102,22,646,770,57,10,381,448,400,4862,440,26580,31882,19007,26,0,89,115
12168,VIZIANAGARAM,Vepada,OBALAYYAPALEM,18,52,264,334,8,21,136,165,159,348,1277,8381,10006,6968,1,3,20,24
12169,VIZIANAGARAM,Vepada,PATURU,10,0,452,462,6,0,217,223,206,498,0,11124,11622,9581,3,0,2,5
12170,VIZIANAGARAM,Vepada,PEDAKRISHNARAJAPURAM,27,34,186,247,18,24,121,163,137,1194,2008,8127,11329,5416,4,9,31,44
12171,VIZIANAGARAM,Vepada,RAMASWAMYPETA,32,0,261,293,19,0,176,195,186,1640,0,12393,14033,10872,12,0,38,50
12172,VIZIANAGARAM,Vepada,SINGARAI,56,0,376,432,36,0,275,311,241,2884,0,19478,22362,12436,15,0,53,68
12173,VIZIANAGARAM,Vepada,SOMUPURAM,31,48,497,576,14,25,322,361,319,935,1548,20260,22743,14449,2,4,48,54
12174,VIZIANAGARAM,Vepada,VALLAMPUDI,71,5,594,670,44,1,330,375,334,915,25,19179,20119,11642,0,0,40,40
12175,VIZIANAGARAM,Vepada,VAVILAPADU,32,43,638,713,20,36,321,377,325,1254,2188,21934,25376,16370,3,1,53,57
12176,VIZIANAGARAM,Vepada,VEELUPARTHI,75,110,617,802,49,82,431,562,537,3892,4892,30421,39205,23479,17,8,123,148
12177,VIZIANAGARAM,Vepada,VEPADA,107,1,681,789,61,1,401,463,409,3702,93,27091,30886,20072,7,0,73,80
12178,VIZIANAGARAM,Vizianagaram,AYYANNAPETA,80,0,257,337,0,0,0,0,0,0,0,0,0,0,0,0,0,0
12179,VIZIANAGARAM,Vizianagaram,BIYYALAPETA,2,0,610,612,0,0,400,400,404,0,0,18998,18998,16034,0,0,7,7
12180,VIZIANAGARAM,Vizianagaram,CHELIVURU,0,0,829,829,0,0,688,688,620,0,0,57098,57098,40138,0,0,167,167
12181,VIZIANAGARAM,Vizianagaram,DHARAMAPURI,42,0,840,882,0,0,0,0,0,0,0,0,0,0,0,0,0,0
12182,VIZIANAGARAM,Vizianagaram,DUPPADA,17,0,779,796,5,0,532,537,511,224,0,30918,31142,27051,0,0,39,39
12183,VIZIANAGARAM,Vizianagaram,DWARAPUDI,80,0,610,690,65,0,454,519,494,5206,0,42344,47550,41765,35,0,295,330
12184,VIZIANAGARAM,Vizianagaram,GOLLALAPETA,90,1,825,916,56,1,508,565,531,3112,57,30994,34163,24249,3,0,28,31
12185,VIZIANAGARAM,Vizianagaram,GUNKALAM,58,2,1321,1381,37,0,864,901,858,2772,0,68219,70991,59913,7,0,121,128
12186,VIZIANAGARAM,Vizianagaram,J.N.PURAM,19,0,184,203,0,0,19,19,15,0,0,678,678,528,0,0,0,0
12187,VIZIANAGARAM,Vizianagaram,JONNAVALASA,73,4,635,712,49,4,410,463,421,2396,156,22737,25289,21574,1,0,13,14
12188,VIZIANAGARAM,Vizianagaram,KONDAKARAKAM,35,123,836,994,9,51,483,543,557,111,1092,18818,20021,18818,0,0,3,3
12189,VIZIANAGARAM,Vizianagaram,KORUKONDA,115,0,754,869,83,0,457,540,462,7105,0,33904,41009,24346,36,0,63,99
12190,VIZIANAGARAM,Vizianagaram,KORUKONDAPALEM,3,0,357,360,1,0,294,295,276,75,0,23874,23949,16259,0,0,124,124
12191,VIZIANAGARAM,Vizianagaram,MALICHERLA,129,0,472,601,107,0,423,530,501,8566,0,32568,41134,29074,31,0,111,142
12192,VIZIANAGARAM,Vizianagaram,NARAYANAPURAM,0,0,438,438,0,0,314,314,278,0,0,23321,23321,19753,0,0,8,8
12193,VIZIANAGARAM,Vizianagaram,PINAVEMALI,32,0,260,292,21,0,194,215,189,1379,0,14536,15915,11456,2,0,40,42
12194,VIZIANAGARAM,Vizianagaram,RAKODU,84,2,472,558,68,2,392,462,455,5336,177,26564,32077,20055,19,1,26,46
12195,VIZIANAGARAM,Vizianagaram,SARIKA,72,1,544,617,59,1,335,395,359,4022,14,26226,30262,24458,7,0,75,82
12196,WEST GODAVARI,Achanta,ACHANTA,757,7,1914,2678,53,1,358,412,391,483,12,3620,4115,3283,0,0,0,0
12197,WEST GODAVARI,Achanta,ACHANTA VEMAVARAM,403,9,1148,1560,136,3,495,634,575,1384,28,6560,7972,5327,0,0,0,0
12198,WEST GODAVARI,Achanta,AYODHYA LANKA,416,0,634,1050,143,0,127,270,192,1366,0,1833,3199,1524,0,0,0,0
12199,WEST GODAVARI,Achanta,BHIMALAPURAM,58,2,287,347,30,2,141,173,159,165,20,1548,1733,1084,0,0,0,0
12200,WEST GODAVARI,Achanta,KANDARAVALLI,71,3,150,224,13,0,14,27,24,19,0,51,70,36,0,0,0,0
12201,WEST GODAVARI,Achanta,KARUGORUMILLI,347,12,267,626,127,2,55,184,127,1554,14,357,1925,976,0,0,0,0
12202,WEST GODAVARI,Achanta,KODAMANCHILI,681,3,465,1149,270,1,172,443,362,4743,12,3065,7820,4832,1,0,0,1
12203,WEST GODAVARI,Achanta,KODERU,110,1,329,440,71,0,154,225,209,2021,0,2436,4457,2893,0,0,0,0
12204,WEST GODAVARI,Achanta,PEDAMALLAM,534,1,254,789,359,0,86,445,279,8119,0,1466,9585,3989,0,0,0,0
12205,WEST GODAVARI,Achanta,PENUMANCHILI,473,6,418,897,218,1,183,402,348,3044,2,2722,5768,3522,0,0,0,0
12206,WEST GODAVARI,Achanta,SESHAMMA CHERUVU,79,0,277,356,44,0,149,193,166,342,0,1394,1736,972,0,0,0,0
12207,WEST GODAVARI,Achanta,VALLURU,634,11,1254,1899,240,3,499,742,638,3064,33,5349,8446,4496,0,0,0,0
12208,WEST GODAVARI,Akiveedu,A.I.BHEEMAVARAM,143,0,345,488,1,0,127,128,119,7,0,1182,1189,981,0,0,0,0
12209,WEST GODAVARI,Akiveedu,AJJAMURU,88,0,194,282,0,0,0,0,0,0,0,0,0,0,0,0,0,0
12210,WEST GODAVARI,Akiveedu,AKIVEEDU,325,96,3153,3574,3,0,203,206,187,38,0,1450,1488,974,0,0,0,0
12211,WEST GODAVARI,Akiveedu,APPARAOPETA,74,0,352,426,42,0,166,208,165,1176,0,5542,6718,3652,0,0,11,11
12212,WEST GODAVARI,Akiveedu,CHERUKUMILLI,194,1,785,980,5,0,10,15,9,49,0,137,186,72,0,0,0,0
12213,WEST GODAVARI,Akiveedu,CHINAKAPAVARAM,59,0,636,695,39,0,181,220,151,884,0,3784,4668,2187,0,0,0,0
12214,WEST GODAVARI,Akiveedu,CHINAMILLIPADU,165,0,598,763,3,0,7,10,9,60,0,110,170,64,0,0,0,0
12215,WEST GODAVARI,Akiveedu,DUMPAGADAPA,72,1,822,895,0,0,0,0,0,0,0,0,0,0,0,0,0,0
12216,WEST GODAVARI,Akiveedu,GIMMULURU,68,8,626,702,10,1,177,188,35,226,23,3543,3792,552,0,0,0,0
12217,WEST GODAVARI,Akiveedu,KOLLAPARRU,22,0,516,538,0,0,6,6,2,0,0,48,48,14,0,0,0,0
12218,WEST GODAVARI,Akiveedu,KUPPANAPUDI,149,0,577,726,0,0,16,16,4,0,0,172,172,22,0,0,0,0
12219,WEST GODAVARI,Akiveedu,MANDAPADU,2,0,347,349,0,0,6,6,3,0,0,36,36,13,0,0,0,0
12220,WEST GODAVARI,Akiveedu,PEDAKAPAVARAM,89,3,1037,1129,0,0,67,67,45,0,0,543,543,281,0,0,0,0
12221,WEST GODAVARI,Akiveedu,RAJULAPET,16,0,132,148,0,0,0,0,0,0,0,0,0,0,0,0,0,0
12222,WEST GODAVARI,Akiveedu,SIDDAPURAM,150,0,614,764,1,0,33,34,26,19,0,335,354,192,0,0,0,0
12223,WEST GODAVARI,Akiveedu,TARATAVAU,19,2,164,185,3,0,12,15,13,25,0,61,86,62,0,0,0,0
12224,WEST GODAVARI,Attili,ARAVALLI,125,2,304,431,25,1,1,27,25,235,20,10,265,177,0,0,0,0
12225,WEST GODAVARI,Attili,ATTILI,355,48,1984,2387,10,1,259,270,184,149,67,5239,5455,2690,0,0,0,0
12226,WEST GODAVARI,Attili,BALLIPADU,116,1,490,607,63,0,227,290,109,1528,0,4627,6155,2269,0,0,0,0
12227,WEST GODAVARI,Attili,DANTHUPALLE,6,0,236,242,3,0,122,125,119,29,0,1224,1253,887,0,0,0,0
12228,WEST GODAVARI,Attili,EDURU,194,3,401,598,116,1,127,244,155,1678,17,1473,3168,1349,0,0,0,0
12229,WEST GODAVARI,Attili,GUMMAMPADU,171,2,205,378,11,0,60,71,62,54,0,1492,1546,1060,0,0,0,0
12230,WEST GODAVARI,Attili,K.SAMUDRAPUGATTU,99,0,314,413,8,0,48,56,53,69,0,390,459,277,0,0,0,0
12231,WEST GODAVARI,Attili,KANCHUMARRU,170,0,307,477,58,0,139,197,164,2412,0,4380,6792,3559,6,0,1,7
12232,WEST GODAVARI,Attili,KOMMARA,274,8,242,524,79,1,29,109,88,828,28,441,1297,744,0,0,0,0
12233,WEST GODAVARI,Attili,LAKSHMINARAYANAPURAM,57,2,688,747,0,0,18,18,15,0,0,138,138,78,0,0,0,0
12234,WEST GODAVARI,Attili,MANCHILI,315,18,594,927,166,0,139,305,234,4404,0,3784,8188,4461,3,0,2,5
12235,WEST GODAVARI,Attili,PALI,56,1,269,326,12,0,22,34,32,150,0,147,297,216,0,0,0,0
12236,WEST GODAVARI,Attili,PALURU,260,22,328,610,118,8,154,280,207,2092,84,2429,4605,2094,0,0,0,0
12237,WEST GODAVARI,Attili,SKINNERAPURAM,182,3,344,529,16,0,1,17,5,73,0,1,74,17,0,0,0,0
12238,WEST GODAVARI,Attili,TIRUPATIPURAM,49,4,700,753,0,0,0,0,0,0,0,0,0,0,0,0,0,0
12239,WEST GODAVARI,Attili,UNIKILI,266,0,230,496,44,0,0,44,29,328,0,0,328,119,0,0,0,0
12240,WEST GODAVARI,Attili,VARIGHEDU,149,3,609,761,72,0,258,330,213,1737,0,3930,5667,2250,0,0,0,0
12241,WEST GODAVARI,Attili,VURADALLAPALEM,166,1,404,571,6,0,19,25,4,77,0,464,541,44,0,0,0,0
12242,WEST GODAVARI,Bheemavaram,ANAKADERU,55,1,672,728,31,1,156,188,137,597,6,2803,3406,1660,0,0,0,0
12243,WEST GODAVARI,Bheemavaram,ANNAVARAM,32,4,617,653,1,0,46,47,34,5,0,304,309,179,0,0,0,0
12244,WEST GODAVARI,Bheemavaram,BETHAPUDI,219,3,713,935,51,1,219,271,21,1234,9,5043,6286,421,1,0,1,2
12245,WEST GODAVARI,Bheemavaram,CHINAMIRAM,79,0,892,971,4,0,126,130,111,108,0,3850,3958,3024,0,0,2,2
12246,WEST GODAVARI,Bheemavaram,DEYYALATIPPA,100,1,449,550,4,0,58,62,62,80,0,1498,1578,766,0,0,1,1
12247,WEST GODAVARI,Bheemavaram,DIRUSUMARRU,348,18,1778,2144,7,1,331,339,285,178,8,8378,8564,4708,0,0,0,0
12248,WEST GODAVARI,Bheemavaram,DONGAPINDI,1,1,651,653,0,0,15,15,12,0,0,294,294,100,0,0,0,0
12249,WEST GODAVARI,Bheemavaram,GOLLAVANITIPPA,311,8,1341,1660,0,0,35,35,9,0,0,358,358,82,0,0,0,0
12250,WEST GODAVARI,Bheemavaram,GUTLAPADU,96,1,538,635,0,0,0,0,0,0,0,0,0,0,0,0,0,0
12251,WEST GODAVARI,Bheemavaram,JONNALAGARUVU,157,3,81,241,40,1,30,71,38,837,2,584,1423,507,0,0,0,0
12252,WEST GODAVARI,Bheemavaram,KOMARADA,7,7,387,401,0,0,68,68,27,0,0,515,515,128,0,0,0,0
12253,WEST GODAVARI,Bheemavaram,KOMATITIPPA (NORTH),80,0,141,221,24,0,49,73,50,467,0,2422,2889,1296,0,0,8,8
12254,WEST GODAVARI,Bheemavaram,KOTHAPUSALAMARRU,4,1,624,629,0,0,6,6,6,0,0,112,112,65,0,0,0,0
12255,WEST GODAVARI,Bheemavaram,LOSARI,3,1,453,457,1,0,26,27,25,20,0,518,538,216,0,0,0,0
12256,WEST GODAVARI,Bheemavaram,LVN.PURAM,30,0,562,592,14,0,75,89,77,129,0,1126,1255,532,0,0,0,0
12257,WEST GODAVARI,Bheemavaram,NAGIDIPALEM,15,0,687,702,0,0,41,41,39,0,0,456,456,198,0,0,0,0
12258,WEST GODAVARI,Bheemavaram,NARASIMHAPURAM,92,0,378,470,18,0,28,46,37,306,0,408,714,448,0,0,0,0
12259,WEST GODAVARI,Bheemavaram,PEDAGARUVU,73,0,490,563,0,0,0,0,0,0,0,0,0,0,0,0,0,0
12260,WEST GODAVARI,Bheemavaram,RAYALAM,135,0,257,392,25,0,105,130,73,685,0,2289,2974,1120,1,0,0,1
12261,WEST GODAVARI,Bheemavaram,SRIRAMAPURAM,97,1,270,368,1,0,4,5,5,20,0,80,100,60,0,0,0,0
12262,WEST GODAVARI,Bheemavaram,TADERU,177,25,560,762,21,1,138,160,85,667,18,3268,3953,2126,2,0,0,2
12263,WEST GODAVARI,Bheemavaram,THOKATIPPA,5,3,458,466,1,0,42,43,34,12,0,522,534,224,0,0,0,0
12264,WEST GODAVARI,Bheemavaram,TUNDURRU,196,0,578,774,67,0,191,258,28,1254,0,3151,4405,446,0,0,0,0
12265,WEST GODAVARI,Bheemavaram,VEMPA,470,3,1113,1586,11,0,11,22,15,232,0,205,437,158,0,0,0,0
12266,WEST GODAVARI,Bheemavaram,YENAMADURRU,97,2,612,711,35,2,226,263,168,775,38,5213,6026,2638,0,0,0,0
12267,WEST GODAVARI,Bhimadole,AGADDALANKA,385,0,920,1305,193,0,187,380,355,3193,0,1962,5155,3691,0,0,0,0
12268,WEST GODAVARI,Bhimadole,AMBERPETA,351,2,628,981,200,1,204,405,335,6579,58,8292,14929,7926,0,0,8,8
12269,WEST GODAVARI,Bhimadole,BHIMADOLE,994,38,961,1993,297,4,131,432,384,11477,66,4377,15920,9379,9,0,1,10
12270,WEST GODAVARI,Bhimadole,CHETTUNNAPADU,353,0,502,855,167,0,162,329,345,1928,0,1890,3818,2282,0,0,0,0
12271,WEST GODAVARI,Bhimadole,DUDDEPUDI,8,0,289,297,0,0,134,134,95,0,0,1894,1894,835,0,0,1,1
12272,WEST GODAVARI,Bhimadole,GUNDUGOLANU,626,4,2026,2656,193,0,772,965,925,1459,0,13442,14901,9098,0,0,2,2
12273,WEST GODAVARI,Bhimadole,KODURUPADU,242,0,56,298,178,0,42,220,203,5105,0,1513,6618,3130,0,0,1,1
12274,WEST GODAVARI,Bhimadole,KORUKOLLU,1,0,177,178,1,0,75,76,54,94,0,5149,5243,2258,0,0,15,15
12275,WEST GODAVARI,Bhimadole,KURELLAGUDM,66,1,368,435,33,1,205,239,163,706,7,5365,6078,2810,0,0,0,0
12276,WEST GODAVARI,Bhimadole,LAXMIPURAM,4,0,212,216,1,0,107,108,108,11,0,2122,2133,1482,0,0,0,0
12277,WEST GODAVARI,Bhimadole,POLASANIPALLE,199,7,469,675,81,1,183,265,235,2425,74,7023,9522,5739,2,0,8,10
12278,WEST GODAVARI,Bhimadole,PULLA,656,14,1558,2228,286,3,588,877,725,4500,29,8967,13496,6507,0,0,0,0
12279,WEST GODAVARI,Bhimadole,SURAPPAGUDEM,225,1,335,561,148,0,97,245,191,5389,0,1924,7313,4088,0,0,0,0
12280,WEST GODAVARI,Buttayagudem,ALIVERU,1,407,1,409,0,143,0,143,133,0,7746,0,7746,4282,0,29,0,29
12281,WEST GODAVARI,Buttayagudem,ANTARVEDIGUDEM,4,959,5,968,1,616,2,619,603,48,38496,163,38707,22429,0,91,1,92
12282,WEST GODAVARI,Buttayagudem,ATCHIAHPALEM,140,521,72,733,71,289,25,385,377,5209,17246,1345,23800,13010,20,45,4,69
12283,WEST GODAVARI,Buttayagudem,BUTTAYAGUDEM,379,675,191,1245,131,308,57,496,494,5617,12237,1500,19354,11925,10,16,1,27
12284,WEST GODAVARI,Buttayagudem,DORAMAMIDI,107,1146,197,1450,7,580,45,632,636,299,28656,1268,30223,18218,0,77,0,77
12285,WEST GODAVARI,Buttayagudem,GANAPAVARAM,156,871,243,1270,0,340,4,344,361,0,11165,86,11251,7432,0,2,0,2
12286,WEST GODAVARI,Buttayagudem,JAINAVARIGUDEM,32,328,69,429,2,131,5,138,107,14,1467,15,1496,796,0,0,0,0
12287,WEST GODAVARI,Buttayagudem,KAMAYYAKUNTA,1,492,13,506,1,361,9,371,376,2,25145,625,25772,17089,0,85,1,86
12288,WEST GODAVARI,Buttayagudem,KORSAVARIGUDEM,2,472,7,481,0,186,2,188,191,0,9348,16,9364,5217,0,18,0,18
12289,WEST GODAVARI,Buttayagudem,KOTANAGAVARAM,85,384,164,633,31,114,37,182,161,952,5476,1174,7602,3762,2,14,2,18
12290,WEST GODAVARI,Buttayagudem,KOTARAMACHANDRAPURAM,75,615,28,718,30,251,8,289,288,1949,14686,276,16911,11128,8,38,0,46
12291,WEST GODAVARI,Buttayagudem,KOYARAJAHMUNDRY,4,470,15,489,0,241,4,245,247,0,10965,152,11117,5980,0,27,0,27
12292,WEST GODAVARI,Buttayagudem,LAXMUDUGUDEM,148,468,284,900,31,178,38,247,228,231,4481,502,5214,2962,0,0,0,0
12293,WEST GODAVARI,Buttayagudem,MANGAIAHPALEM,4,324,3,331,0,133,1,134,123,0,4891,7,4898,2850,0,5,0,5
12294,WEST GODAVARI,Buttayagudem,MANJULURU,1,315,0,316,0,183,0,183,185,0,8418,0,8418,6666,0,13,0,13
12295,WEST GODAVARI,Buttayagudem,NIMMALAGUDEM,17,264,359,640,2,115,212,329,336,94,7455,10057,17606,9949,0,23,20,43
12296,WEST GODAVARI,Buttayagudem,NUTIRAMANNAPALEM,11,400,15,426,0,192,1,193,196,0,8367,72,8439,4659,0,14,0,14
12297,WEST GODAVARI,Buttayagudem,PULIRAMUDUGUDEM,6,537,35,578,2,281,8,291,314,60,9022,140,9222,6312,0,6,0,6
12298,WEST GODAVARI,Buttayagudem,RAJANAGARAM,6,614,43,663,1,304,16,321,313,18,14408,878,15304,9135,0,32,1,33
12299,WEST GODAVARI,Buttayagudem,RAVVARIGUDEM,4,319,4,327,0,204,2,206,217,0,11935,126,12061,8412,0,39,1,40
12300,WEST GODAVARI,Buttayagudem,SEETAPPAGUDEM,4,959,10,973,1,655,7,663,738,31,41739,338,42108,22877,0,140,0,140
12301,WEST GODAVARI,Chagallu,BRAHMANAGUDEM,407,12,345,764,139,1,29,169,140,3157,10,215,3382,1568,1,0,0,1
12302,WEST GODAVARI,Chagallu,CHAGALLU,709,16,833,1558,7,0,21,28,23,101,0,295,396,217,0,0,0,0
12303,WEST GODAVARI,Chagallu,CHANDRAVARAM,209,4,154,367,118,3,45,166,146,2209,68,1053,3330,2735,0,0,0,0
12304,WEST GODAVARI,Chagallu,CHIKKALA,297,19,507,823,2,0,14,16,8,22,0,160,182,76,0,0,0,0
12305,WEST GODAVARI,Chagallu,DARAVARAM,262,13,198,473,52,1,33,86,72,463,3,305,771,593,0,0,0,0
12306,WEST GODAVARI,Chagallu,GOWRIPALLI,57,8,126,191,2,0,4,6,4,37,0,59,96,48,0,0,0,0
12307,WEST GODAVARI,Chagallu,KALAVALAPALLE,287,13,209,509,30,0,6,36,29,98,0,81,179,98,0,0,0,0
12308,WEST GODAVARI,Chagallu,MALLAVARAM,157,2,100,259,0,0,0,0,0,0,0,0,0,0,0,0,0,0
12309,WEST GODAVARI,Chagallu,MARKONDAPADU,439,7,497,943,100,0,106,206,167,1825,0,1662,3487,2339,2,0,0,2
12310,WEST GODAVARI,Chagallu,NALATURU,108,1,89,198,1,0,5,6,4,8,0,94,102,49,0,0,0,0
12311,WEST GODAVARI,Chagallu,NANDIGAMPADU,79,0,144,223,28,0,35,63,56,253,0,284,537,377,0,0,0,0
12312,WEST GODAVARI,Chagallu,SINGANAMUPPAVARAM,104,21,118,243,1,0,0,1,1,20,0,0,20,10,0,0,0,0
12313,WEST GODAVARI,Chagallu,UNAGATLA,260,11,527,798,17,0,19,36,29,134,0,197,331,169,0,0,0,0
12314,WEST GODAVARI,Chintalapudi,CHINTALAPUDI,2197,216,1383,3796,335,0,152,487,481,10404,0,3444,13848,8889,7,0,0,7
12315,WEST GODAVARI,Chintalapudi,CHINTAMPALLE,61,138,345,544,22,63,164,249,235,531,2455,6349,9335,5118,0,2,5,7
12316,WEST GODAVARI,Chintalapudi,ENDAPALLE,509,0,471,980,126,0,153,279,261,4285,0,7185,11470,5708,16,0,28,44
12317,WEST GODAVARI,Chintalapudi,ERRAGUNTAPALLE,638,281,852,1771,12,0,178,190,185,184,0,6664,6848,4327,0,0,11,11
12318,WEST GODAVARI,Chintalapudi,ERRAMPALLI,473,42,760,1275,287,10,270,567,557,11332,169,5026,16527,8853,7,0,0,7
12319,WEST GODAVARI,Chintalapudi,GANIJERLA,378,7,205,590,274,2,109,385,403,13984,10,5592,19586,9616,28,0,9,37
12320,WEST GODAVARI,Chintalapudi,LINGAGUDEM,62,201,313,576,1,20,0,21,18,5,141,0,146,77,0,0,0,0
12321,WEST GODAVARI,Chintalapudi,MALLAYAGUDEM,214,1,130,345,146,0,33,179,177,8306,0,480,8786,5291,24,0,0,24
12322,WEST GODAVARI,Chintalapudi,NAMAVARAM,124,510,193,827,71,151,50,272,260,5077,9296,2391,16764,9659,13,27,4,44
12323,WEST GODAVARI,Chintalapudi,POTHUNURU,86,36,220,342,57,24,110,191,180,2331,514,2426,5271,2831,0,0,0,0
12324,WEST GODAVARI,Chintalapudi,PRAGADAVARAM,2145,10,1370,3525,559,1,159,719,730,21684,5,5518,27207,14244,31,0,8,39
12325,WEST GODAVARI,Chintalapudi,RAGHAVAPURAM,622,88,974,1684,383,34,395,812,820,13176,418,11643,25237,13163,18,0,2,20
12326,WEST GODAVARI,Chintalapudi,RECHARLA,268,300,623,1191,101,95,364,560,562,3747,4690,23136,31573,19181,6,9,73,88
12327,WEST GODAVARI,Chintalapudi,SEETHANAGARAM,377,124,450,951,69,11,13,93,97,3823,929,857,5609,3570,9,5,3,17
12328,WEST GODAVARI,Chintalapudi,SIVAPURAM,252,0,362,614,160,0,242,402,380,9608,0,17671,27279,14143,29,0,57,86
12329,WEST GODAVARI,Chintalapudi,THIMMAREDDIPALLE,148,3,273,424,116,0,200,316,313,5657,0,11060,16717,8977,10,0,15,25
12330,WEST GODAVARI,Chintalapudi,URLAGUDEM,363,4,161,528,247,0,72,319,312,14974,0,1175,16149,8820,51,0,0,51
12331,WEST GODAVARI,Chintalapudi,UTASAMUDRAM,399,182,271,852,100,15,95,210,199,4983,375,4205,9563,5528,13,1,10,24
12332,WEST GODAVARI,Chintalapudi,VENKATADRIGUDEM,172,75,270,517,104,61,120,285,252,4213,3861,4848,12922,7654,1,7,7,15
12333,WEST GODAVARI,Chintalapudi,VENKATAPURAM,223,60,254,537,139,40,130,309,288,8717,3048,5351,17116,11173,22,10,4,36
12334,WEST GODAVARI,Denduluru,CHALLACHINTALAPUDI,42,0,742,784,4,0,278,282,228,118,0,10874,10992,5086,0,0,21,21
12335,WEST GODAVARI,Denduluru,DENDULURU,1449,82,1819,3350,364,23,610,997,911,15888,912,26703,43503,21783,23,2,66,91
12336,WEST GODAVARI,Denduluru,DOSAPADU,403,2,94,499,231,1,62,294,243,7183,46,1613,8842,3650,4,0,0,4
12337,WEST GODAVARI,Denduluru,GALAYAGUDEM,504,14,873,1391,201,4,287,492,436,5502,77,12160,17739,11249,0,0,17,17
12338,WEST GODAVARI,Denduluru,GANGANNAGUDEM,2,0,253,255,0,0,130,130,75,0,0,8694,8694,3073,0,0,36,36
12339,WEST GODAVARI,Denduluru,GOPANNAPALEM,620,2,182,804,330,0,22,352,316,19742,0,931,20673,13663,73,0,0,73
12340,WEST GODAVARI,Denduluru,JOGANNAPALEM,164,2,263,429,122,1,116,239,206,8568,30,4784,13382,6524,25,0,4,29
12341,WEST GODAVARI,Denduluru,KOTHAGUDEM,491,33,546,1070,213,1,137,351,310,7999,46,7619,15664,10558,10,0,7,17
12342,WEST GODAVARI,Denduluru,KOVVALI,598,1,1284,1883,153,1,418,572,512,2814,2,7058,9874,5615,0,0,0,0
12343,WEST GODAVARI,Denduluru,MEDINARAOPALEM,226,2,517,745,131,0,243,374,341,8314,0,11195,19509,10813,21,0,26,47
12344,WEST GODAVARI,Denduluru,MUPPAVARAM,460,0,42,502,279,0,32,311,303,21071,0,2150,23221,12698,96,0,8,104
12345,WEST GODAVARI,Denduluru,PERUGUGUDEM,128,0,133,261,63,0,19,82,68,3569,0,713,4282,2258,9,0,1,10
12346,WEST GODAVARI,Denduluru,POTHUNURU,587,5,1305,1897,295,1,673,969,877,5275,6,12666,17947,8532,0,0,0,0
12347,WEST GODAVARI,Denduluru,RAMARAOGUDEM,437,0,246,683,214,0,39,253,226,14072,0,1832,15904,8112,48,0,1,49
12348,WEST GODAVARI,Denduluru,SAANIGUDEM,177,11,108,296,135,1,69,205,211,12395,66,6295,18756,10259,75,0,35,110
12349,WEST GODAVARI,Denduluru,SOMAVARAPPADU,393,1,377,771,194,0,233,427,390,8159,0,11584,19743,12096,4,0,20,24
12350,WEST GODAVARI,Denduluru,SRIRAMAVARAM,274,0,310,584,159,0,161,320,295,8074,0,7911,15985,8688,14,0,15,29
12351,WEST GODAVARI,Devarapalle,BANDAPURAM,392,3,457,852,63,1,171,235,152,1939,41,8457,10437,4663,0,0,18,18
12352,WEST GODAVARI,Devarapalle,CHINNAYAGUDEM,918,10,236,1164,66,5,37,108,74,1468,104,973,2545,1516,0,0,1,1
12353,WEST GODAVARI,Devarapalle,DEVARAPALLE,788,49,604,1441,106,3,74,183,134,2818,60,1785,4663,1845,0,0,1,1
12354,WEST GODAVARI,Devarapalle,DHUMANTHUNIGUDEM,381,1,298,680,77,1,92,170,144,1749,20,3249,5018,2729,1,0,5,6
12355,WEST GODAVARI,Devarapalle,DUDDUKURU,872,6,187,1065,237,0,21,258,165,12939,0,1240,14179,6545,48,0,4,52
12356,WEST GODAVARI,Devarapalle,GOWRIPATNAM,542,4,363,909,150,0,63,213,183,6789,0,3612,10401,5936,19,0,10,29
12357,WEST GODAVARI,Devarapalle,KRISHNAMPALEM,2,9,308,319,0,0,51,51,27,0,0,1382,1382,572,0,0,2,2
12358,WEST GODAVARI,Devarapalle,KURUKURU,240,11,137,388,105,9,28,142,123,3865,893,875,5633,3476,11,5,1,17
12359,WEST GODAVARI,Devarapalle,LAXMIPURAM,372,7,161,540,225,6,41,272,226,9829,236,1090,11155,5840,23,1,1,25
12360,WEST GODAVARI,Devarapalle,PALLANTLAI,638,11,267,916,72,0,2,74,57,1153,0,16,1169,689,0,0,0,0
12361,WEST GODAVARI,Devarapalle,RAMANNAPALEM,208,0,49,257,86,0,6,92,86,3843,0,134,3977,1751,10,0,0,10
12362,WEST GODAVARI,Devarapalle,SANGAIGUDEM,226,9,243,478,105,4,35,144,120,3667,162,668,4497,2901,3,0,0,3
12363,WEST GODAVARI,Devarapalle,TYAJAMPUDI,374,8,516,898,33,1,102,136,99,1405,7,5073,6485,2853,7,0,10,17
12364,WEST GODAVARI,Devarapalle,YADAVOLE,592,13,1062,1667,186,11,69,266,195,10083,1125,2344,13552,6846,31,8,6,45
12365,WEST GODAVARI,Devarapalle,YERNAGUDEM,618,1,230,849,48,0,3,51,48,1931,0,60,1991,1318,3,0,0,3
12366,WEST GODAVARI,Dwaraka Tirumala,CHELIKANIVANIPOTHEPALLE,302,3,191,496,197,2,98,297,233,12370,79,5670,18119,9245,50,0,19,69
12367,WEST GODAVARI,Dwaraka Tirumala,DORASANIPADU,430,2,256,688,191,2,36,229,204,7301,12,1249,8562,5814,11,0,2,13
12368,WEST GODAVARI,Dwaraka Tirumala,DWARAKATIRUMALA,221,27,135,383,84,17,58,159,146,5710,1714,5049,12473,7510,31,11,26,68
12369,WEST GODAVARI,Dwaraka Tirumala,G. KOTHAPALLE,645,3,200,848,291,1,35,327,298,16780,29,1283,18092,13617,49,0,2,51
12370,WEST GODAVARI,Dwaraka Tirumala,GUNDUGOLANUKUNTA,158,1,207,366,113,0,108,221,172,5645,0,4308,9953,6336,8,0,4,12
12371,WEST GODAVARI,Dwaraka Tirumala,GUNNAMPALLE,468,0,502,970,132,0,99,231,183,4532,0,2909,7441,4105,2,0,4,6
12372,WEST GODAVARI,Dwaraka Tirumala,I.S. RAGHAVAPURAM,713,2,648,1363,336,1,208,545,444,20736,48,6864,27648,12580,68,0,11,79
12373,WEST GODAVARI,Dwaraka Tirumala,JAJULLAKUNTA,276,16,230,522,71,0,65,136,126,2171,0,1481,3652,2383,0,0,1,1
12374,WEST GODAVARI,Dwaraka Tirumala,KODIGUDEM,365,0,94,459,272,0,47,319,311,18646,0,2672,21318,12037,85,0,7,92
12375,WEST GODAVARI,Dwaraka Tirumala,KOMMARA,451,1,96,548,231,0,38,269,254,9605,0,1203,10808,6570,21,0,1,22
12376,WEST GODAVARI,Dwaraka Tirumala,M.NAGULAPALLI,556,2,289,847,250,0,60,310,302,14865,0,4144,19009,10620,61,0,18,79
12377,WEST GODAVARI,Dwaraka Tirumala,MADDULAGUDEM,217,0,139,356,189,0,22,211,206,15526,0,154,15680,8992,60,0,0,60
12378,WEST GODAVARI,Dwaraka Tirumala,MARAMPALLE,3,0,38,41,0,0,0,0,0,0,0,0,0,0,0,0,0,0
12379,WEST GODAVARI,Dwaraka Tirumala,NARAYANAPURAM,392,1,387,780,210,0,1,211,198,15636,0,33,15669,10229,79,0,0,79
12380,WEST GODAVARI,Dwaraka Tirumala,P.KANNAPURAM,683,0,508,1191,279,0,215,494,488,9928,0,5377,15305,10808,9,0,1,10
12381,WEST GODAVARI,Dwaraka Tirumala,PANGIDIGUDEM,697,118,479,1294,202,2,131,335,297,7837,40,5370,13247,6672,16,0,3,19
12382,WEST GODAVARI,Dwaraka Tirumala,RAJUPALEM,49,0,172,221,28,0,50,78,61,351,0,550,901,490,0,0,0,0
12383,WEST GODAVARI,Dwaraka Tirumala,RALLAKUNTA,303,1,104,408,139,1,10,150,120,2590,14,298,2902,1997,0,0,0,0
12384,WEST GODAVARI,Dwaraka Tirumala,RAMANNAGUDEM,214,4,379,597,94,3,109,206,185,2750,258,4800,7808,4407,3,0,6,9
12385,WEST GODAVARI,Dwaraka Tirumala,RAMASINGARAAM,282,2,514,798,105,1,258,364,287,3379,51,13362,16792,7999,3,0,43,46
12386,WEST GODAVARI,Dwaraka Tirumala,THIMMAPURAM,266,0,164,430,81,0,11,92,82,1863,0,227,2090,1547,1,0,0,1
12387,WEST GODAVARI,Dwaraka Tirumala,TIRUMALAMPALEM,755,2,458,1215,330,1,147,478,448,14045,84,6537,20666,12025,11,0,8,19
12388,WEST GODAVARI,Dwaraka Tirumala,VEMPADU,113,4,255,372,67,0,134,201,176,4337,0,6247,10584,5794,14,0,10,24
12389,WEST GODAVARI,Dwaraka Tirumala,VENKATAKRISHNAPURAM,287,0,141,428,166,0,43,209,166,9352,0,2159,11511,5619,34,0,6,40
12390,WEST GODAVARI,Eluru,CHATAPARRU,425,0,661,1086,216,0,141,357,324,4758,0,3570,8328,4468,0,0,4,4
12391,WEST GODAVARI,Eluru,CHODIMELLA,189,1,184,374,74,0,95,169,157,3031,0,4242,7273,4933,1,0,7,8
12392,WEST GODAVARI,Eluru,ELURE (R),392,21,1254,1667,47,0,32,79,64,497,0,972,1469,785,0,0,2,2
12393,WEST GODAVARI,Eluru,GUDIVAKALANKA,91,1,1504,1596,67,0,476,543,512,5783,0,20850,26633,21548,32,0,20,52
12394,WEST GODAVARI,Eluru,JALIPUDI,438,4,717,1159,141,0,243,384,344,1977,0,3930,5907,4149,0,0,1,1
12395,WEST GODAVARI,Eluru,K.D.PURAM,19,11,310,340,6,6,177,189,176,46,97,3380,3523,2280,0,0,0,0
12396,WEST GODAVARI,Eluru,KALAKURRU,0,0,249,249,0,0,14,14,10,0,0,232,232,88,0,0,0,0
12397,WEST GODAVARI,Eluru,KATLAMPUDI,139,2,131,272,62,0,64,126,101,920,0,869,1789,909,0,0,0,0
12398,WEST GODAVARI,Eluru,KOKKIRAILANKA,186,0,44,230,156,0,33,189,172,13747,0,2633,16380,9372,87,0,16,103
12399,WEST GODAVARI,Eluru,KOMADAVOLE,342,2,360,704,56,0,95,151,149,2048,0,2696,4744,2948,4,0,0,4
12400,WEST GODAVARI,Eluru,KOMATILANKA,189,1,98,288,123,1,34,158,138,2851,17,491,3359,1542,0,0,0,0
12401,WEST GODAVARI,Eluru,MADEPALLE,344,0,486,830,162,0,105,267,234,5121,0,2569,7690,4986,1,0,0,1
12402,WEST GODAVARI,Eluru,MALKAPURAM,253,3,345,601,76,1,213,290,265,3384,21,11049,14454,8975,5,0,18,23
12403,WEST GODAVARI,Eluru,MONDICODU,37,1,281,319,15,0,38,53,42,217,0,423,640,341,0,0,0,0
12404,WEST GODAVARI,Eluru,Pedayaganamilli,1,0,72,73,0,0,0,0,0,0,0,0,0,0,0,0,0,0
12405,WEST GODAVARI,Eluru,PONANGI,513,0,521,1034,141,0,111,252,232,2352,0,2389,4741,3042,1,0,0,1
12406,WEST GODAVARI,Eluru,PRATHIKOLLANKA,105,0,1353,1458,66,0,462,528,523,1441,0,12513,13954,10236,0,0,2,2
12407,WEST GODAVARI,Eluru,PYDICHINTAPADU,172,5,491,668,95,3,199,297,281,6347,133,12346,18826,14864,11,0,19,30
12408,WEST GODAVARI,Eluru,SANIVARAPUPETA,443,15,404,862,5,0,15,20,19,42,0,443,485,451,0,0,1,1
12409,WEST GODAVARI,Eluru,SATRAMPADU,196,7,140,343,28,0,2,30,28,587,0,38,625,375,0,0,0,0
12410,WEST GODAVARI,Eluru,SREEPARRU,383,1,814,1198,76,1,217,294,283,875,7,4400,5282,3316,0,0,3,3
12411,WEST GODAVARI,Eluru,TANGELLAMUDI,163,1,506,670,1,0,11,12,11,20,0,154,174,134,0,0,0,0
12412,WEST GODAVARI,Ganapavaram,AGRAHARAGOPAVARAM,146,0,173,319,1,0,0,1,0,20,0,0,20,0,0,0,0,0
12413,WEST GODAVARI,Ganapavaram,APPANNAPETA,57,1,444,502,9,1,194,204,176,108,4,2748,2860,1879,0,0,0,0
12414,WEST GODAVARI,Ganapavaram,ARDHAVARAM,301,6,234,541,29,0,51,80,50,288,0,1359,1647,757,0,0,0,0
12415,WEST GODAVARI,Ganapavaram,CHERUKUGANUMA AGRAHARAM,3,1,525,529,0,1,210,211,169,0,18,1425,1443,984,0,0,0,0
12416,WEST GODAVARI,Ganapavaram,DASULAKUMUDAVALLI,43,5,173,221,25,3,62,90,65,351,55,798,1204,599,0,0,0,0
12417,WEST GODAVARI,Ganapavaram,GANAPAVARAM,420,9,657,1086,98,0,92,190,100,409,0,541,950,409,0,0,0,0
12418,WEST GODAVARI,Ganapavaram,JALLKAKINADA,226,11,111,348,62,6,28,96,69,728,40,308,1076,571,0,0,0,0
12419,WEST GODAVARI,Ganapavaram,KASIPADU,203,3,270,476,100,1,132,233,176,568,6,846,1420,761,0,0,0,0
12420,WEST GODAVARI,Ganapavaram,KESAVARAM,158,20,343,521,4,5,167,176,156,52,53,1717,1822,1125,0,0,0,0
12421,WEST GODAVARI,Ganapavaram,KOMARRU,117,5,307,429,45,1,48,94,84,582,13,413,1008,626,0,0,0,0
12422,WEST GODAVARI,Ganapavaram,KOMATLAPALEM,136,0,7,143,84,0,6,90,65,1626,0,86,1712,736,2,0,0,2
12423,WEST GODAVARI,Ganapavaram,KOMMARA,83,4,609,696,0,0,0,0,0,0,0,0,0,0,0,0,0,0
12424,WEST GODAVARI,Ganapavaram,KOTHAPALLI,138,0,152,290,92,0,75,167,67,3559,0,1789,5348,1462,0,0,0,0
12425,WEST GODAVARI,Ganapavaram,MOYYERU,258,19,206,483,126,0,32,158,121,1951,0,414,2365,1114,0,0,0,0
12426,WEST GODAVARI,Ganapavaram,MUGGULLA,53,1,208,262,38,0,102,140,95,710,0,1744,2454,841,0,0,0,0
12427,WEST GODAVARI,Ganapavaram,MUPPARTHIPADU,146,10,186,342,4,0,0,4,0,57,0,0,57,0,0,0,0,0
12428,WEST GODAVARI,Ganapavaram,PIPPARA,464,21,402,887,160,5,119,284,199,2903,154,2464,5521,2658,0,0,0,0
12429,WEST GODAVARI,Ganapavaram,SARIPALLE,68,5,404,477,25,5,126,156,55,966,62,2795,3823,962,1,0,0,1
12430,WEST GODAVARI,Ganapavaram,SEETHALAMKONDEPADU,41,6,240,287,15,3,108,126,16,308,179,1992,2479,218,0,1,0,1
12431,WEST GODAVARI,Ganapavaram,VAKAPALLI,40,9,289,338,19,3,121,143,58,346,65,1322,1733,568,0,0,0,0
12432,WEST GODAVARI,Ganapavaram,VALLURU,106,3,217,326,21,1,19,41,21,280,1,280,561,221,0,0,0,0
12433,WEST GODAVARI,Ganapavaram,VARADARAJAPURAM,71,0,195,266,40,0,82,122,32,1063,0,1439,2502,559,0,0,0,0
12434,WEST GODAVARI,Ganapavaram,VEERESWARAPURAM,98,0,121,219,42,0,64,106,42,276,0,667,943,258,0,0,0,0
12435,WEST GODAVARI,Ganapavaram,VELAGAPALLI,37,0,115,152,12,0,43,55,39,188,0,823,1011,492,0,0,0,0
12436,WEST GODAVARI,Ganapavaram,VENKATRAJAPURAM,178,10,92,280,2,0,1,3,1,10,0,20,30,5,0,0,0,0
12437,WEST GODAVARI,Gopalapuram,BHIMOLU,438,24,578,1040,165,12,185,362,292,8674,844,11407,20925,11194,24,2,39,65
12438,WEST GODAVARI,Gopalapuram,CHERUKUMILLI,99,1,247,347,73,1,108,182,146,5489,3,5845,11337,6631,24,0,21,45
12439,WEST GODAVARI,Gopalapuram,CHITYALA,499,10,474,983,54,1,57,112,61,1721,7,1714,3442,1029,0,0,0,0
12440,WEST GODAVARI,Gopalapuram,DONDAPUDI,478,6,681,1165,96,3,258,357,268,4549,231,16947,21727,10230,21,1,70,92
12441,WEST GODAVARI,Gopalapuram,GANGOLU,656,7,648,1311,246,1,142,389,285,12617,21,4606,17244,8842,43,0,5,48
12442,WEST GODAVARI,Gopalapuram,GOPALAPURAM,891,5,473,1369,273,0,46,319,213,15884,0,2090,17974,6659,62,0,4,66
12443,WEST GODAVARI,Gopalapuram,GUDDIGUDEM,270,0,585,855,146,0,221,367,292,8873,0,12306,21179,11247,18,0,15,33
12444,WEST GODAVARI,Gopalapuram,JAGANNADHAPURAM,218,0,269,487,102,0,68,170,145,5552,0,3798,9350,5294,21,0,14,35
12445,WEST GODAVARI,Gopalapuram,KARAGAPADU,109,0,522,631,48,0,294,342,270,2490,0,17550,20040,10472,8,0,70,78
12446,WEST GODAVARI,Gopalapuram,KARICHARLAGUDEM,146,0,320,466,84,0,222,306,250,6188,0,15038,21226,9848,29,0,60,89
12447,WEST GODAVARI,Gopalapuram,KOMATIGUNTA,177,0,110,287,43,0,38,81,72,1198,0,1480,2678,1404,1,0,1,2
12448,WEST GODAVARI,Gopalapuram,KOVVURUPADU,198,4,472,674,66,2,205,273,81,3300,80,10299,13679,2847,9,0,20,29
12449,WEST GODAVARI,Gopalapuram,RAJAMPALEM,249,0,193,442,27,0,16,43,34,782,0,437,1219,543,1,0,1,2
12450,WEST GODAVARI,Gopalapuram,SAGGONDA,433,5,323,761,157,3,98,258,219,5287,50,3084,8421,5055,8,0,3,11
12451,WEST GODAVARI,Gopalapuram,SANJEEVAPURAM,126,206,209,541,59,148,89,296,272,1579,8961,2356,12896,6749,2,10,3,15
12452,WEST GODAVARI,Gopalapuram,VADALAKUNTA,450,0,147,597,33,0,13,46,40,1074,0,339,1413,680,3,0,1,4
12453,WEST GODAVARI,Gopalapuram,VELLACHINTALAGUDEM,834,2,330,1166,164,0,20,184,115,9380,0,749,10129,3878,22,0,1,23
12454,WEST GODAVARI,Gopalapuram,VENKATAYAPALEM,121,0,231,352,40,0,53,93,90,1942,0,2323,4265,2383,3,0,6,9
12455,WEST GODAVARI,Iragavaram,ARJUNUDUPALEM,130,3,369,502,79,2,52,133,94,1066,40,458,1564,797,0,0,0,0
12456,WEST GODAVARI,Iragavaram,ELETIPADU,37,3,237,277,16,0,55,71,69,157,0,1166,1323,1159,0,0,0,0
12457,WEST GODAVARI,Iragavaram,GOTERU,72,0,364,436,36,0,95,131,112,1756,0,5846,7602,4345,1,0,21,22
12458,WEST GODAVARI,Iragavaram,INAPARRU,85,3,219,307,50,0,70,120,108,1808,0,3462,5270,2998,0,0,5,5
12459,WEST GODAVARI,Iragavaram,IRAGAVARAM,191,16,792,999,62,1,221,284,260,996,5,6187,7188,5318,0,0,1,1
12460,WEST GODAVARI,Iragavaram,ITEMPUDI,1,0,55,56,0,0,0,0,0,0,0,0,0,0,0,0,0,0
12461,WEST GODAVARI,Iragavaram,K.ILLINDALAPARRU,221,12,596,829,137,9,107,253,193,4189,258,1757,6204,3430,3,0,1,4
12462,WEST GODAVARI,Iragavaram,KAKILERU,161,8,176,345,46,0,43,89,62,564,0,496,1060,599,0,0,0,0
12463,WEST GODAVARI,Iragavaram,KANNAYAKUMUDAVALLI,96,8,369,473,22,3,150,175,41,224,49,2524,2797,525,0,0,0,0
12464,WEST GODAVARI,Iragavaram,KANTHERU,176,5,111,292,113,3,49,165,149,3932,89,1633,5654,3345,0,0,2,2
12465,WEST GODAVARI,Iragavaram,KATHAVAPADU,98,0,168,266,62,0,30,92,76,2272,0,839,3111,1558,4,0,0,4
12466,WEST GODAVARI,Iragavaram,KAVALIPURAM,71,27,399,497,31,17,206,254,217,1035,853,7594,9482,5728,0,1,4,5
12467,WEST GODAVARI,Iragavaram,KOTHAPADU,59,4,236,299,41,2,48,91,79,1071,9,808,1888,1122,0,0,0,0
12468,WEST GODAVARI,Iragavaram,OGIDI,174,8,241,423,29,0,120,149,136,1122,0,4691,5813,4003,0,0,5,5
12469,WEST GODAVARI,Iragavaram,PEKERU,85,2,459,546,43,1,110,154,133,477,5,711,1193,758,0,0,0,0
12470,WEST GODAVARI,Iragavaram,PODALADA,59,0,196,255,33,0,125,158,143,780,0,3041,3821,2483,0,0,0,0
12471,WEST GODAVARI,Iragavaram,RAPAKA,132,2,269,403,75,1,108,184,166,1329,16,1997,3342,2327,0,0,0,0
12472,WEST GODAVARI,Iragavaram,RELANGI,479,15,1226,1720,206,1,445,652,597,4690,23,6302,11015,6529,2,0,0,2
12473,WEST GODAVARI,Iragavaram,SURAMPUDI,117,2,328,447,80,0,227,307,236,863,0,2562,3425,1543,0,0,0,0
12474,WEST GODAVARI,Iragavaram,THURUPUVIPPARRU,115,2,580,697,40,2,223,265,225,175,30,1346,1551,878,0,0,0,0
12475,WEST GODAVARI,Iragavaram,YERRAICHERUVU,0,0,231,231,0,0,164,164,147,0,0,3656,3656,1735,0,0,1,1
12476,WEST GODAVARI,Jangareddigudem,A.POLAVARAM,246,13,332,591,93,9,44,146,135,3693,452,1419,5564,4363,4,0,3,7
12477,WEST GODAVARI,Jangareddigudem,AKKAMPETA,128,0,272,400,80,0,35,115,103,3914,0,578,4492,2711,9,0,0,9
12478,WEST GODAVARI,Jangareddigudem,AMMAPALEM,180,0,327,507,59,0,106,165,132,3028,0,3303,6331,3240,4,0,2,6
12479,WEST GODAVARI,Jangareddigudem,CHAKRADEVARAPALLE,96,67,333,496,28,13,122,163,143,435,92,1910,2437,1655,0,0,0,0
12480,WEST GODAVARI,Jangareddigudem,DEVULAPALLE,274,2,356,632,110,0,64,174,162,5242,0,2700,7942,5287,5,0,7,12
12481,WEST GODAVARI,Jangareddigudem,GURAVAIGUDEM,81,11,315,407,42,5,156,203,172,1501,548,7610,9659,6124,1,3,8,12
12482,WEST GODAVARI,Jangareddigudem,JANGAREDDIGUDEM,916,52,1864,2832,0,0,0,0,0,0,0,0,0,0,0,0,0,0
12483,WEST GODAVARI,Jangareddigudem,KETHAVARAM,353,2,731,1086,183,1,271,455,394,5548,38,10012,15598,10101,4,0,8,12
12484,WEST GODAVARI,Jangareddigudem,LAKKAVARAM,457,65,617,1139,0,0,102,102,42,0,0,3938,3938,979,0,0,0,0
12485,WEST GODAVARI,Jangareddigudem,MYSANAGUDEM,358,1,631,990,128,0,171,299,275,5358,0,7891,13249,9309,4,0,13,17
12486,WEST GODAVARI,Jangareddigudem,NAGULAGUDEM,263,3,166,432,188,1,87,276,249,9139,50,4370,13559,7433,9,0,1,10
12487,WEST GODAVARI,Jangareddigudem,NIMMALAGUDEM,209,1,113,323,102,0,40,142,118,4296,0,1359,5655,3268,7,0,0,7
12488,WEST GODAVARI,Jangareddigudem,PANGIDIGUDEM,613,4,415,1032,427,2,139,568,497,20040,93,3983,24116,13274,18,0,0,18
12489,WEST GODAVARI,Jangareddigudem,PATTENAPALEM,92,80,402,574,47,26,65,138,115,2262,1196,2584,6042,3448,6,3,4,13
12490,WEST GODAVARI,Jangareddigudem,PERAMPETA,405,0,363,768,190,0,37,227,201,6043,0,819,6862,4980,1,0,0,1
12491,WEST GODAVARI,Jangareddigudem,PUTLAGUTLAGUDEM,135,0,387,522,88,0,230,318,286,3566,0,11782,15348,9422,3,0,17,20
12492,WEST GODAVARI,Jangareddigudem,SREENIVASAPURAM,601,22,256,879,166,2,1,169,164,7775,100,5,7880,5181,15,0,0,15
12493,WEST GODAVARI,Jangareddigudem,TADUVAI,765,19,578,1362,257,15,59,331,303,10690,837,1668,13195,9211,18,2,1,21
12494,WEST GODAVARI,Jangareddigudem,TEKKINAVARIGUDEM,88,0,330,418,1,0,3,4,4,5,0,60,65,21,0,0,0,0
12495,WEST GODAVARI,Jangareddigudem,TIRUMALAPURAM,205,0,292,497,152,0,130,282,259,7945,0,5766,13711,9071,10,0,5,15
12496,WEST GODAVARI,Jangareddigudem,VEGAVARAM,526,2,826,1354,121,0,54,175,152,4584,0,1224,5808,3657,3,0,0,3
12497,WEST GODAVARI,Jeelugumilli,ANKANNAGUDEM,89,593,117,799,28,242,19,289,302,327,11869,640,12836,7353,0,28,2,30
12498,WEST GODAVARI,Jeelugumilli,DARBHAGUDEM,755,260,342,1357,318,132,66,516,486,20247,9787,3541,33575,18714,57,42,6,105
12499,WEST GODAVARI,Jeelugumilli,GANGANNGUDEM,4,363,91,458,1,150,4,155,152,66,9432,89,9587,6394,0,22,0,22
12500,WEST GODAVARI,Jeelugumilli,JEELUGU MILLI,424,377,399,1200,167,140,69,376,345,9020,6455,3482,18957,11492,22,9,9,40
12501,WEST GODAVARI,Jeelugumilli,KAMMAIAH PALEM,59,209,768,1036,5,81,166,252,240,128,3041,4550,7719,4799,0,12,2,14
12502,WEST GODAVARI,Jeelugumilli,MULAGALAMPALLE,214,281,726,1221,105,138,359,602,522,6465,8064,22091,36620,20380,15,22,58,95
12503,WEST GODAVARI,Jeelugumilli,P.ANKAM PALEM,129,88,401,618,45,47,199,291,273,1070,2243,8480,11793,7228,2,5,8,15
12504,WEST GODAVARI,Jeelugumilli,PALACHERLARAJAVARAM,149,45,303,497,65,9,96,170,150,1399,97,2967,4463,2808,1,0,0,1
12505,WEST GODAVARI,Jeelugumilli,RACHANNAGUDEM,197,640,106,943,61,308,31,400,373,3493,15318,1392,20203,10481,8,25,2,35
12506,WEST GODAVARI,Jeelugumilli,SWARNAVARIGUDEM,115,155,158,428,50,48,14,112,88,1607,1785,355,3747,1450,3,2,0,5
12507,WEST GODAVARI,Jeelugumilli,TATIKAYALA GUDEM,284,204,460,948,165,117,257,539,509,10297,7676,15422,33395,19566,27,18,36,81
12508,WEST GODAVARI,Jeelugumilli,VANKAVARI GUDEM,37,665,46,748,9,255,22,286,258,652,17715,956,19323,10568,2,62,1,65
12509,WEST GODAVARI,Kalla,ANANDPURAM,10,0,194,204,6,0,33,39,31,35,0,295,330,155,0,0,0,0
12510,WEST GODAVARI,Kalla,BANDADA,25,4,721,750,8,0,116,124,110,141,0,1941,2082,989,0,0,0,0
12511,WEST GODAVARI,Kalla,BANDADA PETA,8,0,608,616,0,0,169,169,66,0,0,2636,2636,726,0,0,0,0
12512,WEST GODAVARI,Kalla,DODDANAPUDI,139,0,1058,1197,6,0,400,406,83,77,0,6257,6334,972,0,0,0,0
12513,WEST GODAVARI,Kalla,ELURUPADU,18,5,739,762,1,2,199,202,109,12,19,2778,2809,943,0,0,0,0
12514,WEST GODAVARI,Kalla,JAKKARAM,165,9,177,351,0,0,0,0,0,0,0,0,0,0,0,0,0,0
12515,WEST GODAVARI,Kalla,JUVVALAPALEM,59,12,638,709,18,6,227,251,225,520,115,2481,3116,1897,0,0,0,0
12516,WEST GODAVARI,Kalla,KALAVAPUDI,44,1,615,660,0,0,60,60,63,0,0,1023,1023,617,0,0,0,0
12517,WEST GODAVARI,Kalla,KALLA,269,12,949,1230,76,5,264,345,152,1930,93,3864,5887,2235,1,0,0,1
12518,WEST GODAVARI,Kalla,KALLAKURU,10,0,776,786,1,0,274,275,253,21,0,4074,4095,2364,0,0,0,0
12519,WEST GODAVARI,Kalla,KOLANAPALLE,151,0,159,310,2,0,5,7,3,40,0,100,140,22,0,0,0,0
12520,WEST GODAVARI,Kalla,KOMATIGUNTA,1,0,397,398,0,0,27,27,16,0,0,175,175,74,0,0,0,0
12521,WEST GODAVARI,Kalla,KOPALLE,50,12,839,901,1,1,319,321,278,3,20,4464,4487,2493,0,0,0,0
12522,WEST GODAVARI,Kalla,L.N.PURAM,88,0,504,592,20,0,87,107,84,310,0,707,1017,552,0,0,0,0
12523,WEST GODAVARI,Kalla,MALLAVANITIPPA,0,0,240,240,0,0,78,78,75,0,0,1210,1210,937,0,0,0,0
12524,WEST GODAVARI,Kalla,PALLIPALEM,17,0,291,308,0,0,0,0,0,0,0,0,0,0,0,0,0,0
12525,WEST GODAVARI,Kalla,PATHALLAMEAKA,16,0,236,252,0,0,0,0,0,0,0,0,0,0,0,0,0,0
12526,WEST GODAVARI,Kalla,PEDAMIRAM,98,10,997,1105,1,0,12,13,11,20,0,240,260,106,0,0,0,0
12527,WEST GODAVARI,Kalla,S.C.BOSE MAJI SAINIK,50,4,232,286,18,0,53,71,33,118,0,594,712,320,0,0,0,0
12528,WEST GODAVARI,Kalla,SEESALI,85,9,640,734,1,0,6,7,6,20,0,96,116,58,0,0,0,0
12529,WEST GODAVARI,Kalla,VEMPADU,55,0,254,309,1,0,2,3,4,20,0,40,60,50,0,0,0,0
12530,WEST GODAVARI,Kamavarapukota,ADAMILLI,582,2,376,960,272,0,76,348,353,14622,0,2495,17117,10481,38,0,2,40
12531,WEST GODAVARI,Kamavarapukota,ANKALAMPADU,482,1,426,909,317,1,221,539,492,19161,52,10222,29435,15814,56,0,13,69
12532,WEST GODAVARI,Kamavarapukota,EDAVALLI,210,1,523,734,143,0,222,365,323,6077,0,9078,15155,8592,6,0,16,22
12533,WEST GODAVARI,Kamavarapukota,GUNTUPALLE,494,9,740,1243,294,3,416,713,595,12633,121,21019,33773,16694,13,0,57,70
12534,WEST GODAVARI,Kamavarapukota,KALLAHERUVU,246,5,654,905,171,2,361,534,503,10089,24,25095,35208,20336,41,0,110,151
12535,WEST GODAVARI,Kamavarapukota,KAMAVEREPUKOTA,2145,361,1949,4455,602,30,592,1224,1182,25376,688,24228,50292,31774,63,1,32,96
12536,WEST GODAVARI,Kamavarapukota,KHANDRIKASEETHARAMAPURA,365,0,432,797,287,0,318,605,567,18426,0,17140,35566,20570,39,0,37,76
12537,WEST GODAVARI,Kamavarapukota,POLASIGUDEM,35,6,227,268,11,5,86,102,92,556,359,4457,5372,3829,1,1,6,8
12538,WEST GODAVARI,Kamavarapukota,RAMANNAPALEM,258,2,145,405,166,1,37,204,190,8328,14,1468,9810,4665,24,0,2,26
12539,WEST GODAVARI,Kamavarapukota,RAVIKAMPADU,404,8,651,1063,190,3,333,526,422,6747,11,9238,15996,8498,11,0,6,17
12540,WEST GODAVARI,Kamavarapukota,SAGIPADU,583,2,274,859,314,0,119,433,404,10569,0,3834,14403,8342,8,0,0,8
12541,WEST GODAVARI,Kamavarapukota,TADIKALAPUDI,797,1,691,1489,447,0,90,537,540,26366,0,2724,29090,17682,52,0,0,52
12542,WEST GODAVARI,Kamavarapukota,UPPALAPADU,143,0,396,539,86,0,145,231,215,4164,0,6214,10378,5806,12,0,15,27
12543,WEST GODAVARI,Kamavarapukota,VEERIGETTEGUDEM,352,28,240,620,195,10,74,279,261,6731,552,2128,9411,5677,5,0,3,8
12544,WEST GODAVARI,Kovvur,ARIKIREVULA,376,3,306,685,131,0,27,158,135,3470,0,601,4071,2736,2,0,0,2
12545,WEST GODAVARI,Kovvur,CHIDIPI,100,2,74,176,0,0,0,0,0,0,0,0,0,0,0,0,0,0
12546,WEST GODAVARI,Kovvur,DHARMAVARAM,663,10,315,988,82,0,4,86,74,5105,0,401,5506,2761,19,0,2,21
12547,WEST GODAVARI,Kovvur,DOMMERU,785,3,597,1385,51,0,7,58,8,2392,0,255,2647,141,0,0,0,0
12548,WEST GODAVARI,Kovvur,ISUKAPATLAPANGIDI,435,36,524,995,5,0,10,15,7,85,0,174,259,94,0,0,0,0
12549,WEST GODAVARI,Kovvur,KAPAVARAM,312,2,346,660,76,1,43,120,72,5008,50,2569,7627,3223,22,0,10,32
12550,WEST GODAVARI,Kovvur,KUMARADEVAM,314,3,428,745,0,0,2,2,0,0,0,10,10,0,0,0,0,0
12551,WEST GODAVARI,Kovvur,MADDURU,196,7,435,638,14,1,12,27,8,188,12,191,391,109,0,0,0,0
12552,WEST GODAVARI,Kovvur,MADDURULANKA,169,0,140,309,29,0,14,43,18,342,0,240,582,164,0,0,0,0
12553,WEST GODAVARI,Kovvur,NANDAMURU,93,2,120,215,1,0,1,2,1,14,0,8,22,7,0,0,0,0
12554,WEST GODAVARI,Kovvur,PASIVEDALA,348,11,432,791,58,0,2,60,53,3222,0,28,3250,2908,1,0,0,1
12555,WEST GODAVARI,Kovvur,PENAKANAMETTA,354,7,243,604,1,0,0,1,1,6,0,0,6,6,0,0,0,0
12556,WEST GODAVARI,Kovvur,SEETHAMPETA,8,1,255,264,3,0,37,40,4,166,0,1584,1750,193,0,0,1,1
12557,WEST GODAVARI,Kovvur,THOGUMMI,284,3,244,531,2,0,3,5,3,27,0,54,81,44,0,0,0,0
12558,WEST GODAVARI,Kovvur,VADAPALLE,312,2,599,913,0,0,0,0,0,0,0,0,0,0,0,0,0,0
12559,WEST GODAVARI,Kovvur,VEMULURU,202,2,472,676,0,0,1,1,1,0,0,8,8,8,0,0,0,0
12560,WEST GODAVARI,Koyyalagudem,ATCHUTAPURAM,217,0,338,555,84,0,184,268,223,3424,0,8979,12403,6856,5,0,18,23
12561,WEST GODAVARI,Koyyalagudem,BAYYANAGUDEM,260,2,281,543,94,1,47,142,106,3063,118,1460,4641,2749,2,1,0,3
12562,WEST GODAVARI,Koyyalagudem,BODIGUDEM,482,30,365,877,163,4,65,232,196,7690,30,1705,9425,5899,19,0,2,21
12563,WEST GODAVARI,Koyyalagudem,DIPPAKAYALAPADU,297,262,291,850,111,180,53,344,293,3122,11825,1100,16047,9838,3,27,0,30
12564,WEST GODAVARI,Koyyalagudem,GAVAROVARAM,509,4,368,881,113,0,102,215,179,7394,0,4891,12285,8254,28,0,17,45
12565,WEST GODAVARI,Koyyalagudem,KANNAPURAM,202,16,557,775,41,7,257,305,265,1181,768,14154,16103,10717,1,4,35,40
12566,WEST GODAVARI,Koyyalagudem,MANGAPATHIDEVIPETA,169,21,439,629,75,16,176,267,214,3200,1275,10483,14958,9000,9,5,23,37
12567,WEST GODAVARI,Koyyalagudem,NARASANNAPALEM,96,0,216,312,33,0,75,108,86,1052,0,2477,3529,2218,0,0,1,1
12568,WEST GODAVARI,Koyyalagudem,PARIMPUDI,219,53,537,809,68,10,253,331,301,2263,209,15307,17779,13437,5,0,71,76
12569,WEST GODAVARI,Koyyalagudem,PONGUTURU,272,9,472,753,120,0,142,262,190,4620,0,4601,9221,5209,8,0,2,10
12570,WEST GODAVARI,Koyyalagudem,RAJAVARAM,856,3,799,1658,461,1,232,694,643,17984,30,10231,28245,17552,21,0,20,41
12571,WEST GODAVARI,Koyyalagudem,RAMANUJAPURAM,147,5,316,468,74,0,147,221,175,1941,0,3029,4970,2640,0,0,0,0
12572,WEST GODAVARI,Koyyalagudem,SARIPALLE,249,217,399,865,86,115,163,364,270,1980,5712,5414,13106,5871,6,12,12,30
12573,WEST GODAVARI,Koyyalagudem,SEETHAMPETA,94,0,302,396,33,0,62,95,79,426,0,830,1256,879,0,0,0,0
12574,WEST GODAVARI,Koyyalagudem,VEDANTHAPURAM,158,1,209,368,100,1,41,142,132,3617,71,1826,5514,3148,4,0,5,9
12575,WEST GODAVARI,Koyyalagudem,YERRAMPETA,749,6,892,1647,206,0,278,484,437,5863,0,13960,19823,13424,8,0,35,43
12576,WEST GODAVARI,Kukunoor,Amaravaram,269,380,213,862,0,0,0,0,0,0,0,0,0,0,0,0,0,0
12577,WEST GODAVARI,Kukunoor,Dacharam,202,305,296,803,0,0,0,0,0,0,0,0,0,0,0,0,0,0
12578,WEST GODAVARI,Kukunoor,Damaracharla,204,93,211,508,0,0,14,14,9,0,0,72,72,30,0,0,0,0
12579,WEST GODAVARI,Kukunoor,Ganapavaram,321,92,128,541,191,17,41,249,225,5450,430,1294,7174,4161,0,0,0,0
12580,WEST GODAVARI,Kukunoor,Gommugudem,135,476,222,833,0,0,0,0,0,0,0,0,0,0,0,0,0,0
12581,WEST GODAVARI,Kukunoor,Kivvaka,153,87,166,406,0,15,1,16,15,0,22,1,23,15,0,0,0,0
12582,WEST GODAVARI,Kukunoor,Kukunoor,436,369,820,1625,0,19,0,19,12,0,102,0,102,42,0,0,0,0
12583,WEST GODAVARI,Kukunoor,Madhavaram,252,270,363,885,10,17,13,40,18,66,71,37,174,56,0,0,0,0
12584,WEST GODAVARI,Kukunoor,Maredubaka,97,163,132,392,0,0,0,0,0,0,0,0,0,0,0,0,0,0
12585,WEST GODAVARI,Kukunoor,Pedaravigudem,282,248,299,829,133,48,1,182,168,4107,2441,96,6644,4198,0,2,0,2
12586,WEST GODAVARI,Kukunoor,Seetharama Nagar,190,70,139,399,104,18,70,192,188,4701,586,2657,7944,5687,1,0,1,2
12587,WEST GODAVARI,Kukunoor,Sridhara,210,160,253,623,69,10,105,184,180,1919,253,4999,7171,4625,1,0,7,8
12588,WEST GODAVARI,Kukunoor,Thondipaka,112,260,248,620,0,0,0,0,0,0,0,0,0,0,0,0,0,0
12589,WEST GODAVARI,Kukunoor,Upperu,131,242,147,520,0,0,0,0,0,0,0,0,0,0,0,0,0,0
12590,WEST GODAVARI,Kukunoor,Vinjaram,363,213,357,933,0,0,0,0,0,0,0,0,0,0,0,0,0,0
12591,WEST GODAVARI,Lingapalem,ASANNAGUDEM,237,0,316,553,170,0,246,416,423,7123,0,9937,17060,8286,3,0,8,11
12592,WEST GODAVARI,Lingapalem,AYYAPARAJUGUDEM,599,2,285,886,317,2,170,489,445,14307,113,6503,20923,11205,8,0,2,10
12593,WEST GODAVARI,Lingapalem,BADARLA,33,0,235,268,24,0,167,191,184,886,0,6411,7297,3817,1,0,7,8
12594,WEST GODAVARI,Lingapalem,BHOGOLE,349,8,457,814,271,6,318,595,585,16007,299,16176,32482,17049,45,0,30,75
12595,WEST GODAVARI,Lingapalem,DHARMAJIGUDEM,1052,40,663,1755,577,7,311,895,853,25452,322,13627,39401,21417,32,0,7,39
12596,WEST GODAVARI,Lingapalem,K.GOKAVARAM,1480,3,549,2032,1081,1,359,1441,1536,75737,35,16511,92283,46300,214,0,24,238
12597,WEST GODAVARI,Lingapalem,KALARAYANAGUDEM,488,5,279,772,281,3,155,439,484,12720,193,5627,18540,9708,10,0,1,11
12598,WEST GODAVARI,Lingapalem,KONIJERLA,188,5,92,285,146,3,71,220,260,7209,88,4369,11666,5965,17,0,18,35
12599,WEST GODAVARI,Lingapalem,KOTHAPALLE,264,4,632,900,191,2,420,613,509,10289,72,24643,35004,16949,17,0,40,57
12600,WEST GODAVARI,Lingapalem,LINGAMPALEM,473,20,433,926,319,6,294,619,743,26360,285,18971,45616,23831,126,2,50,178
12601,WEST GODAVARI,Lingapalem,MATTAMGUDEM,366,10,423,799,258,3,227,488,434,15615,109,9128,24852,12449,35,0,14,49
12602,WEST GODAVARI,Lingapalem,MUDICHERLA,232,6,340,578,178,2,243,423,376,7426,79,9701,17206,9536,3,0,5,8
12603,WEST GODAVARI,Lingapalem,MULAGALAMPADU,261,0,220,481,190,0,128,318,299,6771,0,4258,11029,5734,12,0,2,14
12604,WEST GODAVARI,Lingapalem,NARASANNPALEM,305,3,453,761,173,0,222,395,427,7610,0,7400,15010,7144,14,0,3,17
12605,WEST GODAVARI,Lingapalem,PUPPULAVARIGUDEM,150,11,218,379,120,10,154,284,291,11550,952,14290,26792,15057,62,4,76,142
12606,WEST GODAVARI,Lingapalem,RANGAPURAM,236,0,297,533,166,0,164,330,334,9771,0,7703,17474,11108,24,0,16,40
12607,WEST GODAVARI,Lingapalem,SINGAGUDEM,326,2,384,712,278,1,298,577,603,14383,26,15858,30267,15075,31,0,30,61
12608,WEST GODAVARI,Lingapalem,T.CH.R.PALEM,402,2,329,733,301,0,211,512,525,13764,0,4399,18163,10474,31,0,0,31
12609,WEST GODAVARI,Lingapalem,VEMULAPALLE,433,1,211,645,338,0,143,481,520,16431,0,6471,22902,11383,14,0,5,19
12610,WEST GODAVARI,Lingapalem,YEDAVALLI,382,14,479,875,319,11,352,682,778,25626,561,20015,46202,22667,82,1,33,116
12611,WEST GODAVARI,Mogalthur,JAGANNADHAPURAM,28,2,215,245,0,0,0,0,0,0,0,0,0,0,0,0,0,0
12612,WEST GODAVARI,Mogalthur,K.P.PALEM NORTH,128,1,1008,1137,14,0,181,195,39,469,0,5639,6108,511,0,0,0,0
12613,WEST GODAVARI,Mogalthur,K.P.PALEM SOUTH,117,1,908,1026,45,1,106,152,61,2239,5,2959,5203,1837,6,0,0,6
12614,WEST GODAVARI,Mogalthur,KALIPATNAM EAST,74,0,611,685,17,0,115,132,1,243,0,1615,1858,8,0,0,0,0
12615,WEST GODAVARI,Mogalthur,KALIPATNAM WEST,12,0,862,874,2,0,164,166,25,40,0,4222,4262,212,0,0,0,0
12616,WEST GODAVARI,Mogalthur,KOMATITIPPA,31,1,342,374,10,0,137,147,19,243,0,3639,3882,312,0,0,0,0
12617,WEST GODAVARI,Mogalthur,KOTHAPALEM,141,0,224,365,21,0,37,58,5,277,0,283,560,47,0,0,0,0
12618,WEST GODAVARI,Mogalthur,KOTHOTA,74,0,786,860,25,0,135,160,51,364,0,3316,3680,606,0,0,3,3
12619,WEST GODAVARI,Mogalthur,MODI,0,0,267,267,0,0,124,124,9,0,0,3267,3267,159,0,0,0,0
12620,WEST GODAVARI,Mogalthur,MOGALTHUR,623,13,2074,2710,97,0,150,247,110,3944,0,4779,8723,3222,1,0,6,7
12621,WEST GODAVARI,Mogalthur,MUTYALAPALLE,26,0,1058,1084,0,0,29,29,22,0,0,517,517,216,0,0,0,0
12622,WEST GODAVARI,Mogalthur,PATAPADU,0,2,656,658,0,0,210,210,162,0,0,2894,2894,977,0,0,0,0
12623,WEST GODAVARI,Mogalthur,PERUPALEM NORTH,186,0,1098,1284,16,0,153,169,54,327,0,7132,7459,2083,1,0,2,3
12624,WEST GODAVARI,Mogalthur,PERUPALEM SOUTH,217,1,1678,1896,9,0,98,107,20,326,0,3404,3730,440,0,0,4,4
12625,WEST GODAVARI,Mogalthur,RAMANNAPALEM,338,9,1439,1786,107,0,423,530,62,3012,0,10017,13029,1212,0,0,0,0
12626,WEST GODAVARI,Mogalthur,SERIPALEM,93,1,469,563,16,0,126,142,52,811,0,5468,6279,1436,0,0,3,3
12627,WEST GODAVARI,Mogalthur,VARATIPPA,4,3,277,284,0,0,0,0,0,0,0,0,0,0,0,0,0,0
12628,WEST GODAVARI,Nallajerla,ACHANNAPALEM,245,0,238,483,122,0,69,191,145,6457,0,2559,9016,5500,13,0,5,18
12629,WEST GODAVARI,Nallajerla,ANANTHAPALLE,467,10,845,1322,109,0,119,228,164,4114,0,2738,6852,4341,8,0,1,9
12630,WEST GODAVARI,Nallajerla,ANUMUNILANKA,251,9,282,542,153,3,95,251,171,6893,209,5040,12142,5521,9,1,14,24
12631,WEST GODAVARI,Nallajerla,AVAPADU,235,16,293,544,95,2,67,164,99,4247,89,3895,8231,4462,9,0,11,20
12632,WEST GODAVARI,Nallajerla,AYYAVARAM,5,0,420,425,0,0,103,103,92,0,0,4700,4700,3029,0,0,11,11
12633,WEST GODAVARI,Nallajerla,CHEEPURUGUDEM,284,13,367,664,109,2,142,253,196,7342,52,6916,14310,9715,31,0,15,46
12634,WEST GODAVARI,Nallajerla,DUBACHERLA,497,26,641,1164,219,1,77,297,257,10277,25,2166,12468,7881,27,0,3,30
12635,WEST GODAVARI,Nallajerla,EAST CHODAVARAM,347,3,309,659,113,0,49,162,131,6153,0,1616,7769,5316,12,0,1,13
12636,WEST GODAVARI,Nallajerla,GANTAVARIGUDEM,357,4,450,811,96,0,84,180,133,4017,0,3323,7340,4268,13,0,7,20
12637,WEST GODAVARI,Nallajerla,GUNDEPALLE,65,0,242,307,40,0,139,179,77,1985,0,8745,10730,1855,5,0,21,26
12638,WEST GODAVARI,Nallajerla,JAGANNADHAPURAM,292,7,290,589,182,1,53,236,211,13305,15,1653,14973,8726,48,0,3,51
12639,WEST GODAVARI,Nallajerla,KOWLURU,177,1,115,293,113,1,31,145,133,5550,68,2606,8224,4914,13,0,13,26
12640,WEST GODAVARI,Nallajerla,MARELLAMUDI,110,0,339,449,9,0,112,121,66,236,0,5041,5277,2274,0,0,12,12
12641,WEST GODAVARI,Nallajerla,MUSALLAKUNTA,193,4,123,320,98,3,30,131,105,6714,260,920,7894,4341,34,1,2,37
12642,WEST GODAVARI,Nallajerla,NABIPETA,234,5,185,424,110,0,39,149,120,7630,0,1836,9466,6429,32,0,9,41
12643,WEST GODAVARI,Nallajerla,NALLAJERLA,506,17,592,1115,206,5,125,336,241,10936,109,4734,15779,8347,31,0,13,44
12644,WEST GODAVARI,Nallajerla,POTHAVARAM,846,40,258,1144,276,20,14,310,279,9772,1045,294,11111,6958,18,2,0,20
12645,WEST GODAVARI,Nallajerla,PRAKASARAOPALEM,392,1,437,830,60,0,122,182,142,2381,0,5447,7828,4584,5,0,14,19
12646,WEST GODAVARI,Nallajerla,PULLALAPADU,316,23,143,482,130,5,23,158,121,6777,82,1338,8197,5159,22,0,6,28
12647,WEST GODAVARI,Nallajerla,SINGARAJUPALEM,256,1,173,430,104,0,6,110,85,3762,0,99,3861,1862,4,0,0,4
12648,WEST GODAVARI,Nallajerla,SUBHADRAPALEM,351,0,109,460,160,0,38,198,177,7002,0,2229,9231,6620,11,0,8,19
12649,WEST GODAVARI,Nallajerla,TELIKICHERLA,239,4,1046,1289,100,0,331,431,225,5069,0,13846,18915,6610,9,0,27,36
12650,WEST GODAVARI,Nallajerla,WEST CHODAVARAM,150,2,85,237,73,1,14,88,60,4423,16,381,4820,2852,18,0,1,19
12651,WEST GODAVARI,Narasapuram,BIYYAPUTIPPA,4,0,229,233,0,0,0,0,0,0,0,0,0,0,0,0,0,0
12652,WEST GODAVARI,Narasapuram,CHANAKUNRIPALEM,120,1,987,1108,45,0,500,545,138,569,0,10858,11427,1946,0,0,0,0
12653,WEST GODAVARI,Narasapuram,CHITTAVARAM,258,14,449,721,98,9,170,277,213,2603,562,4809,7974,4256,2,0,4,6
12654,WEST GODAVARI,Narasapuram,DHARBAREVU,21,0,357,378,10,0,182,192,162,391,0,7232,7623,5051,0,0,7,7
12655,WEST GODAVARI,Narasapuram,GONDI,96,0,235,331,0,0,0,0,0,0,0,0,0,0,0,0,0,0
12656,WEST GODAVARI,Narasapuram,K.BETAPUDI,87,0,232,319,20,0,56,76,17,267,0,820,1087,184,0,0,0,0
12657,WEST GODAVARI,Narasapuram,KOPPARRU,423,34,755,1212,0,0,0,0,0,0,0,0,0,0,0,0,0,0
12658,WEST GODAVARI,Narasapuram,L.B.CHERLA,60,12,838,910,12,3,331,346,292,405,70,5359,5834,2878,0,0,0,0
12659,WEST GODAVARI,Narasapuram,LAKSHMANESWARAM,71,1,684,756,4,0,208,212,187,66,0,5411,5477,2629,0,0,0,0
12660,WEST GODAVARI,Narasapuram,LIKHITHAPUDI,146,19,263,428,3,0,1,4,4,48,0,20,68,55,0,0,0,0
12661,WEST GODAVARI,Narasapuram,MALLAVARAM,336,6,176,518,129,1,47,177,129,1946,34,1280,3260,1613,0,0,1,1
12662,WEST GODAVARI,Narasapuram,MALLAVARAMLANKA,199,5,152,356,98,0,100,198,136,4611,0,4461,9072,4179,8,0,4,12
12663,WEST GODAVARI,Narasapuram,MARRITHIPPA,25,0,250,275,11,0,115,126,101,106,0,1137,1243,606,0,0,0,0
12664,WEST GODAVARI,Narasapuram,NAVARASAPURAM NEW,156,47,18,221,0,0,0,0,0,0,0,0,0,0,0,0,0,0
12665,WEST GODAVARI,Narasapuram,NAVARASAPURAM OLD,102,1,112,215,0,0,0,0,0,0,0,0,0,0,0,0,0,0
12666,WEST GODAVARI,Narasapuram,PASALADEVI,57,0,554,611,10,0,184,194,23,240,0,5292,5532,434,0,0,2,2
12667,WEST GODAVARI,Narasapuram,PEDALANKA,62,1,242,305,46,0,146,192,138,1234,0,3456,4690,1666,0,0,0,0
12668,WEST GODAVARI,Narasapuram,PEDAMINAVARILANKA,6,2,559,567,0,0,0,0,0,0,0,0,0,0,0,0,0,0
12669,WEST GODAVARI,Narasapuram,RAJUGARITHOTA,75,0,118,193,25,0,35,60,24,441,0,651,1092,226,0,0,0,0
12670,WEST GODAVARI,Narasapuram,RUSTUMBADA,207,1,481,689,7,0,18,25,14,172,0,330,502,201,0,0,0,0
12671,WEST GODAVARI,Narasapuram,SARIPALLE,329,1,171,501,18,0,9,27,15,213,0,128,341,122,0,0,0,0
12672,WEST GODAVARI,Narasapuram,SARVA,50,0,597,647,15,0,168,183,43,191,0,2531,2722,604,0,0,0,0
12673,WEST GODAVARI,Narasapuram,SEETHARAMAPURAM NORTH,52,0,306,358,0,0,7,7,7,0,0,116,116,51,0,0,0,0
12674,WEST GODAVARI,Narasapuram,SEETHARAMAPURAM SOUTH,411,44,402,857,21,0,6,27,24,572,0,89,661,459,0,0,0,0
12675,WEST GODAVARI,Narasapuram,THURPUTALLU,104,1,1113,1218,19,1,200,220,102,700,13,4963,5676,1731,0,0,0,0
12676,WEST GODAVARI,Narasapuram,VEMULADEEVI EAST,76,1,650,727,0,0,1,1,1,0,0,20,20,20,0,0,0,0
12677,WEST GODAVARI,Narasapuram,VEMULADEVI WEST,118,0,1370,1488,40,0,315,355,177,541,0,6757,7298,2733,0,0,5,5
12678,WEST GODAVARI,Narasapuram,YERRAMSETTIVARIPURAM,132,0,757,889,15,0,163,178,106,450,0,3580,4030,1918,0,0,0,0
12679,WEST GODAVARI,Nidadavole,ATLAPADU,272,2,188,462,3,0,1,4,0,54,0,20,74,0,0,0,0,0
12680,WEST GODAVARI,Nidadavole,D.MUPPAVARAM,179,4,237,420,25,0,49,74,70,2023,0,3737,5760,4768,13,0,14,27
12681,WEST GODAVARI,Nidadavole,GOPAVARAM,146,0,218,364,0,0,0,0,0,0,0,0,0,0,0,0,0,0
12682,WEST GODAVARI,Nidadavole,JEEDIGUNTA,164,1,246,411,0,0,0,0,0,0,0,0,0,0,0,0,0,0
12683,WEST GODAVARI,Nidadavole,KALAVACHERLA,242,0,166,408,9,0,8,17,14,180,0,160,340,162,0,0,0,0
12684,WEST GODAVARI,Nidadavole,KAMSALIPALEM,205,2,421,628,51,1,87,139,21,423,11,670,1104,95,0,0,0,0
12685,WEST GODAVARI,Nidadavole,KATA KOTESWARAM,144,5,224,373,0,0,0,0,0,0,0,0,0,0,0,0,0,0
12686,WEST GODAVARI,Nidadavole,KORUMAMIDI,596,22,185,803,52,0,2,54,34,829,0,18,847,326,0,0,0,0
12687,WEST GODAVARI,Nidadavole,KORUPALLE,173,6,312,491,69,1,167,237,178,569,2,1654,2225,1119,0,0,0,0
12688,WEST GODAVARI,Nidadavole,MUNIPALLE,231,11,222,464,111,3,77,191,147,2076,30,1302,3408,1842,0,0,0,0
12689,WEST GODAVARI,Nidadavole,PANDALAPARRU,188,5,376,569,0,0,0,0,0,0,0,0,0,0,0,0,0,0
12690,WEST GODAVARI,Nidadavole,PENDYALA,172,7,413,592,15,2,21,38,31,300,40,404,744,326,0,0,0,0
12691,WEST GODAVARI,Nidadavole,PURUSHOTHAPALLE,332,5,234,571,102,0,57,159,144,1074,0,1351,2425,1917,0,0,0,0
12692,WEST GODAVARI,Nidadavole,RAVIMETLA,177,1,403,581,62,0,153,215,171,1617,0,3979,5596,3581,0,0,0,0
12693,WEST GODAVARI,Nidadavole,SAMISRAGUDEM,606,0,302,908,121,0,4,125,102,6810,0,65,6875,4597,23,0,0,23
12694,WEST GODAVARI,Nidadavole,SETTIPETA,226,1,232,459,71,0,112,183,61,1315,0,2993,4308,888,0,0,0,0
12695,WEST GODAVARI,Nidadavole,SINGAVARAM,94,16,251,361,79,13,207,299,237,2155,286,4870,7311,3573,0,0,0,0
12696,WEST GODAVARI,Nidadavole,SURAPURAM,1,0,134,135,0,0,0,0,0,0,0,0,0,0,0,0,0,0
12697,WEST GODAVARI,Nidadavole,TADIMALLA,372,28,289,689,77,14,26,117,93,4202,183,1138,5523,2822,19,0,5,24
12698,WEST GODAVARI,Nidadavole,TALLAPALEM,230,0,284,514,5,0,16,21,10,100,0,305,405,102,0,0,0,0
12699,WEST GODAVARI,Nidadavole,THIMMARAJUPALEM,285,20,65,370,20,1,6,27,18,355,5,90,450,139,0,0,0,0
12700,WEST GODAVARI,Nidadavole,UNAKARAMILLI,72,0,76,148,0,0,0,0,0,0,0,0,0,0,0,0,0,0
12701,WEST GODAVARI,Nidadavole,VIJJESWARAM,143,0,326,469,60,0,50,110,68,2215,0,1896,4111,1607,3,0,1,4
12702,WEST GODAVARI,Nidamarru,ADEVIKOLANU,151,12,969,1132,46,1,423,470,108,1126,2,7397,8525,1319,0,0,1,1
12703,WEST GODAVARI,Nidamarru,AMUDALAPPALLE,82,0,10,92,59,0,4,63,53,1735,0,79,1814,991,0,0,0,0
12704,WEST GODAVARI,Nidamarru,BAVAYAPALEM,151,6,430,587,91,2,164,257,115,1957,16,3084,5057,1826,0,0,0,0
12705,WEST GODAVARI,Nidamarru,BUVVANAPALLE,185,1,762,948,46,0,114,160,58,996,0,1787,2783,827,0,0,0,0
12706,WEST GODAVARI,Nidamarru,BYNEPALLELLE,65,0,103,168,3,0,22,25,15,60,0,330,390,129,0,0,0,0
12707,WEST GODAVARI,Nidamarru,CHANAMILLI,100,0,611,711,62,0,424,486,154,2099,0,14417,16516,4109,1,0,4,5
12708,WEST GODAVARI,Nidamarru,CHINANINDRAKOLANU,63,0,283,346,1,0,20,21,16,3,0,150,153,80,0,0,0,0
12709,WEST GODAVARI,Nidamarru,DEVARAGOPAVARAM,26,0,342,368,5,0,172,177,41,41,0,4335,4376,951,0,0,1,1
12710,WEST GODAVARI,Nidamarru,ENIKAPALLI,86,1,176,263,18,0,47,65,30,167,0,501,668,220,0,0,0,0
12711,WEST GODAVARI,Nidamarru,GUNAPARRU,65,0,179,244,47,0,120,167,99,699,0,1527,2226,777,0,0,0,0
12712,WEST GODAVARI,Nidamarru,KROVVIDI,225,0,374,599,43,0,155,198,113,731,0,3166,3897,1355,0,0,0,0
12713,WEST GODAVARI,Nidamarru,MAUDALAPARRU,140,0,264,404,38,0,20,58,42,704,0,206,910,496,0,0,0,0
12714,WEST GODAVARI,Nidamarru,NIDAMARRU,170,18,1091,1279,32,1,404,437,201,452,20,10688,11160,2567,0,0,9,9
12715,WEST GODAVARI,Nidamarru,PEDANINDRAKOLANU,382,6,839,1227,35,0,236,271,83,873,0,3236,4109,991,0,0,0,0
12716,WEST GODAVARI,Nidamarru,SIDDAPURAM,3,0,160,163,1,0,51,52,27,3,0,1095,1098,471,0,0,0,0
12717,WEST GODAVARI,Nidamarru,THOKALAPALLE,78,1,784,863,39,0,229,268,232,337,0,2693,3030,1859,0,0,0,0
12718,WEST GODAVARI,Palacole,AAGARTHIPALEM,229,1,226,456,82,0,59,141,94,2150,0,1377,3527,1894,0,0,0,0
12719,WEST GODAVARI,Palacole,AGARRU,326,9,198,533,117,6,72,195,152,2034,49,1307,3390,1934,0,0,0,0
12720,WEST GODAVARI,Palacole,ARATLAKATLA,209,1,349,559,85,1,79,165,132,707,16,742,1465,725,0,0,0,0
12721,WEST GODAVARI,Palacole,BALLIPADU,176,0,105,281,10,0,0,10,3,200,0,0,200,48,0,0,0,0
12722,WEST GODAVARI,Palacole,BHAVVESWARAM,95,5,298,398,0,0,3,3,2,0,0,36,36,12,0,0,0,0
12723,WEST GODAVARI,Palacole,CHANDAPARRU,260,1,0,261,59,1,0,60,49,542,6,0,548,374,0,0,0,0
12724,WEST GODAVARI,Palacole,CHINTAPARRU,233,11,366,610,118,5,159,282,203,2206,25,3088,5319,1899,2,0,2,4
12725,WEST GODAVARI,Palacole,DAGGULURU,139,17,178,334,16,0,0,16,13,150,0,0,150,83,0,0,0,0
12726,WEST GODAVARI,Palacole,DIGAMARRU,269,4,180,453,57,3,58,118,86,844,29,686,1559,954,0,0,0,0
12727,WEST GODAVARI,Palacole,GAVARAPETA,2,2,494,498,1,0,234,235,199,3,0,1105,1108,589,0,0,0,0
12728,WEST GODAVARI,Palacole,GORINTADA,63,0,136,199,25,0,53,78,56,317,0,938,1255,471,0,0,0,0
12729,WEST GODAVARI,Palacole,KAPAVARAM,288,8,214,510,47,0,46,93,83,338,0,251,589,369,0,0,0,0
12730,WEST GODAVARI,Palacole,KOTHAPETA,127,7,395,529,4,0,0,4,2,35,0,0,35,22,0,0,0,0
12731,WEST GODAVARI,Palacole,LANKALAKODERU,517,3,231,751,242,0,74,316,235,3609,0,1127,4736,2501,0,0,0,0
12732,WEST GODAVARI,Palacole,PALACOLE,521,17,289,827,124,3,18,145,120,2207,56,267,2530,1618,0,0,0,0
12733,WEST GODAVARI,Palacole,PALAMURU,83,0,129,212,40,0,52,92,60,1193,0,983,2176,962,0,0,0,0
12734,WEST GODAVARI,Palacole,PEDAMAMIDIPALLE,36,0,290,326,14,0,135,149,122,80,0,1049,1129,810,0,0,0,0
12735,WEST GODAVARI,Palacole,POOLAPALLE,176,4,422,602,1,0,0,1,0,14,0,0,14,0,0,0,0,0
12736,WEST GODAVARI,Palacole,SAGAMCHERUVU,42,2,281,325,9,2,89,100,91,63,35,1140,1238,951,0,0,0,0
12737,WEST GODAVARI,Palacole,SIVADEVUNICHIKKALA,306,5,287,598,97,1,61,159,106,1562,13,931,2506,1416,0,0,0,0
12738,WEST GODAVARI,Palacole,TILLAPUDI,185,3,561,749,125,1,308,434,186,4064,14,5413,9491,3033,7,0,0,7
12739,WEST GODAVARI,Palacole,ULLAMPARRU,101,18,340,459,22,2,44,68,55,174,11,309,494,306,0,0,0,0
12740,WEST GODAVARI,Palacole,VADLAVANIPALEM,65,0,157,222,21,0,84,105,92,419,0,1747,2166,1610,0,0,0,0
12741,WEST GODAVARI,Palacole,VALAMARRU,102,0,97,199,41,0,35,76,59,529,0,458,987,655,0,0,0,0
12742,WEST GODAVARI,Palacole,VARIDHANAM,44,12,188,244,23,3,54,80,74,481,11,802,1294,1046,0,0,0,0
12743,WEST GODAVARI,Palacole,VELIVELA,164,2,257,423,4,0,5,9,7,47,0,70,117,55,0,0,0,0
12744,WEST GODAVARI,Palacole,VENKATAPURAM,103,0,172,275,53,0,111,164,119,584,0,1389,1973,956,0,0,0,0
12745,WEST GODAVARI,Palakoderu,GARAGAPARRU,237,5,888,1130,1,0,7,8,6,20,0,129,149,62,0,0,0,0
12746,WEST GODAVARI,Palakoderu,GOLLALAKODERU,87,7,566,660,10,0,237,247,234,108,0,3504,3612,2344,0,0,0,0
12747,WEST GODAVARI,Palakoderu,GORAGANAMUDI,165,0,153,318,46,0,40,86,71,1530,0,1218,2748,1838,0,0,0,0
12748,WEST GODAVARI,Palakoderu,KONDEPUDI,11,2,315,328,7,2,202,211,204,97,24,4237,4358,2696,0,0,0,0
12749,WEST GODAVARI,Palakoderu,KORUKOLLU,232,24,551,807,1,0,278,279,241,20,0,5083,5103,3108,0,0,0,0
12750,WEST GODAVARI,Palakoderu,KUMUDAVALLI,29,0,495,524,5,0,141,146,114,189,0,5098,5287,3392,0,0,0,0
12751,WEST GODAVARI,Palakoderu,MOGALLU,275,41,967,1283,99,4,153,256,225,1514,92,1797,3403,2063,0,0,0,0
12752,WEST GODAVARI,Palakoderu,MYPA,60,0,166,226,29,0,87,116,54,766,0,2546,3312,1207,0,0,0,0
12753,WEST GODAVARI,Palakoderu,PALAKODERU,319,0,619,938,129,0,236,365,334,2175,0,3016,5191,3773,0,0,0,0
12754,WEST GODAVARI,Palakoderu,PENNADA AGRAHARAM,113,7,708,828,42,3,322,367,335,813,23,5375,6211,4841,0,0,0,0
12755,WEST GODAVARI,Palakoderu,SRUNGAVRUKSHAM,463,12,626,1101,81,3,168,252,229,1528,61,4626,6215,3756,0,0,0,0
12756,WEST GODAVARI,Palakoderu,VENDRA,151,9,427,587,60,6,136,202,168,803,106,2015,2924,2067,0,0,0,0
12757,WEST GODAVARI,Palakoderu,VENDRA AGRAHARAM,0,0,144,144,0,0,62,62,59,0,0,1472,1472,1092,0,0,0,0
12758,WEST GODAVARI,Palakoderu,VISSAKODERU,352,3,624,979,11,0,33,44,37,107,0,328,435,287,0,0,0,0
12759,WEST GODAVARI,Pedapadu,APPANAVEEDU,273,11,138,422,120,1,27,148,149,4483,14,1079,5576,4076,2,0,1,3
12760,WEST GODAVARI,Pedapadu,EPURU,375,14,333,722,0,0,0,0,0,0,0,0,0,0,0,0,0,0
12761,WEST GODAVARI,Pedapadu,GOGUNTA,88,0,62,150,44,0,36,80,75,2269,0,1747,4016,1981,2,0,0,2
12762,WEST GODAVARI,Pedapadu,GUDIPADU,120,0,218,338,1,0,0,1,1,20,0,0,20,10,0,0,0,0
12763,WEST GODAVARI,Pedapadu,JAYAPURAM,8,0,234,242,0,0,2,2,1,0,0,40,40,10,0,0,0,0
12764,WEST GODAVARI,Pedapadu,KALAPARRU,153,6,527,686,71,2,304,377,348,646,50,4808,5504,3116,0,0,0,0
12765,WEST GODAVARI,Pedapadu,KOKKIRIPADU,264,0,379,643,0,0,0,0,0,0,0,0,0,0,0,0,0,0
12766,WEST GODAVARI,Pedapadu,KONIKI,55,0,115,170,25,0,45,70,62,79,0,117,196,147,0,0,0,0
12767,WEST GODAVARI,Pedapadu,KOTHAMUPPARRU,221,13,213,447,138,2,109,249,216,4201,56,3305,7562,3687,4,0,0,4
12768,WEST GODAVARI,Pedapadu,KOTHURU,175,20,479,674,10,0,151,161,144,47,0,598,645,359,0,0,0,0
12769,WEST GODAVARI,Pedapadu,NAIDUGUDEM,380,1,193,574,249,1,102,352,347,3564,5,1059,4628,2545,0,0,0,0
12770,WEST GODAVARI,Pedapadu,PATHAMUPPARRU,452,0,22,474,4,0,0,4,4,66,0,0,66,32,0,0,0,0
12771,WEST GODAVARI,Pedapadu,PEDAPADU,684,66,927,1677,302,43,496,841,791,4815,642,8390,13847,8348,0,0,0,0
12772,WEST GODAVARI,Pedapadu,PUNUKOLLU,134,0,74,208,94,0,27,121,103,2974,0,1029,4003,1981,1,0,0,1
12773,WEST GODAVARI,Pedapadu,RAJUPETA,162,0,95,257,0,0,0,0,0,0,0,0,0,0,0,0,0,0
12774,WEST GODAVARI,Pedapadu,S. KOTHAPALLE,130,4,100,234,79,3,66,148,135,2932,58,2029,5019,2547,0,0,0,0
12775,WEST GODAVARI,Pedapadu,SATYAVOLU,83,0,466,549,56,0,269,325,284,1100,0,4795,5895,3229,0,0,0,0
12776,WEST GODAVARI,Pedapadu,TALLAGUDEM,161,0,7,168,130,0,2,132,120,4813,0,139,4952,2848,1,0,0,1
12777,WEST GODAVARI,Pedapadu,THOTAGUDEM,60,0,161,221,3,0,4,7,6,45,0,80,125,60,0,0,0,0
12778,WEST GODAVARI,Pedapadu,VADDIGUDEM,95,2,503,600,0,0,0,0,0,0,0,0,0,0,0,0,0,0
12779,WEST GODAVARI,Pedapadu,VASANTHAWADA,241,3,484,728,14,0,137,151,130,168,0,1316,1484,798,0,0,0,0
12780,WEST GODAVARI,Pedapadu,VATLURU,550,16,562,1128,8,1,5,14,12,122,8,86,216,144,0,0,0,0
12781,WEST GODAVARI,Pedapadu,VEERAMMAKUNTA,42,33,532,607,0,0,2,2,1,0,0,40,40,10,0,0,0,0
12782,WEST GODAVARI,Pedavegi,AMNAPALEM,321,2,230,553,97,1,67,165,142,814,10,697,1521,908,0,0,0,0
12783,WEST GODAVARI,Pedavegi,ANKANAGUDA,663,2,330,995,301,1,169,471,486,15869,87,8209,24165,17675,34,0,6,40
12784,WEST GODAVARI,Pedavegi,B. SINGAVARAM,64,31,327,422,29,0,232,261,260,1326,0,14819,16145,8209,2,0,60,62
12785,WEST GODAVARI,Pedavegi,BAPIRAJUGUDEM,360,18,392,770,22,0,28,50,54,132,0,200,332,189,0,0,0,0
12786,WEST GODAVARI,Pedavegi,BHOGAPURAM,142,6,423,571,93,1,149,243,226,6259,7,5927,12193,7028,26,0,15,41
12787,WEST GODAVARI,Pedavegi,CHAKRAYAGUDEM,29,3,328,360,17,2,175,194,157,529,46,6903,7478,4552,0,0,4,4
12788,WEST GODAVARI,Pedavegi,DUGGIRALA,625,0,124,749,227,0,63,290,264,4581,0,796,5377,3419,0,0,0,0
12789,WEST GODAVARI,Pedavegi,GARLAMADUGU,359,0,275,634,48,0,64,112,87,2155,0,3065,5220,2788,6,0,2,8
12790,WEST GODAVARI,Pedavegi,JAGANNADHAPURAM,517,0,92,609,152,0,13,165,155,5124,0,412,5536,2700,7,0,0,7
12791,WEST GODAVARI,Pedavegi,JANAMPETA,161,0,499,660,31,0,188,219,204,403,0,2903,3306,2153,0,0,0,0
12792,WEST GODAVARI,Pedavegi,K.KANNAPURAM,148,2,277,427,50,1,80,131,96,2555,66,1634,4255,2288,2,0,0,2
12793,WEST GODAVARI,Pedavegi,KAPPULAVARIGUDEM,307,0,218,525,75,0,106,181,174,2379,0,2839,5218,2810,1,0,2,3
12794,WEST GODAVARI,Pedavegi,KAVAGUNTA,263,3,111,377,92,2,7,101,90,3293,21,91,3405,2009,1,0,0,1
12795,WEST GODAVARI,Pedavegi,KONDALARAOPALEM,238,1,263,502,95,0,22,117,105,2570,0,376,2946,1368,1,0,0,1
12796,WEST GODAVARI,Pedavegi,KOPPAKA,453,0,275,728,185,0,73,258,223,7585,0,1253,8838,4965,11,0,0,11
12797,WEST GODAVARI,Pedavegi,KUCHIPUDI,631,13,548,1192,169,3,188,360,326,4071,51,7169,11291,6334,3,0,7,10
12798,WEST GODAVARI,Pedavegi,LAXMIPURAM,257,1,170,428,22,0,1,23,2,604,0,7,611,54,1,0,0,1
12799,WEST GODAVARI,Pedavegi,MUNDUR,732,7,367,1106,272,4,137,413,383,9850,101,4410,14361,9270,4,0,1,5
12800,WEST GODAVARI,Pedavegi,NADIPALLE,261,3,242,506,79,0,124,203,175,2024,0,5600,7624,4606,1,0,10,11
12801,WEST GODAVARI,Pedavegi,NYAYAMPALLE,267,0,170,437,76,0,10,86,75,1277,0,159,1436,710,0,0,0,0
12802,WEST GODAVARI,Pedavegi,PEDAKADIM,48,1,384,433,0,0,7,7,7,0,0,140,140,80,0,0,0,0
12803,WEST GODAVARI,Pedavegi,PEDAVEGI,206,23,463,692,17,0,48,65,54,378,0,1678,2056,993,0,0,6,6
12804,WEST GODAVARI,Pedavegi,PINAKADIMI,230,4,318,552,108,1,147,256,229,4205,4,3822,8031,4237,1,0,0,1
12805,WEST GODAVARI,Pedavegi,RAMASINGAVARAM,409,6,419,834,169,2,181,352,272,6291,25,6617,12933,6995,7,0,12,19
12806,WEST GODAVARI,Pedavegi,RATNALAKUNTA,238,2,263,503,63,0,18,81,63,852,0,315,1167,564,0,0,0,0
12807,WEST GODAVARI,Pedavegi,RAYANNAPALEM,350,1,422,773,6,0,19,25,28,120,0,380,500,266,0,0,0,0
12808,WEST GODAVARI,Pedavegi,TALLAGOKAVARAM,269,3,185,457,130,0,68,198,159,3550,0,1586,5136,2811,2,0,1,3
12809,WEST GODAVARI,Pedavegi,VANGURU,438,6,229,673,181,4,132,317,270,5617,104,4008,9729,4873,6,0,5,11
12810,WEST GODAVARI,Pedavegi,VEGIVADA,451,4,616,1071,201,3,196,400,352,8438,95,9710,18243,9755,26,0,25,51
12811,WEST GODAVARI,Pedavegi,VIJAYARAI,244,12,1181,1437,99,4,553,656,631,3558,103,12957,16618,12052,2,0,0,2
12812,WEST GODAVARI,Pentapadu,AKUTEEGAPADU,200,4,189,393,90,0,62,152,54,1506,0,736,2242,585,0,0,0,0
12813,WEST GODAVARI,Pentapadu,ALAMPURAM,209,12,692,913,65,1,353,419,365,903,27,5928,6858,4147,0,0,0,0
12814,WEST GODAVARI,Pentapadu,B. KONDEPADU,95,1,297,393,0,0,4,4,2,0,0,44,44,24,0,0,0,0
12815,WEST GODAVARI,Pentapadu,BODAPADU,13,4,313,330,7,2,215,224,174,85,14,3283,3382,1741,0,0,0,0
12816,WEST GODAVARI,Pentapadu,CHINTAPALLI,164,3,132,299,120,2,70,192,140,1650,21,849,2520,1044,0,0,0,0
12817,WEST GODAVARI,Pentapadu,DARSIPARRU,154,1,241,396,26,0,7,33,24,415,0,107,522,250,0,0,0,0
12818,WEST GODAVARI,Pentapadu,JATTAPALEM,203,8,346,557,108,0,205,313,259,1064,0,2769,3833,1763,0,0,0,0
12819,WEST GODAVARI,Pentapadu,KASPA PENTAPADU,262,1,260,523,5,0,8,13,10,70,0,113,183,80,0,0,0,0
12820,WEST GODAVARI,Pentapadu,KORUMILLI,102,0,120,222,66,0,47,113,32,1478,0,780,2258,411,0,0,0,0
12821,WEST GODAVARI,Pentapadu,MEENAVALLURU,1,0,519,520,0,0,195,195,152,0,0,1209,1209,600,0,0,0,0
12822,WEST GODAVARI,Pentapadu,MOUNJDEPADU,46,0,314,360,18,0,227,245,161,301,0,5475,5776,2298,0,0,0,0
12823,WEST GODAVARI,Pentapadu,MUDUNURU,198,0,371,569,37,0,46,83,55,1376,0,686,2062,844,3,0,0,3
12824,WEST GODAVARI,Pentapadu,PADAMARAVIPPARRU,185,7,1072,1264,60,0,155,215,128,1070,0,2044,3114,1228,0,0,0,0
12825,WEST GODAVARI,Pentapadu,PARIMELLA,214,6,331,551,126,4,140,270,103,1187,23,1116,2326,599,0,0,0,0
12826,WEST GODAVARI,Pentapadu,PENTAPADU,319,2,944,1265,13,0,16,29,22,181,0,240,421,219,0,0,0,0
12827,WEST GODAVARI,Pentapadu,PRATHIPADU,222,1,183,406,10,0,10,20,14,176,0,148,324,142,0,0,0,0
12828,WEST GODAVARI,Pentapadu,RACHARLA,112,5,217,334,1,0,1,2,2,14,0,20,34,24,0,0,0,0
12829,WEST GODAVARI,Pentapadu,RAMACHANDRAPURAM,130,0,36,166,6,0,1,7,6,57,0,12,69,36,0,0,0,0
12830,WEST GODAVARI,Pentapadu,RAVIPADU,117,0,544,661,86,0,383,469,72,1524,0,5683,7207,988,0,0,0,0
12831,WEST GODAVARI,Pentapadu,UMAMAHESWARAM,169,3,67,239,93,1,21,115,80,1467,14,317,1798,850,0,0,0,0
12832,WEST GODAVARI,Pentapadu,VALLURUPALLI,192,0,275,467,8,0,10,18,5,73,0,79,152,55,0,0,0,0
12833,WEST GODAVARI,Pentapadu,YANALAPALLE,135,2,110,247,75,0,62,137,55,2738,0,1887,4625,1251,0,0,2,2
12834,WEST GODAVARI,Penugonda,CHINAMALLAM,148,9,434,591,36,1,149,186,153,447,49,1643,2139,1271,0,0,0,0
12835,WEST GODAVARI,Penugonda,DEVA,236,6,216,458,29,1,12,42,39,194,6,98,298,176,0,0,0,0
12836,WEST GODAVARI,Penugonda,DONGARAVIPALEM,116,9,239,364,0,0,2,2,1,0,0,26,26,20,0,0,0,0
12837,WEST GODAVARI,Penugonda,ILAPARRU,309,5,256,570,4,0,30,34,25,28,0,209,237,170,0,0,0,0
12838,WEST GODAVARI,Penugonda,KOTHALAPARRU,149,3,316,468,53,0,149,202,171,264,0,1169,1433,797,0,0,0,0
12839,WEST GODAVARI,Penugonda,MULAPARRU,574,2,284,860,112,1,139,252,206,1323,20,3007,4350,2628,0,0,0,0
12840,WEST GODAVARI,Penugonda,MUNAMARRU,77,6,229,312,27,1,67,95,56,544,8,1027,1579,848,0,0,0,0
12841,WEST GODAVARI,Penugonda,NADIPUDI,137,3,487,627,24,1,38,63,43,656,60,545,1261,658,0,0,0,0
12842,WEST GODAVARI,Penugonda,PENUGONDA,574,69,948,1591,2,0,8,10,2,14,0,96,110,30,0,0,0,0
12843,WEST GODAVARI,Penugonda,RAMANNAPALEM,58,4,319,381,3,4,55,62,17,98,84,1326,1508,318,0,0,0,0
12844,WEST GODAVARI,Penugonda,SIDHANTHAM,415,6,783,1204,65,0,144,209,190,962,0,2666,3628,2510,0,0,1,1
12845,WEST GODAVARI,Penugonda,TAMARADA,102,0,358,460,0,0,3,3,1,0,0,32,32,16,0,0,0,0
12846,WEST GODAVARI,Penugonda,VADALI,247,1,394,642,1,0,5,6,1,20,0,100,120,20,0,0,0,0
12847,WEST GODAVARI,Penugonda,VENKATRAMAPURAM,186,6,146,338,2,0,3,5,1,37,0,60,97,20,0,0,0,0
12848,WEST GODAVARI,Penumantra,ALAMURU,244,1,309,554,67,1,87,155,132,896,11,1116,2023,1234,0,0,0,0
12849,WEST GODAVARI,Penumantra,BHATLAMAGUTUR,188,1,141,330,92,0,94,186,142,3163,0,3108,6271,2739,2,0,0,2
12850,WEST GODAVARI,Penumantra,GARUVU,3,2,287,292,1,0,78,79,72,26,0,2351,2377,1654,0,0,0,0
12851,WEST GODAVARI,Penumantra,JUTTIGA,92,6,288,386,30,0,56,86,76,571,0,959,1530,1026,0,0,0,0
12852,WEST GODAVARI,Penumantra,KOYYETIPADU,157,27,144,328,81,3,81,165,143,850,31,1102,1983,1223,0,0,0,0
12853,WEST GODAVARI,Penumantra,MALLIPUDI,230,1,525,756,31,0,67,98,77,438,0,1402,1840,911,0,0,0,0
12854,WEST GODAVARI,Penumantra,MAMUDURU,115,0,730,845,0,0,4,4,4,0,0,53,53,32,0,0,0,0
12855,WEST GODAVARI,Penumantra,MARTERU,222,0,92,314,69,0,9,78,78,1823,0,255,2078,1605,0,0,0,0
12856,WEST GODAVARI,Penumantra,NATTARAMESWARAM,124,8,196,328,38,0,4,42,38,134,0,39,173,111,0,0,0,0
12857,WEST GODAVARI,Penumantra,NEGGIPUDI,96,0,421,517,3,0,36,39,40,35,0,1060,1095,919,0,0,0,0
12858,WEST GODAVARI,Penumantra,NELAMURU,231,13,170,414,66,2,26,94,71,2133,78,564,2775,1430,0,0,0,0
12859,WEST GODAVARI,Penumantra,ODURU,394,12,159,565,230,8,38,276,203,2837,90,382,3309,1727,0,0,0,0
12860,WEST GODAVARI,Penumantra,PENUMANTRA,390,31,988,1409,0,0,0,0,0,0,0,0,0,0,0,0,0,0
12861,WEST GODAVARI,Penumantra,POLAMURU,227,3,747,977,26,0,49,75,59,450,0,894,1344,640,0,0,0,0
12862,WEST GODAVARI,Penumantra,SATYAVARAM,194,8,183,385,115,1,101,217,191,1774,8,866,2648,1287,0,0,0,0
12863,WEST GODAVARI,Penumantra,SOMARAJUILLINDALAPARRU,101,0,534,635,25,0,130,155,142,392,0,2722,3114,2108,0,0,0,0
12864,WEST GODAVARI,Penumantra,VELAGALAVARIPALEM,201,2,181,384,55,0,47,102,88,918,0,976,1894,1239,0,0,0,0
12865,WEST GODAVARI,Penumantra,VELAGALERU,161,1,87,249,22,0,10,32,23,269,0,53,322,130,0,0,0,0
12866,WEST GODAVARI,Peravali,AJJARAM,211,6,154,371,24,1,5,30,18,114,20,35,169,77,0,0,0,0
12867,WEST GODAVARI,Peravali,ANNAVARAPPADU,158,5,391,554,6,0,5,11,1,249,0,184,433,6,0,0,0,0
12868,WEST GODAVARI,Peravali,KADIMPADU,45,1,162,208,4,0,2,6,2,46,0,22,68,10,0,0,0,0
12869,WEST GODAVARI,Peravali,KAKARAPARRU,207,7,488,702,12,0,11,23,7,108,0,126,234,62,0,0,0,0
12870,WEST GODAVARI,Peravali,KANURU,289,24,783,1096,37,5,63,105,74,232,62,587,881,434,0,0,0,0
12871,WEST GODAVARI,Peravali,KANURUAGRAHARAM,123,0,519,642,55,0,10,65,45,473,0,133,606,258,0,0,0,0
12872,WEST GODAVARI,Peravali,KAPAVARAM,117,0,508,625,2,0,17,19,0,12,0,134,146,0,0,0,0,0
12873,WEST GODAVARI,Peravali,KHANDAVALLI,662,15,887,1564,14,0,2,16,11,86,0,12,98,55,0,0,0,0
12874,WEST GODAVARI,Peravali,KOTHAPALLEAGRAHARAM,84,2,241,327,19,0,4,23,10,226,0,42,268,85,0,0,0,0
12875,WEST GODAVARI,Peravali,MALLESWARAM,100,4,375,479,33,0,1,34,21,328,0,20,348,137,0,0,0,0
12876,WEST GODAVARI,Peravali,MUKKAMALA,267,15,691,973,32,0,63,95,74,546,0,1319,1865,1292,0,0,1,1
12877,WEST GODAVARI,Peravali,NADUPALLE,292,18,371,681,20,1,25,46,37,79,8,86,173,89,0,0,0,0
12878,WEST GODAVARI,Peravali,NALLAKULAVARIPALEM,1,0,177,178,0,0,2,2,0,0,0,40,40,0,0,0,0,0
12879,WEST GODAVARI,Peravali,PERAVALI,168,1,344,513,19,0,75,94,80,266,0,921,1187,745,0,0,0,0
12880,WEST GODAVARI,Peravali,PITTALAVEMAVARAM,153,6,139,298,32,0,3,35,29,656,0,30,686,402,0,0,0,0
12881,WEST GODAVARI,Peravali,TEEPARRU,185,3,181,369,6,0,0,6,1,54,0,0,54,2,0,0,0,0
12882,WEST GODAVARI,Peravali,USULUMARRU,203,0,412,615,63,0,52,115,68,514,0,390,904,377,0,0,0,0
12883,WEST GODAVARI,Peravali,VENKATARAYAPURAM,1,0,300,301,0,0,5,5,1,0,0,37,37,11,0,0,0,0
12884,WEST GODAVARI,Poduru,APPANNACHERUVU,161,0,30,191,90,0,0,90,70,5275,0,0,5275,2796,5,0,0,5
12885,WEST GODAVARI,Poduru,GUMMALURU,486,8,923,1417,169,4,276,449,388,2882,30,4995,7907,5068,0,0,0,0
12886,WEST GODAVARI,Poduru,J.PURAM,283,0,210,493,7,0,1,8,3,75,0,20,95,31,0,0,0,0
12887,WEST GODAVARI,Poduru,JINNURU,312,3,820,1135,70,1,283,354,317,1203,108,6499,7810,6309,0,1,3,4
12888,WEST GODAVARI,Poduru,K.CHIKKALA,176,0,425,601,76,0,142,218,182,1229,0,3304,4533,2711,0,0,0,0
12889,WEST GODAVARI,Poduru,KAVITAM,497,1,592,1090,198,0,298,496,473,2942,0,6086,9028,6568,0,0,0,0
12890,WEST GODAVARI,Poduru,M.M.PADU,99,2,120,221,51,1,79,131,81,2102,47,3226,5375,2221,3,0,5,8
12891,WEST GODAVARI,Poduru,MATTAPARRU,227,7,646,880,78,1,293,372,339,1055,6,4048,5109,3667,0,0,0,0
12892,WEST GODAVARI,Poduru,P.POLAVARAM,90,1,217,308,40,1,99,140,98,858,42,2420,3320,1617,0,0,1,1
12893,WEST GODAVARI,Poduru,P.VILLURU,261,6,434,701,107,0,82,189,152,1496,0,1147,2643,1573,0,0,0,0
12894,WEST GODAVARI,Poduru,PENUMADAM,519,9,887,1415,113,5,336,454,415,3122,101,7413,10636,7379,2,0,3,5
12895,WEST GODAVARI,Poduru,PODURU,452,2,1159,1613,100,0,316,416,370,1484,0,5680,7164,5140,0,0,0,0
12896,WEST GODAVARI,Poduru,RAVIPADU,126,1,126,253,69,1,48,118,96,1577,21,1096,2694,1594,0,0,0,0
12897,WEST GODAVARI,Poduru,TURPUPALEM,90,1,348,439,58,0,149,207,180,1843,0,2325,4168,2392,0,0,0,0
12898,WEST GODAVARI,Poduru,VADDIPARRU,166,0,441,607,75,0,272,347,263,952,0,3768,4720,2535,0,0,0,0
12899,WEST GODAVARI,Poduru,VEDANGI,315,8,486,809,86,2,155,243,206,1098,25,1336,2459,1679,0,0,0,0
12900,WEST GODAVARI,Polavaram,CHEGONDAPALLE,8,504,27,539,0,300,14,314,242,0,16335,325,16660,8550,0,39,0,39
12901,WEST GODAVARI,Polavaram,GEDDAPALLI,3,326,0,329,1,159,0,160,177,6,3717,0,3723,2318,0,0,0,0
12902,WEST GODAVARI,Polavaram,GUTALA,719,44,1978,2741,220,6,651,877,607,3527,50,18516,22093,10605,0,0,6,6
12903,WEST GODAVARI,Polavaram,ITIKALAKOTA,6,255,26,287,2,159,14,175,174,106,7711,861,8678,5997,0,13,2,15
12904,WEST GODAVARI,Polavaram,JILLELAGUDEM,4,885,21,910,2,471,8,481,465,88,24461,257,24806,14192,0,58,0,58
12905,WEST GODAVARI,Polavaram,KONDRUKOTA,130,1105,223,1458,60,417,111,588,534,2907,18113,3820,24840,13765,1,17,3,21
12906,WEST GODAVARI,Polavaram,KORUTURU,26,465,64,555,4,255,29,288,254,95,10227,721,11043,6087,0,4,0,4
12907,WEST GODAVARI,Polavaram,L.N.D.PETA,143,10,767,920,41,2,322,365,329,478,61,9823,10362,7728,0,0,8,8
12908,WEST GODAVARI,Polavaram,MAMIDIGONDA,2,243,0,245,0,138,0,138,131,0,7245,0,7245,4454,0,18,0,18
12909,WEST GODAVARI,Polavaram,PATTISAM,235,11,1082,1328,105,8,422,535,396,5494,345,20035,25874,13995,11,0,19,30
12910,WEST GODAVARI,Polavaram,POLAVARAM,723,138,2792,3653,254,85,987,1326,885,12578,5583,48934,67095,34554,21,6,55,82
12911,WEST GODAVARI,Polavaram,PRAGADA PALLE,163,379,349,891,84,220,122,426,412,4465,13019,6111,23595,14051,6,25,8,39
12912,WEST GODAVARI,Polavaram,PYDIPAKA,159,2,217,378,44,0,48,92,62,2180,0,2524,4704,1758,4,0,2,6
12913,WEST GODAVARI,Polavaram,THUTIGUNTA,99,433,42,574,68,281,25,374,364,3207,14936,951,19094,10535,1,12,0,13
12914,WEST GODAVARI,Polavaram,VINJARAM,22,728,51,801,4,390,24,418,432,105,19210,1123,20438,11852,0,30,1,31
12915,WEST GODAVARI,T Narasapuram,ALLAMCHERLARAJUPALEM,209,2,264,475,135,2,151,288,281,6786,70,8003,14859,8051,19,0,25,44
12916,WEST GODAVARI,T Narasapuram,APPALARAJUGUDEM,183,82,328,593,100,64,140,304,287,4215,2907,4182,11304,6524,5,6,5,16
12917,WEST GODAVARI,T Narasapuram,BANDAMCHERLA,457,0,288,745,281,0,89,370,384,18060,0,3836,21896,12837,46,0,3,49
12918,WEST GODAVARI,T Narasapuram,BANDIVARIGUDEM,229,124,568,921,76,111,234,421,404,3172,7127,8607,18906,9881,3,12,14,29
12919,WEST GODAVARI,T Narasapuram,BORRAMPALEM,912,15,621,1548,504,3,224,731,694,23770,141,8633,32544,18570,57,1,14,72
12920,WEST GODAVARI,T Narasapuram,EPIGUNTA,210,164,483,857,114,127,159,400,405,5035,6335,3805,15175,9576,14,9,4,27
12921,WEST GODAVARI,T Narasapuram,KOTHAVARAM,487,1,130,618,275,0,33,308,307,21057,0,1644,22701,11097,88,0,4,92
12922,WEST GODAVARI,T Narasapuram,MAKKINAVARIGUDEM,291,147,653,1091,9,63,131,203,198,260,2687,3662,6609,5058,0,4,3,7
12923,WEST GODAVARI,T Narasapuram,MARRIGUDEM,27,518,73,618,1,292,8,301,349,27,15482,318,15827,9150,0,47,1,48
12924,WEST GODAVARI,T Narasapuram,RAJUPOTHEPALLI,375,0,277,652,161,0,36,197,191,4028,0,796,4824,2675,0,0,0,0
12925,WEST GODAVARI,T Narasapuram,T.NARASAPURAM,1389,358,1112,2859,526,184,591,1301,1358,20975,6059,17712,44746,26866,33,21,14,68
12926,WEST GODAVARI,T Narasapuram,TEDLAM,440,2,400,842,289,0,222,511,470,14209,0,6625,20834,10503,20,0,5,25
12927,WEST GODAVARI,T Narasapuram,TIRUMALADEVIPETA,864,101,881,1846,345,46,233,624,557,11800,1591,6860,20251,11799,22,2,7,31
12928,WEST GODAVARI,T Narasapuram,VALLAMPATLA,547,0,677,1224,68,0,174,242,221,2750,0,8267,11017,6612,3,0,11,14
12929,WEST GODAVARI,T Narasapuram,VILAGAPADU,519,0,519,1038,208,0,63,271,272,9790,0,1249,11039,6400,21,0,0,21
12930,WEST GODAVARI,Tadepalligudem,APPARAOPETA,101,1,490,592,51,1,190,242,175,1114,2,5460,6576,2799,0,0,4,4
12931,WEST GODAVARI,Tadepalligudem,ARUGOLANU,284,4,586,874,159,1,260,420,305,3262,11,5478,8751,4167,2,0,2,4
12932,WEST GODAVARI,Tadepalligudem,ARULLA,181,0,123,304,112,0,72,184,184,3776,0,2140,5916,3262,0,0,0,0
12933,WEST GODAVARI,Tadepalligudem,BANGARUGUDEM,215,3,426,644,13,0,40,53,43,26,0,260,286,138,0,0,0,0
12934,WEST GODAVARI,Tadepalligudem,CHINA TADEPALLE,226,20,245,491,163,1,146,310,253,4543,34,6615,11192,5245,0,0,7,7
12935,WEST GODAVARI,Tadepalligudem,DANDAGARRA,4,4,801,809,0,1,126,127,28,0,6,1712,1718,186,0,0,0,0
12936,WEST GODAVARI,Tadepalligudem,JAGANNADHAPURAM,443,37,800,1280,125,1,121,247,94,1982,10,1406,3398,525,1,0,0,1
12937,WEST GODAVARI,Tadepalligudem,JAGGANNAPETA,164,15,353,532,82,4,134,220,186,3307,61,5260,8628,5218,3,0,6,9
12938,WEST GODAVARI,Tadepalligudem,KADIYEDDA,240,22,739,1001,146,8,402,556,435,5418,340,10003,15761,8924,3,0,0,3
12939,WEST GODAVARI,Tadepalligudem,KOMMUGUDEM,268,1,213,482,92,0,77,169,131,2644,0,2543,5187,2825,0,0,0,0
12940,WEST GODAVARI,Tadepalligudem,KONDRUPROLU,241,21,332,594,83,7,126,216,194,1329,151,2034,3514,2491,0,0,0,0
12941,WEST GODAVARI,Tadepalligudem,KOTHURU,107,4,526,637,51,0,208,259,67,734,0,2065,2799,636,0,0,0,0
12942,WEST GODAVARI,Tadepalligudem,KRISHNAYAPALEM,223,5,409,637,108,0,127,235,137,1861,0,1317,3178,1427,0,0,0,0
12943,WEST GODAVARI,Tadepalligudem,KUNCHANAPALLE,414,6,328,748,174,0,40,214,166,2189,0,267,2456,1228,0,0,0,0
12944,WEST GODAVARI,Tadepalligudem,L.AGRAHARAM,11,0,409,420,0,0,0,0,0,0,0,0,0,0,0,0,0,0
12945,WEST GODAVARI,Tadepalligudem,MADHAVARAM,356,24,699,1079,120,8,358,486,318,1790,58,5380,7228,3133,0,0,0,0
12946,WEST GODAVARI,Tadepalligudem,MARAMPALLI,58,3,231,292,21,0,97,118,90,319,0,1394,1713,930,0,0,0,0
12947,WEST GODAVARI,Tadepalligudem,METTA UPPARAGUDEM,160,37,585,782,43,14,233,290,227,449,194,3888,4531,2290,0,0,0,0
12948,WEST GODAVARI,Tadepalligudem,MODUGUDUNTA,87,0,553,640,23,0,87,110,89,225,0,1284,1509,795,0,0,0,0
12949,WEST GODAVARI,Tadepalligudem,NANDAMURU,141,3,287,431,1,0,0,1,0,20,0,0,20,0,0,0,0,0
12950,WEST GODAVARI,Tadepalligudem,NAWABPALEM,202,3,410,615,105,2,155,262,145,1675,18,2917,4610,1587,0,0,0,0
12951,WEST GODAVARI,Tadepalligudem,NEELADRIPURAM,193,7,467,667,70,2,103,175,151,1248,66,1659,2973,1725,1,0,1,2
12952,WEST GODAVARI,Tadepalligudem,PADALA,259,1,250,510,168,0,66,234,176,2826,0,875,3701,2087,0,0,0,0
12953,WEST GODAVARI,Tadepalligudem,PATTEMPALEM,262,0,327,589,112,0,152,264,192,3488,0,4905,8393,4858,3,0,6,9
12954,WEST GODAVARI,Tadepalligudem,PEDA TADEPALLE,126,7,395,528,1,0,132,133,53,42,0,6712,6754,2036,0,0,5,5
12955,WEST GODAVARI,Tadepalligudem,PULLAIGUDEM,106,1,358,465,24,0,125,149,120,688,0,2567,3255,1936,0,0,0,0
12956,WEST GODAVARI,Tadepalligudem,RAMANNAGUDEM,163,7,261,431,31,0,96,127,79,826,0,1729,2555,1199,0,0,0,0
12957,WEST GODAVARI,Tadepalligudem,UPPARAGUDEM,411,0,77,488,66,0,20,86,56,543,0,110,653,293,0,0,0,0
12958,WEST GODAVARI,Tadepalligudem,VEERAMPALEM,241,3,167,411,149,2,84,235,194,3800,16,1977,5793,3622,1,0,1,2
12959,WEST GODAVARI,Tadepalligudem,VENKATARAOPALEM,198,0,0,198,122,0,0,122,116,1075,0,0,1075,670,0,0,0,0
12960,WEST GODAVARI,Tadepalligudem,VENKATRAMANNAGUDEM,92,3,449,544,53,1,247,301,271,2083,18,8127,10228,6722,1,0,0,1
12961,WEST GODAVARI,Tanuku,DUVVA,277,10,1007,1294,71,3,438,512,257,2945,207,15809,18961,7273,0,0,2,2
12962,WEST GODAVARI,Tanuku,KOMARAVARAM,155,1,498,654,95,0,56,151,119,4645,0,2465,7110,3944,9,0,2,11
12963,WEST GODAVARI,Tanuku,KONALA,175,9,208,392,116,6,129,251,200,5360,436,8640,14436,6652,3,1,23,27
12964,WEST GODAVARI,Tanuku,MAHALAKSHMI CHERUVU,0,0,244,244,0,0,162,162,147,0,0,1851,1851,1141,0,0,0,0
12965,WEST GODAVARI,Tanuku,MANDAPAKA,157,8,675,840,55,2,276,333,302,1623,51,8797,10471,6836,0,0,0,0
12966,WEST GODAVARI,Tanuku,MUDDAPURAM,190,10,338,538,113,0,187,300,214,3559,0,4422,7981,3505,0,0,0,0
12967,WEST GODAVARI,Tanuku,PYDIPARRU,65,4,282,351,0,0,0,0,0,0,0,0,0,0,0,0,0,0
12968,WEST GODAVARI,Tanuku,TETALI,356,6,388,750,137,1,55,193,171,5624,18,1529,7171,4434,6,0,0,6
12969,WEST GODAVARI,Tanuku,VEERABHADRAPURAM,141,2,71,214,0,0,0,0,0,0,0,0,0,0,0,0,0,0
12970,WEST GODAVARI,Tanuku,VELPURU,313,27,1419,1759,108,5,114,227,199,2807,258,3316,6381,4259,1,0,0,1
12971,WEST GODAVARI,Tanuku,VENKATAPURAM,98,0,139,237,0,0,0,0,0,0,0,0,0,0,0,0,0,0
12972,WEST GODAVARI,Tanuku,YEERAICHERUVU,0,0,155,155,0,0,91,91,85,0,0,3969,3969,2309,0,0,3,3
12973,WEST GODAVARI,Thallapudi,ANNADEVARAPETA,1450,3,1037,2490,197,0,50,247,215,10716,0,2857,13573,7054,47,0,8,55
12974,WEST GODAVARI,Thallapudi,BALLIPADU,236,0,97,333,81,0,1,82,64,3645,0,20,3665,1999,9,0,0,9
12975,WEST GODAVARI,Thallapudi,GAJJARAM,547,1,177,725,51,0,7,58,52,1660,0,140,1800,1229,1,0,0,1
12976,WEST GODAVARI,Thallapudi,MALAKAPALLE,499,8,292,799,49,0,33,82,63,1604,0,1544,3148,1699,1,0,5,6
12977,WEST GODAVARI,Thallapudi,PEDDEVAM,790,33,728,1551,100,0,31,131,36,4214,0,1023,5237,851,8,0,0,8
12978,WEST GODAVARI,Thallapudi,POCHAVARAM,424,2,324,750,19,0,91,110,98,673,0,5016,5689,3489,2,0,12,14
12979,WEST GODAVARI,Thallapudi,PRAKKILANKA,257,0,244,501,41,0,26,67,34,832,0,685,1517,476,0,0,0,0
12980,WEST GODAVARI,Thallapudi,THADIPUDI,108,0,338,446,41,0,59,100,48,2919,0,2500,5419,1855,11,0,7,18
12981,WEST GODAVARI,Thallapudi,THALLAPUDI,344,56,464,864,50,0,5,55,50,1836,0,92,1928,1459,1,0,0,1
12982,WEST GODAVARI,Thallapudi,TIRIGUDUMETTA,378,0,262,640,129,0,0,129,96,4619,0,0,4619,1712,6,0,0,6
12983,WEST GODAVARI,Thallapudi,VEGESWARAPURAM,179,41,656,876,4,0,72,76,3,186,0,3677,3863,80,0,0,1,1
12984,WEST GODAVARI,Undi,AREDU,9,10,220,239,4,3,46,53,41,144,78,989,1211,603,0,0,0,0
12985,WEST GODAVARI,Undi,ARTHAMURU,66,11,329,406,7,0,79,86,23,25,0,379,404,94,0,0,0,0
12986,WEST GODAVARI,Undi,CHERUKUWADA,277,25,485,787,37,1,143,181,127,966,5,3894,4865,2284,0,0,0,0
12987,WEST GODAVARI,Undi,CHILUKURU,54,3,288,345,10,0,93,103,80,110,0,984,1094,623,0,0,0,0
12988,WEST GODAVARI,Undi,CHINAPULLURU,173,0,148,321,0,0,0,0,0,0,0,0,0,0,0,0,0,0
12989,WEST GODAVARI,Undi,KALIGOTLA,96,2,321,419,1,0,3,4,1,9,0,26,35,9,0,0,0,0
12990,WEST GODAVARI,Undi,KALISIPUDI,77,0,264,341,33,0,112,145,89,1117,0,3371,4488,1671,0,0,1,1
12991,WEST GODAVARI,Undi,KOLAMURRU,75,1,410,486,30,0,43,73,47,552,0,780,1332,654,0,0,0,0
12992,WEST GODAVARI,Undi,MAHADEVAPATNAM,232,2,701,935,83,1,247,331,263,1696,9,2949,4654,2939,0,0,0,0
12993,WEST GODAVARI,Undi,NARASIMHARAJAPURAAGRAHA,145,3,412,560,0,0,2,2,1,0,0,10,10,5,0,0,0,0
12994,WEST GODAVARI,Undi,PAMULAPARRU,55,83,308,446,0,0,1,1,1,0,0,6,6,6,0,0,0,0
12995,WEST GODAVARI,Undi,PANDUVVA,143,0,417,560,62,0,156,218,190,362,0,1078,1440,673,0,0,0,0
12996,WEST GODAVARI,Undi,PEDAPULLERU,37,2,493,532,3,1,58,62,51,77,21,1830,1928,873,0,0,0,0
12997,WEST GODAVARI,Undi,UNDI,292,4,1327,1623,3,1,149,153,132,60,20,2373,2453,1758,0,0,0,0
12998,WEST GODAVARI,Undi,UNUDURRU,166,10,274,450,47,1,46,94,56,381,5,283,669,281,0,0,0,0
12999,WEST GODAVARI,Undi,UPPULURU,204,5,380,589,116,0,105,221,136,2976,0,1694,4670,1978,0,0,0,0
13000,WEST GODAVARI,Undi,VANDRUM,165,9,316,490,69,0,140,209,113,1498,0,3772,5270,2185,0,0,0,0
13001,WEST GODAVARI,Undi,VELIVARRU,32,5,205,242,3,2,46,51,44,33,12,443,488,338,0,0,0,0
13002,WEST GODAVARI,Undi,YENDAGANDI,270,14,639,923,49,0,20,69,52,120,0,137,257,123,0,0,0,0
13003,WEST GODAVARI,Undrajavaram,CHILAKAPADU,87,0,261,348,5,0,49,54,27,60,0,849,909,397,0,0,0,0
13004,WEST GODAVARI,Undrajavaram,CHIVATAM,375,16,293,684,0,0,4,4,1,0,0,68,68,6,0,0,0,0
13005,WEST GODAVARI,Undrajavaram,DAMMENNU,161,5,134,300,50,0,27,77,59,1475,0,529,2004,928,1,0,0,1
13006,WEST GODAVARI,Undrajavaram,KALDHARI,532,14,552,1098,17,0,96,113,68,316,0,2735,3051,1304,0,0,3,3
13007,WEST GODAVARI,Undrajavaram,KARRAVARISAVARAM,1,0,116,117,0,0,4,4,1,0,0,35,35,17,0,0,0,0
13008,WEST GODAVARI,Undrajavaram,MORTHA,198,19,649,866,0,0,4,4,2,0,0,68,68,28,0,0,0,0
13009,WEST GODAVARI,Undrajavaram,PALANGI,153,4,189,346,32,2,10,44,35,366,31,101,498,293,0,0,0,0
13010,WEST GODAVARI,Undrajavaram,PASALAPUDI,174,10,334,518,72,0,143,215,143,1693,0,4308,6001,2512,0,0,0,0
13011,WEST GODAVARI,Undrajavaram,SATYAWADA,300,1,223,524,69,1,34,104,88,1198,17,506,1721,1161,0,0,0,0
13012,WEST GODAVARI,Undrajavaram,SURYARAOPALEM,483,7,313,803,78,1,76,155,58,2332,18,1994,4344,1058,1,0,0,1
13013,WEST GODAVARI,Undrajavaram,TADIPARRU,206,6,421,633,14,0,18,32,14,206,0,269,475,177,0,0,0,0
13014,WEST GODAVARI,Undrajavaram,UNDRAJAVARAM,745,2,356,1103,74,0,24,98,73,1569,0,463,2032,1219,0,0,0,0
13015,WEST GODAVARI,Undrajavaram,VADLURU,199,3,352,554,66,2,58,126,100,956,60,835,1851,1109,0,0,0,0
13016,WEST GODAVARI,Undrajavaram,VELAGADURRU,209,0,145,354,36,0,2,38,31,1394,0,40,1434,937,2,0,0,2
13017,WEST GODAVARI,Undrajavaram,VELIVENNU,263,3,803,1069,37,0,28,65,15,664,0,475,1139,194,0,0,0,0
13018,WEST GODAVARI,Unguturu,A.GOKAVARAM,230,0,180,410,13,0,34,47,26,158,0,566,724,454,0,0,0,0
13019,WEST GODAVARI,Unguturu,APPARAOPETA,73,0,109,182,42,0,55,97,74,638,0,638,1276,653,0,0,0,0
13020,WEST GODAVARI,Unguturu,BADAMPUDI,206,48,467,721,43,0,177,220,188,778,0,3558,4336,2160,0,0,0,0
13021,WEST GODAVARI,Unguturu,BOMMIDI,184,11,363,558,119,6,184,309,169,3336,99,2750,6185,2617,1,0,0,1
13022,WEST GODAVARI,Unguturu,CHEBROLU,118,16,971,1105,30,1,244,275,217,1011,41,5455,6507,3773,0,0,0,0
13023,WEST GODAVARI,Unguturu,DONTAVARAM,154,0,209,363,80,0,112,192,140,3206,0,3577,6783,2982,0,0,0,0
13024,WEST GODAVARI,Unguturu,GOLLAGUDEM,328,1,309,638,131,0,73,204,172,2126,0,1740,3866,2325,0,0,0,0
13025,WEST GODAVARI,Unguturu,GOPALAPURAM,109,0,140,249,0,0,0,0,0,0,0,0,0,0,0,0,0,0
13026,WEST GODAVARI,Unguturu,GOPINADHAPATNAM,191,1,195,387,1,0,3,4,0,6,0,24,30,0,0,0,0,0
13027,WEST GODAVARI,Unguturu,KAGUPADU,291,10,197,498,111,6,80,197,166,2652,162,2685,5499,3106,0,0,0,0
13028,WEST GODAVARI,Unguturu,KAIKARAM,442,25,1743,2210,119,9,704,832,675,1643,122,11666,13431,7026,0,0,0,0
13029,WEST GODAVARI,Unguturu,KAKARLAMUDI,138,0,549,687,61,0,239,300,265,1576,0,4989,6565,3207,0,0,0,0
13030,WEST GODAVARI,Unguturu,KAMSALIGUNTA,86,0,109,195,25,0,40,65,26,324,0,456,780,233,0,0,0,0
13031,WEST GODAVARI,Unguturu,NALLAMADU,121,0,162,283,44,0,9,53,38,1049,0,79,1128,477,0,0,0,0
13032,WEST GODAVARI,Unguturu,NARAYANAPURAM,220,9,572,801,27,1,202,230,154,724,9,6939,7672,3705,0,0,1,1
13033,WEST GODAVARI,Unguturu,NELADRRIPURAM,243,1,328,572,41,0,101,142,93,389,0,767,1156,599,0,0,0,0
13034,WEST GODAVARI,Unguturu,NOCHAGUNTA,422,16,581,1019,4,0,22,26,16,56,0,362,418,145,0,0,0,0
13035,WEST GODAVARI,Unguturu,RACHURU,230,3,435,668,55,0,193,248,217,1080,0,3568,4648,2457,1,0,0,1
13036,WEST GODAVARI,Unguturu,RAVULPARU,111,2,466,579,55,0,263,318,273,403,0,2562,2965,1324,0,0,0,0
13037,WEST GODAVARI,Unguturu,SEETAAMAPURAM,38,1,264,303,28,0,176,204,157,727,0,4776,5503,2678,0,0,0,0
13038,WEST GODAVARI,Unguturu,TALLAPURAM,85,0,201,286,59,0,103,162,120,1200,0,1663,2863,1248,0,0,0,0
13039,WEST GODAVARI,Unguturu,THIMAYYAPALEM,71,4,256,331,44,0,97,141,116,1973,0,3863,5836,3509,4,0,7,11
13040,WEST GODAVARI,Unguturu,UNGUTURU,249,3,958,1210,96,0,362,458,397,2951,0,9252,12203,6878,1,0,2,3
13041,WEST GODAVARI,Unguturu,UPPAKAPADU,160,5,391,556,85,4,202,291,176,1237,65,2428,3730,2042,0,0,0,0
13042,WEST GODAVARI,Unguturu,VELLAMALLI,444,46,832,1322,142,10,194,346,308,3836,132,4946,8914,6236,0,0,0,0
13043,WEST GODAVARI,Unguturu,VENKATADRIAPPARAOPURAM,140,2,174,316,86,2,69,157,114,2100,22,1014,3136,1588,0,0,0,0
13044,WEST GODAVARI,Unguturu,YERRAMILLIPADU,152,2,235,389,50,0,67,117,85,1038,0,1771,2809,1412,0,0,2,2
13045,WEST GODAVARI,Veeravasaram,ANDALURU,263,1,192,456,140,0,77,217,187,1535,0,852,2387,1310,0,0,0,0
13046,WEST GODAVARI,Veeravasaram,BALEPALLI,130,2,168,300,53,0,63,116,31,350,0,274,624,88,0,0,0,0
13047,WEST GODAVARI,Veeravasaram,BALUSUGOYIPALEM,55,6,276,337,0,0,0,0,0,0,0,0,0,0,0,0,0,0
13048,WEST GODAVARI,Veeravasaram,BOBBANAPALLE,70,12,124,206,54,1,66,121,80,1170,18,1248,2436,704,0,0,0,0
13049,WEST GODAVARI,Veeravasaram,CHINTALAKOTIGARUVU,54,0,250,304,27,0,116,143,87,661,0,3881,4542,2186,0,0,2,2
13050,WEST GODAVARI,Veeravasaram,DUSANAPUDI,61,2,115,178,0,0,0,0,0,0,0,0,0,0,0,0,0,0
13051,WEST GODAVARI,Veeravasaram,KONITHIWADA,131,44,841,1016,16,23,236,275,264,437,539,2895,3871,2310,1,0,0,1
13052,WEST GODAVARI,Veeravasaram,M.P.PALEM,189,0,139,328,36,0,38,74,14,375,0,606,981,144,0,0,0,0
13053,WEST GODAVARI,Veeravasaram,M.POLAVARAM,118,1,336,455,73,1,200,274,203,1239,7,2740,3986,1834,0,0,0,0
13054,WEST GODAVARI,Veeravasaram,MACHIPURI,299,3,591,893,54,0,91,145,45,952,0,1057,2009,493,0,0,0,0
13055,WEST GODAVARI,Veeravasaram,MENTEPUDI,28,0,156,184,6,0,74,80,5,82,0,1088,1170,58,0,0,0,0
13056,WEST GODAVARI,Veeravasaram,NANDAMURUGARUVU,68,1,311,380,0,0,1,1,0,0,0,2,2,0,0,0,0,0
13057,WEST GODAVARI,Veeravasaram,NAVUDURU,248,8,310,566,0,0,8,8,2,0,0,54,54,8,0,0,0,0
13058,WEST GODAVARI,Veeravasaram,NELAPAGULA,115,4,152,271,2,0,3,5,3,40,0,60,100,40,0,0,0,0
13059,WEST GODAVARI,Veeravasaram,P.VEMAVARAM,84,0,129,213,0,0,0,0,0,0,0,0,0,0,0,0,0,0
13060,WEST GODAVARI,Veeravasaram,PERIKIPALEM,127,0,152,279,41,0,60,101,55,429,0,685,1114,410,0,0,0,0
13061,WEST GODAVARI,Veeravasaram,RAYAKUDURU,275,6,753,1034,78,1,102,181,142,2765,13,3366,6144,3238,0,0,0,0
13062,WEST GODAVARI,Veeravasaram,THOKALAPUDI,113,0,338,451,30,0,93,123,108,367,0,1870,2237,1593,0,0,0,0
13063,WEST GODAVARI,Veeravasaram,THOLERU,163,1,619,783,54,0,309,363,248,1482,0,5306,6788,2087,0,0,1,1
13064,WEST GODAVARI,Veeravasaram,UTTARAPALEM,1,0,314,315,0,0,69,69,72,0,0,550,550,362,0,0,0,0
13065,WEST GODAVARI,Veeravasaram,VADDIGUDEM,1,1,329,331,0,1,118,119,101,0,6,1258,1264,646,0,0,0,0
13066,WEST GODAVARI,Veeravasaram,VEERAVALLIPALEM,16,0,149,165,11,0,86,97,89,71,0,593,664,345,0,0,0,0
13067,WEST GODAVARI,Veeravasaram,VEERAVASARAM,411,52,921,1384,30,1,368,399,364,296,3,4032,4331,2385,0,0,1,1
13068,WEST GODAVARI,Velairpad,Katukur,80,654,117,851,0,228,0,228,207,0,2740,0,2740,1408,0,0,0,0
13069,WEST GODAVARI,Velairpad,Koida,7,582,18,607,0,152,2,154,127,0,1352,17,1369,733,0,0,0,0
13070,WEST GODAVARI,Velairpad,Medepalle,43,910,236,1189,0,1,0,1,1,0,5,0,5,5,0,0,0,0
13071,WEST GODAVARI,Velairpad,Narlavaram,55,375,115,545,0,4,1,5,2,0,12,5,17,8,0,0,0,0
13072,WEST GODAVARI,Velairpad,Ramavaram,6,658,20,684,0,0,0,0,0,0,0,0,0,0,0,0,0,0
13073,WEST GODAVARI,Velairpad,Repakagommu,321,542,436,1299,16,15,6,37,34,81,169,120,370,217,0,0,0,0
13074,WEST GODAVARI,Velairpad,Rudramkota,125,5,194,324,3,0,2,5,5,32,0,28,60,31,0,0,0,0
13075,WEST GODAVARI,Velairpad,Thatukurgommu,236,985,322,1543,0,23,5,28,28,0,412,66,478,276,0,0,0,0
13076,WEST GODAVARI,Velairpad,Tirumalapuram,6,266,46,318,0,21,0,21,17,0,334,0,334,171,0,0,0,0
13077,WEST GODAVARI,Yelamanchili,ABBIRAJUPALEM,156,0,308,464,23,0,16,39,16,1166,0,453,1619,585,2,0,0,2
13078,WEST GODAVARI,Yelamanchili,ADAVIPALEM,162,1,294,457,1,0,2,3,0,20,0,28,48,0,0,0,0,0
13079,WEST GODAVARI,Yelamanchili,ARYAPETA,394,10,130,534,131,1,44,176,130,2661,6,744,3411,1795,1,0,0,1
13080,WEST GODAVARI,Yelamanchili,BADEVA,56,0,579,635,1,0,19,20,0,20,0,310,330,0,0,0,0,0
13081,WEST GODAVARI,Yelamanchili,BURUGUPALLE,88,7,336,431,4,1,101,106,92,41,1,1336,1378,834,0,0,0,0
13082,WEST GODAVARI,Yelamanchili,CHINCHINADA,289,14,249,552,43,2,44,89,63,455,14,463,932,517,0,0,0,0
13083,WEST GODAVARI,Yelamanchili,CHINTADIBBA,120,0,142,262,1,0,1,2,1,6,0,6,12,6,0,0,0,0
13084,WEST GODAVARI,Yelamanchili,DODDIPATLA,57,2,585,644,0,0,9,9,1,0,0,134,134,12,0,0,0,0
13085,WEST GODAVARI,Yelamanchili,ELAMANCHOLILANKA,79,0,136,215,27,0,1,28,19,165,0,6,171,92,0,0,0,0
13086,WEST GODAVARI,Yelamanchili,GANGADUPALEM,62,0,216,278,31,0,58,89,74,262,0,408,670,442,0,0,0,0
13087,WEST GODAVARI,Yelamanchili,GUMPARRU,113,2,292,407,35,0,91,126,87,490,0,966,1456,879,0,0,0,0
13088,WEST GODAVARI,Yelamanchili,ILAPAKURRU,234,12,217,463,42,0,11,53,37,845,0,277,1122,683,0,0,0,0
13089,WEST GODAVARI,Yelamanchili,K.S.PALEM,7,2,264,273,0,0,35,35,20,0,0,1176,1176,536,0,0,1,1
13090,WEST GODAVARI,Yelamanchili,KALAGAMPUDI,29,11,250,290,21,5,89,115,95,1020,93,1543,2656,1504,3,0,0,3
13091,WEST GODAVARI,Yelamanchili,KAMBLEEPALEM,58,1,272,331,21,1,134,156,126,196,6,1345,1547,1144,0,0,0,0
13092,WEST GODAVARI,Yelamanchili,KANAKAYALANKA,159,0,227,386,2,0,4,6,3,32,0,72,104,24,0,0,0,0
13093,WEST GODAVARI,Yelamanchili,KATTIPALEM,71,2,402,475,4,0,8,12,4,26,0,70,96,10,0,0,0,0
13094,WEST GODAVARI,Yelamanchili,KAZA EAST,157,0,110,267,18,0,17,35,24,233,0,131,364,161,0,0,0,0
13095,WEST GODAVARI,Yelamanchili,KAZA WEST,167,4,324,495,34,0,79,113,96,372,0,956,1328,1004,0,0,0,0
13096,WEST GODAVARI,Yelamanchili,KONTHERU,370,1,294,665,58,1,17,76,66,1861,20,652,2533,1353,1,0,1,2
13097,WEST GODAVARI,Yelamanchili,LAKSHMIPALEM,54,0,123,177,22,0,55,77,71,178,0,388,566,406,0,0,0,0
13098,WEST GODAVARI,Yelamanchili,MATTAPALEM,40,3,215,258,4,0,67,71,51,40,0,962,1002,465,0,0,0,0
13099,WEST GODAVARI,Yelamanchili,MEDAPADU,188,6,157,351,0,0,5,5,1,0,0,100,100,2,0,0,0,0
13100,WEST GODAVARI,Yelamanchili,NARIMAVARIMERAKA,143,0,92,235,47,0,6,53,42,996,0,61,1057,629,0,0,0,0
13101,WEST GODAVARI,Yelamanchili,NEREDUMALLI,131,0,151,282,44,0,41,85,55,1216,0,936,2152,1071,0,0,0,0
13102,WEST GODAVARI,Yelamanchili,PEDALANKA,145,0,144,289,5,0,4,9,6,84,0,80,164,64,0,0,0,0
13103,WEST GODAVARI,Yelamanchili,PENUMARRU,112,28,172,312,3,0,1,4,4,60,0,20,80,36,0,0,0,0
13104,WEST GODAVARI,Yelamanchili,SIRAGALAPALLE,178,1,238,417,59,0,20,79,65,846,0,395,1241,852,0,0,0,0
13105,WEST GODAVARI,Yelamanchili,UTADA,83,3,76,162,31,0,9,40,12,716,0,156,872,255,0,0,0,0
13106,WEST GODAVARI,Yelamanchili,VADDILANKA,47,0,125,172,24,0,15,39,29,322,0,92,414,222,0,0,0,0
13107,WEST GODAVARI,Yelamanchili,Y.V.LANKA,234,0,552,786,74,0,36,110,66,3125,0,1539,4664,2736,2,0,0,2
13108,WEST GODAVARI,Yelamanchili,YELAMANCHILI,77,4,600,681,14,0,44,58,32,173,0,534,707,259,0,0,0,0
